SZAVAZOKOR,VALASZTOPOLGAR,MEGJELENTEK,URNABAN_BELYEGZES_NELKULI,URNABAN_LEBELYEGZETT,ELTERES,ERVENYTELEN,ERVENYES
01-001-001,1055,698,6,692,-6,4,688
01-001-002,978,602,0,602,0,3,599
01-001-003,1753,1183,0,1183,0,2,1181
01-001-004,1004,568,1,566,-2,9,557
01-001-005,932,576,0,576,0,0,576
01-001-006,998,624,0,624,0,4,620
01-001-007,899,559,0,557,-2,1,556
01-001-008,896,557,0,557,0,1,556
01-001-009,1026,615,0,615,0,3,612
01-001-010,962,589,0,588,-1,3,585
01-001-011,969,613,0,613,0,0,613
01-001-012,1017,613,0,613,0,2,611
01-001-013,1065,650,0,650,0,2,648
01-001-014,997,622,0,622,0,1,621
01-001-015,974,584,0,583,-1,2,581
01-001-016,895,577,0,577,0,2,575
01-001-017,1014,631,0,631,0,2,629
01-001-018,1011,634,0,633,-1,1,632
01-001-019,969,569,0,569,0,1,568
01-001-020,901,559,0,559,0,2,557
01-002-001,1077,661,3,658,-3,0,658
01-002-002,943,562,0,562,0,4,558
01-002-003,699,386,0,386,0,1,385
01-002-004,1020,592,0,592,0,3,589
01-002-005,1084,649,0,649,0,4,645
01-002-006,878,580,0,579,-1,2,577
01-002-007,799,508,0,508,0,2,506
01-002-008,886,588,0,587,-1,4,583
01-002-009,861,551,0,551,0,5,546
01-002-010,723,500,0,499,-1,2,497
01-002-011,2695,2015,2,2015,0,4,2011
01-002-012,988,657,0,657,0,0,657
01-002-013,668,427,1,426,-1,1,425
01-002-014,854,536,1,536,0,1,535
01-002-015,761,486,0,486,0,5,481
01-002-016,886,587,0,587,0,0,587
01-002-017,866,564,0,564,0,2,562
01-002-018,777,503,0,503,0,0,503
01-002-019,851,562,0,561,-1,2,559
01-002-020,830,552,0,551,-1,0,551
01-002-021,855,531,0,531,0,4,527
01-002-022,853,567,0,567,0,4,563
01-002-023,879,583,0,583,0,1,582
01-002-024,983,621,0,620,-1,0,620
01-002-025,829,524,0,524,0,1,523
01-002-026,873,614,0,613,-1,11,602
01-002-027,758,468,0,468,0,0,468
01-002-028,705,463,0,463,0,2,461
01-002-029,507,307,0,307,0,0,307
01-002-030,595,368,0,368,0,2,366
01-002-031,1115,691,0,691,0,3,688
01-002-032,977,679,0,679,0,1,678
01-002-033,855,601,1,602,1,9,593
01-002-034,764,461,0,461,0,1,460
01-002-035,879,557,0,558,1,18,540
01-002-036,880,602,0,601,-1,0,601
01-002-037,882,562,0,562,0,3,559
01-002-038,1009,652,0,652,0,2,650
01-002-039,841,547,0,547,0,5,542
01-002-040,847,514,0,514,0,2,512
01-002-041,782,453,0,453,0,3,450
01-002-042,786,473,0,473,0,2,471
01-002-043,796,534,0,534,0,0,534
01-002-044,919,625,0,625,0,1,624
01-002-045,887,540,1,541,1,11,530
01-002-046,911,578,0,578,0,2,576
01-002-047,895,605,0,605,0,0,605
01-002-048,947,609,0,608,-1,1,607
01-002-049,879,562,0,560,-2,3,557
01-002-050,819,497,0,497,0,1,496
01-002-051,758,519,0,519,0,4,515
01-002-052,693,447,0,447,0,2,445
01-002-053,720,475,0,475,0,0,475
01-002-054,1064,637,1,635,-2,1,634
01-002-055,925,548,0,547,-1,3,544
01-002-056,776,489,1,488,-1,3,485
01-002-057,743,479,0,479,0,2,477
01-002-058,937,541,0,541,0,2,539
01-002-059,798,504,0,504,0,1,503
01-002-060,816,451,1,451,0,3,448
01-002-061,917,575,0,573,-2,3,570
01-002-062,673,377,0,377,0,2,375
01-002-063,841,514,1,514,0,0,514
01-002-064,857,504,0,504,0,0,504
01-002-065,928,537,0,537,0,1,536
01-002-066,1036,580,0,580,0,2,578
01-002-067,860,456,0,456,0,0,456
01-002-068,885,503,0,502,-1,3,499
01-002-069,955,530,0,530,0,5,525
01-002-070,868,532,0,532,0,5,527
01-002-071,853,525,0,525,0,0,525
01-002-072,963,567,0,567,0,1,566
01-002-073,949,560,0,560,0,2,558
01-002-074,842,461,0,461,0,3,458
01-003-001,901,547,0,547,0,3,544
01-003-002,881,531,0,531,0,3,528
01-003-003,1000,528,0,524,-4,4,520
01-003-004,967,557,0,557,0,6,551
01-003-005,851,431,0,431,0,1,430
01-003-006,967,591,0,591,0,2,589
01-003-007,920,507,0,507,0,5,502
01-003-008,808,428,0,428,0,0,428
01-003-009,855,489,0,489,0,5,484
01-003-010,880,552,0,552,0,4,548
01-003-011,948,567,0,567,0,4,563
01-003-012,901,580,0,580,0,4,576
01-003-013,911,560,0,560,0,0,560
01-003-014,879,522,0,522,0,1,521
01-003-015,750,478,0,477,-1,1,476
01-003-016,795,534,0,534,0,1,533
01-003-017,851,551,0,551,0,0,551
01-003-018,947,567,0,567,0,0,567
01-003-019,1094,671,1,671,0,0,671
01-003-020,1113,598,0,598,0,2,596
01-003-021,813,438,0,438,0,2,436
01-003-022,1112,609,0,609,0,3,606
01-003-023,856,513,0,513,0,0,513
01-003-024,810,491,0,491,0,1,490
01-003-025,794,409,0,409,0,0,409
01-003-026,768,478,1,478,0,1,477
01-003-027,846,550,0,550,0,1,549
01-003-028,890,508,0,510,2,21,489
01-003-029,871,491,0,491,0,4,487
01-003-030,920,533,0,533,0,1,532
01-003-031,906,449,0,449,0,4,445
01-003-032,962,554,0,554,0,0,554
01-003-033,873,463,0,463,0,1,462
01-003-034,794,430,0,430,0,0,430
01-003-035,807,445,0,445,0,1,444
01-003-036,804,441,0,441,0,0,441
01-003-037,912,555,0,554,-1,0,554
01-003-038,784,418,0,418,0,2,416
01-003-039,793,452,0,452,0,0,452
01-003-040,731,368,1,367,-1,0,367
01-003-041,827,407,0,407,0,1,406
01-003-042,2699,1942,1,1938,-4,3,1935
01-003-043,1069,527,0,527,0,2,525
01-003-044,990,628,0,626,-2,6,620
01-003-045,947,456,0,456,0,2,454
01-003-046,1048,528,0,526,-2,2,524
01-003-047,570,316,0,316,0,2,314
01-003-048,822,420,0,420,0,1,419
01-003-049,861,468,0,468,0,0,468
01-003-050,865,466,1,465,-1,3,462
01-003-051,790,443,0,443,0,1,442
01-003-052,888,518,0,518,0,2,516
01-003-053,728,445,0,445,0,1,444
01-003-054,901,521,0,521,0,2,519
01-003-055,850,457,0,457,0,3,454
01-003-056,840,478,0,478,0,1,477
01-003-057,933,471,0,471,0,1,470
01-003-058,812,397,0,397,0,0,397
01-003-059,775,513,0,513,0,2,511
01-003-060,870,475,0,475,0,0,475
01-003-061,853,464,0,464,0,1,463
01-003-062,891,409,0,409,0,1,408
01-003-063,876,385,0,385,0,1,384
01-003-064,749,415,0,415,0,2,413
01-003-065,980,571,2,566,-5,1,565
01-003-066,840,455,2,453,-2,3,450
01-003-067,827,440,0,440,0,2,438
01-003-068,810,571,0,571,0,1,570
01-003-069,812,498,0,498,0,0,498
01-003-070,839,497,2,494,-3,1,493
01-003-071,918,538,0,538,0,1,537
01-003-072,914,530,0,530,0,4,526
01-003-073,845,534,0,534,0,2,532
01-003-074,896,574,0,574,0,0,574
01-003-075,756,468,1,466,-2,1,465
01-003-076,945,565,0,565,0,2,563
01-003-077,894,574,0,571,-3,1,570
01-003-078,838,523,0,523,0,0,523
01-003-079,892,558,0,558,0,1,557
01-003-080,871,527,1,526,-1,1,525
01-003-081,915,563,0,563,0,3,560
01-003-082,1025,650,0,650,0,2,648
01-003-083,972,646,0,644,-2,1,643
01-003-084,889,534,1,532,-2,1,531
01-003-085,814,431,0,431,0,0,431
01-003-086,822,330,0,330,0,0,330
01-003-087,954,446,0,446,0,2,444
01-003-088,881,478,0,478,0,3,475
01-003-089,987,465,0,465,0,2,463
01-003-090,835,335,0,335,0,0,335
01-003-091,805,382,0,382,0,0,382
01-003-092,994,446,1,446,0,2,444
01-003-093,886,432,0,431,-1,3,428
01-003-094,819,395,0,393,-2,1,392
01-003-095,819,353,2,350,-3,2,348
01-003-096,980,480,0,480,0,0,480
01-003-097,997,446,0,446,0,3,443
01-003-098,728,276,0,276,0,0,276
01-003-099,977,428,0,427,-1,1,426
01-003-100,873,375,0,375,0,1,374
01-003-101,905,342,0,342,0,5,337
01-003-102,916,416,0,415,-1,1,414
01-003-103,848,447,0,447,0,1,446
01-003-104,781,351,0,351,0,1,350
01-003-105,757,371,0,370,-1,1,369
01-003-106,843,441,0,441,0,3,438
01-003-107,781,426,0,426,0,3,423
01-003-108,854,423,0,423,0,3,420
01-003-109,825,407,0,407,0,1,406
01-003-110,824,391,0,391,0,0,391
01-003-111,770,375,0,375,0,2,373
01-003-112,826,342,0,342,0,1,341
01-004-001,1202,690,0,690,0,0,690
01-004-002,1142,550,0,550,0,0,550
01-004-003,1180,620,0,619,-1,0,619
01-004-004,1350,792,0,792,0,0,792
01-004-005,1267,556,0,555,-1,2,553
01-004-006,1275,708,0,708,0,1,707
01-004-007,1248,559,0,559,0,4,555
01-004-008,1009,483,0,483,0,1,482
01-004-009,1058,528,0,528,0,1,527
01-004-010,1159,586,0,586,0,0,586
01-004-011,980,515,0,515,0,0,515
01-004-012,1048,471,0,471,0,2,469
01-004-013,1045,443,0,443,0,2,441
01-004-014,1009,525,0,525,0,0,525
01-004-015,955,449,0,448,-1,1,447
01-004-016,1023,565,0,565,0,0,565
01-004-017,1109,689,0,688,-1,2,686
01-004-018,1086,653,0,653,0,5,648
01-004-019,1000,466,0,466,0,3,463
01-004-020,1007,524,0,524,0,1,523
01-004-021,1057,618,0,618,0,0,618
01-004-022,1071,638,0,638,0,3,635
01-004-023,1037,552,0,552,0,0,552
01-004-024,1099,571,0,571,0,3,568
01-004-025,1061,557,0,556,-1,1,555
01-004-026,1102,658,0,658,0,0,658
01-004-027,1103,658,0,658,0,1,657
01-004-028,1085,632,0,631,-1,0,631
01-004-029,1121,613,0,613,0,3,610
01-004-030,1120,504,0,503,-1,3,500
01-004-031,988,398,0,398,0,0,398
01-004-032,956,520,0,520,0,1,519
01-004-033,1004,441,0,441,0,1,440
01-004-034,988,318,0,318,0,0,318
01-004-035,1128,443,0,443,0,3,440
01-004-036,1072,408,0,407,-1,2,405
01-004-037,1003,426,0,426,0,0,426
01-004-038,1067,500,0,500,0,0,500
01-004-039,976,555,0,555,0,1,554
01-004-040,955,427,0,427,0,1,426
01-004-041,1055,595,0,595,0,0,595
01-004-042,902,438,0,438,0,0,438
01-004-043,1087,526,0,526,0,4,522
01-004-044,1096,547,0,547,0,2,545
01-004-045,1066,501,0,500,-1,0,500
01-004-046,1254,697,0,697,0,0,697
01-004-047,1006,490,0,490,0,2,488
01-004-048,1039,503,0,503,0,1,502
01-004-049,1243,597,0,597,0,2,595
01-004-050,1266,648,0,648,0,1,647
01-004-051,1196,431,0,431,0,1,430
01-004-052,924,507,0,507,0,1,506
01-004-053,875,422,0,422,0,0,422
01-004-054,1088,522,0,522,0,2,520
01-004-055,1095,519,0,519,0,1,518
01-004-056,1079,535,0,535,0,2,533
01-004-057,963,493,0,493,0,2,491
01-004-058,1276,609,0,609,0,2,607
01-004-059,1017,420,0,420,0,1,419
01-004-060,1142,497,0,497,0,3,494
01-004-061,1172,536,0,535,-1,1,534
01-004-062,984,459,0,459,0,1,458
01-004-063,2856,1817,0,1817,0,4,1813
01-004-064,1146,561,0,561,0,2,559
01-004-065,1022,451,0,451,0,1,450
01-004-066,1140,528,0,528,0,3,525
01-004-067,1118,537,0,537,0,3,534
01-004-068,1142,500,0,500,0,0,500
01-004-069,1171,527,0,527,0,1,526
01-004-070,1114,548,0,548,0,1,547
01-005-001,863,483,0,482,-1,2,480
01-005-002,742,389,0,389,0,2,387
01-005-003,713,423,0,423,0,2,421
01-005-004,893,554,0,554,0,3,551
01-005-005,912,516,0,514,-2,2,512
01-005-006,771,438,0,438,0,4,434
01-005-007,864,476,1,476,0,1,475
01-005-008,1021,544,0,544,0,4,540
01-005-009,826,452,0,452,0,1,451
01-005-010,561,309,0,309,0,0,309
01-005-011,1718,1232,0,1233,1,17,1216
01-005-012,943,496,0,487,-9,3,484
01-005-013,907,481,0,480,-1,1,479
01-005-014,970,503,0,503,0,1,502
01-005-015,895,484,0,484,0,2,482
01-005-016,812,442,0,441,-1,2,439
01-005-017,795,449,0,449,0,0,449
01-005-018,827,487,1,486,-1,8,478
01-005-019,823,485,0,484,-1,1,483
01-005-020,966,540,0,540,0,2,538
01-005-021,960,543,0,543,0,1,542
01-006-001,816,404,1,403,-1,1,402
01-006-002,681,321,0,319,-2,2,317
01-006-003,725,319,0,319,0,1,318
01-006-004,749,371,0,371,0,1,370
01-006-005,788,394,0,394,0,0,394
01-006-006,692,316,0,316,0,0,316
01-006-007,761,329,1,328,-1,1,327
01-006-008,693,304,1,304,0,0,304
01-006-009,716,312,0,311,-1,1,310
01-006-010,686,353,0,352,-1,2,350
01-006-011,737,389,0,389,0,1,388
01-006-012,823,373,0,373,0,1,372
01-006-013,802,328,0,328,0,4,324
01-006-014,913,390,0,390,0,0,390
01-006-015,920,491,0,491,0,1,490
01-006-016,915,402,0,402,0,0,402
01-006-017,928,399,0,399,0,0,399
01-006-018,975,439,0,439,0,0,439
01-006-019,1004,436,0,436,0,1,435
01-006-020,796,360,0,360,0,4,356
01-006-021,966,512,0,512,0,2,510
01-006-022,884,393,0,393,0,0,393
01-006-023,976,485,0,485,0,1,484
01-006-024,925,494,0,494,0,0,494
01-006-025,678,342,0,342,0,1,341
01-006-026,1767,1260,0,1259,-1,7,1252
01-006-027,911,474,0,474,0,2,472
01-006-028,782,391,1,390,-1,0,390
01-006-029,920,494,0,494,0,1,493
01-006-030,768,432,0,431,-1,4,427
01-007-001,1087,451,0,451,0,0,451
01-007-002,1184,521,0,520,-1,3,517
01-007-003,1118,511,0,510,-1,0,510
01-007-004,2255,1625,0,1625,0,5,1620
01-007-005,873,357,0,357,0,5,352
01-007-006,1105,529,0,529,0,2,527
01-007-007,1229,459,0,459,0,4,455
01-007-008,653,255,0,255,0,3,252
01-007-009,714,300,0,300,0,0,300
01-007-010,997,421,0,421,0,2,419
01-007-011,958,487,0,487,0,2,485
01-007-012,747,363,0,363,0,1,362
01-007-013,964,455,0,455,0,1,454
01-007-014,876,419,0,419,0,3,416
01-007-015,1125,575,0,575,0,1,574
01-007-016,857,351,0,351,0,2,349
01-007-017,865,434,0,435,1,15,420
01-007-018,1082,486,0,486,0,1,485
01-007-019,838,417,0,417,0,1,416
01-007-020,821,398,0,398,0,0,398
01-007-021,1068,504,0,504,0,2,502
01-007-022,950,458,0,458,0,3,455
01-007-023,824,351,0,351,0,0,351
01-007-024,936,412,0,412,0,6,406
01-007-025,880,413,0,413,0,3,410
01-007-026,858,485,0,485,0,1,484
01-007-027,861,461,0,461,0,1,460
01-007-028,1156,464,0,464,0,4,460
01-007-029,1202,440,0,439,-1,2,437
01-007-030,1205,567,0,567,0,2,565
01-007-031,840,394,0,394,0,2,392
01-007-032,1183,516,0,516,0,1,515
01-007-033,1000,468,0,468,0,0,468
01-007-034,757,347,0,347,0,0,347
01-007-035,992,440,0,440,0,2,438
01-007-036,883,409,0,409,0,3,406
01-007-037,1030,400,0,400,0,1,399
01-007-038,873,345,0,345,0,1,344
01-008-001,751,396,1,394,-2,1,393
01-008-002,717,359,0,359,0,2,357
01-008-003,667,367,0,367,0,1,366
01-008-004,673,336,0,336,0,0,336
01-008-005,761,388,0,388,0,0,388
01-008-006,647,329,0,330,1,8,322
01-008-007,983,485,0,482,-3,0,482
01-008-008,3583,2331,1,2331,0,6,2325
01-008-009,928,497,0,495,-2,1,494
01-008-010,763,406,0,406,0,5,401
01-008-011,1059,508,0,508,0,1,507
01-008-012,723,280,0,280,0,1,279
01-008-013,1027,400,0,399,-1,1,398
01-008-014,1081,472,0,472,0,2,470
01-008-015,940,349,0,349,0,2,347
01-008-016,1060,489,0,489,0,3,486
01-008-017,1029,477,0,477,0,0,477
01-008-018,760,358,0,358,0,1,357
01-008-019,884,375,0,375,0,2,373
01-008-020,1054,368,0,368,0,1,367
01-008-021,961,363,0,363,0,0,363
01-008-022,737,271,0,271,0,0,271
01-008-023,679,271,0,271,0,0,271
01-008-024,915,341,0,341,0,0,341
01-008-025,779,334,0,334,0,3,331
01-008-026,786,339,0,339,0,1,338
01-008-027,874,331,0,331,0,3,328
01-008-028,646,259,0,259,0,1,258
01-008-029,972,335,0,335,0,1,334
01-008-030,1020,295,0,295,0,0,295
01-008-031,1283,186,0,186,0,0,186
01-008-032,958,284,0,284,0,1,283
01-008-033,627,245,0,245,0,2,243
01-008-034,684,296,0,296,0,1,295
01-008-035,692,227,0,227,0,2,225
01-008-036,710,348,0,348,0,0,348
01-008-037,497,132,0,132,0,0,132
01-008-038,787,336,0,335,-1,2,333
01-008-039,754,307,0,307,0,2,305
01-008-040,695,303,0,303,0,0,303
01-008-041,914,408,0,408,0,1,407
01-008-042,1254,379,0,379,0,0,379
01-008-043,1075,357,0,357,0,3,354
01-008-044,801,198,0,196,-2,1,195
01-008-045,742,330,0,330,0,1,329
01-008-046,946,337,0,337,0,0,337
01-008-047,535,226,0,226,0,0,226
01-008-048,975,289,0,289,0,2,287
01-008-049,1281,487,0,484,-3,2,482
01-008-050,1121,328,0,328,0,5,323
01-008-051,777,211,0,211,0,1,210
01-008-052,1065,383,0,383,0,2,381
01-008-053,625,391,0,390,-1,0,390
01-008-054,1026,541,0,541,0,6,535
01-008-055,723,279,0,279,0,2,277
01-008-056,1067,489,0,489,0,3,486
01-008-057,614,305,0,305,0,1,304
01-008-058,643,373,0,373,0,1,372
01-008-059,594,252,0,252,0,1,251
01-008-060,631,213,0,213,0,0,213
01-009-001,617,338,0,338,0,1,337
01-009-002,597,309,0,309,0,2,307
01-009-003,617,312,0,311,-1,0,311
01-009-004,645,343,0,343,0,2,341
01-009-005,633,305,0,305,0,3,302
01-009-006,662,355,0,354,-1,0,354
01-009-007,742,383,0,381,-2,2,379
01-009-008,615,315,0,315,0,2,313
01-009-009,3393,2607,0,2606,-1,5,2601
01-009-010,649,394,0,394,0,0,394
01-009-011,737,394,0,394,0,0,394
01-009-012,695,366,0,366,0,1,365
01-009-013,815,450,0,449,-1,1,448
01-009-014,897,513,0,513,0,1,512
01-009-015,617,310,0,310,0,1,309
01-009-016,592,288,0,288,0,0,288
01-009-017,1012,521,0,521,0,0,521
01-009-018,787,362,0,362,0,2,360
01-009-019,868,374,0,373,-1,1,372
01-009-020,1058,357,0,357,0,2,355
01-009-021,816,361,0,361,0,1,360
01-009-022,807,364,0,364,0,1,363
01-009-023,800,302,1,302,0,2,300
01-009-024,619,302,0,302,0,0,302
01-009-025,895,427,0,427,0,0,427
01-009-026,745,356,0,356,0,0,356
01-009-027,736,399,0,399,0,2,397
01-009-028,710,394,0,394,0,2,392
01-009-029,998,452,0,452,0,1,451
01-009-030,962,467,0,467,0,5,462
01-009-031,812,318,0,318,0,2,316
01-009-032,679,274,0,274,0,0,274
01-009-033,862,370,0,370,0,2,368
01-009-034,665,294,0,294,0,0,294
01-009-035,732,405,0,405,0,0,405
01-009-036,1079,495,1,493,-2,1,492
01-009-037,693,249,0,249,0,1,248
01-009-038,791,224,0,224,0,0,224
01-009-039,899,226,0,226,0,0,226
01-009-040,655,122,0,122,0,0,122
01-009-041,655,330,0,330,0,0,330
01-009-042,674,379,0,378,-1,1,377
01-009-043,713,400,0,400,0,1,399
01-009-044,609,319,0,319,0,0,319
01-009-045,832,369,0,369,0,9,360
01-009-046,764,385,0,385,0,0,385
01-009-047,702,371,0,371,0,0,371
01-009-048,659,348,0,348,0,1,347
01-009-049,875,469,0,469,0,2,467
01-009-050,827,468,0,468,0,5,463
01-009-051,816,445,0,446,1,10,436
01-009-052,792,421,0,421,0,4,417
01-009-053,712,375,0,375,0,1,374
01-010-001,597,307,0,306,-1,1,305
01-010-002,595,312,0,312,0,0,312
01-010-003,588,180,2,178,-2,1,177
01-010-004,613,187,0,187,0,1,186
01-010-005,596,195,0,195,0,0,195
01-010-006,623,219,0,219,0,0,219
01-010-007,579,271,0,271,0,0,271
01-010-008,675,258,0,258,0,0,258
01-010-009,985,428,0,428,0,0,428
01-010-010,605,269,0,269,0,0,269
01-010-011,710,368,0,368,0,2,366
01-010-012,673,400,0,400,0,0,400
01-010-013,740,336,0,336,0,3,333
01-010-014,682,298,0,298,0,1,297
01-010-015,727,275,0,275,0,1,274
01-010-016,745,367,0,367,0,0,367
01-010-017,709,321,0,321,0,2,319
01-010-018,725,285,0,285,0,0,285
01-010-019,713,340,0,340,0,3,337
01-010-020,867,335,0,335,0,1,334
01-010-021,937,364,0,364,0,2,362
01-010-022,767,434,0,433,-1,1,432
01-010-023,711,337,0,337,0,1,336
01-010-024,810,358,0,358,0,2,356
01-010-025,571,259,0,259,0,1,258
01-010-026,605,309,0,309,0,0,309
01-010-027,807,331,0,331,0,3,328
01-010-028,764,328,0,328,0,2,326
01-010-029,791,382,0,382,0,1,381
01-010-030,670,315,0,315,0,0,315
01-010-031,802,429,0,429,0,2,427
01-010-032,871,543,0,543,0,1,542
01-010-033,730,266,0,266,0,2,264
01-010-034,780,293,0,293,0,0,293
01-010-035,2427,1606,0,1604,-2,6,1598
01-010-036,800,372,0,372,0,1,371
01-010-037,840,334,0,334,0,1,333
01-010-038,776,383,0,383,0,3,380
01-010-039,618,270,0,270,0,0,270
01-010-040,614,270,0,270,0,0,270
01-010-041,613,333,0,333,0,1,332
01-010-042,682,311,0,311,0,0,311
01-010-043,644,290,0,289,-1,2,287
01-010-044,662,342,0,342,0,0,342
01-010-045,583,323,0,323,0,0,323
01-010-046,585,249,0,249,0,1,248
01-010-047,659,272,0,272,0,6,266
01-010-048,728,244,0,244,0,1,243
01-010-049,632,211,2,211,0,0,211
01-010-050,793,259,0,259,0,2,257
01-010-051,640,331,0,331,0,2,329
01-010-052,668,343,0,343,0,1,342
01-010-053,649,349,0,349,0,0,349
01-010-054,677,397,0,397,0,1,396
01-010-055,701,327,0,327,0,4,323
01-010-056,845,327,0,327,0,0,327
01-010-057,826,357,0,357,0,0,357
01-010-058,645,276,0,276,0,1,275
01-010-059,598,252,0,252,0,2,250
01-010-060,712,276,0,276,0,2,274
01-010-061,803,387,0,387,0,0,387
01-010-062,731,322,1,320,-2,0,320
01-010-063,827,357,2,356,-1,0,356
01-010-064,754,349,0,349,0,5,344
01-010-065,754,327,1,326,-1,0,326
01-010-066,799,346,0,346,0,0,346
01-010-067,749,301,0,301,0,1,300
01-010-068,676,339,0,339,0,0,339
01-010-069,705,301,0,301,0,3,298
01-010-070,925,410,0,410,0,2,408
01-010-071,888,410,0,410,0,1,409
01-010-072,880,391,0,391,0,3,388
01-010-073,869,343,0,343,0,0,343
01-010-074,804,317,0,317,0,1,316
01-010-075,635,369,0,369,0,2,367
01-010-076,681,360,0,360,0,0,360
01-011-001,765,462,0,461,-1,1,460
01-011-002,843,522,0,522,0,4,518
01-011-003,770,528,0,528,0,1,527
01-011-004,810,493,0,492,-1,1,491
01-011-005,819,540,0,539,-1,2,537
01-011-006,862,526,0,526,0,0,526
01-011-007,793,461,1,461,0,3,458
01-011-008,678,427,0,427,0,0,427
01-011-009,752,450,0,450,0,0,450
01-011-010,1053,602,0,602,0,5,597
01-011-011,968,578,0,578,0,2,576
01-011-012,865,500,0,500,0,1,499
01-011-013,778,474,0,474,0,1,473
01-011-014,958,590,0,586,-4,2,584
01-011-015,759,450,1,449,-1,5,444
01-011-016,782,443,0,443,0,1,442
01-011-017,776,426,0,425,-1,4,421
01-011-018,898,506,0,506,0,1,505
01-011-019,763,411,0,411,0,1,410
01-011-020,791,448,0,448,0,0,448
01-011-021,811,464,0,464,0,1,463
01-011-022,674,454,0,454,0,0,454
01-011-023,816,529,0,529,0,4,525
01-011-024,786,468,0,468,0,1,467
01-011-025,816,486,1,486,0,3,483
01-011-026,923,568,0,568,0,2,566
01-011-027,852,467,0,467,0,4,463
01-011-028,1061,612,0,612,0,3,609
01-011-029,838,487,0,487,0,1,486
01-011-030,792,473,0,473,0,1,472
01-011-031,1030,600,0,600,0,0,600
01-011-032,1074,641,0,641,0,2,639
01-011-033,609,420,0,420,0,2,418
01-011-034,1045,622,0,621,-1,1,620
01-011-035,831,507,0,507,0,1,506
01-011-036,769,523,0,522,-1,4,518
01-011-037,898,609,1,607,-2,1,606
01-011-038,878,581,0,581,0,0,581
01-011-039,767,531,0,531,0,1,530
01-011-040,934,635,0,635,0,0,635
01-011-041,962,678,0,678,0,0,678
01-011-042,884,617,0,615,-2,5,610
01-011-043,834,605,0,605,0,1,604
01-011-044,912,638,0,637,-1,1,636
01-011-045,1122,789,0,788,-1,1,787
01-011-046,935,636,0,636,0,2,634
01-011-047,997,699,0,699,0,2,697
01-011-048,854,479,0,480,1,10,470
01-011-049,904,506,0,505,-1,2,503
01-011-050,764,508,0,508,0,0,508
01-011-051,811,521,0,521,0,4,517
01-011-052,803,495,0,495,0,0,495
01-011-053,865,528,0,528,0,4,524
01-011-054,846,519,0,519,0,1,518
01-011-055,773,488,0,487,-1,1,486
01-011-056,4176,3125,0,3124,-1,6,3118
01-011-057,740,438,0,438,0,3,435
01-011-058,761,466,0,466,0,3,463
01-011-059,1006,593,0,588,-5,2,586
01-011-060,1026,622,0,622,0,0,622
01-011-061,1045,633,1,633,0,2,631
01-011-062,1057,690,0,690,0,3,687
01-011-063,972,591,0,591,0,1,590
01-011-064,892,498,0,498,0,6,492
01-011-065,1092,619,0,618,-1,6,612
01-011-066,802,431,0,431,0,1,430
01-011-067,914,468,0,468,0,0,468
01-011-068,745,335,1,333,-2,3,330
01-011-069,817,498,0,495,-3,1,494
01-011-070,952,621,0,621,0,3,618
01-011-071,787,429,0,429,0,1,428
01-011-072,687,374,0,374,0,1,373
01-011-073,968,531,0,531,0,1,530
01-011-074,1099,666,0,666,0,3,663
01-011-075,950,526,0,526,0,2,524
01-011-076,1127,610,0,610,0,1,609
01-011-077,1090,589,0,589,0,2,587
01-011-078,973,592,0,592,0,2,590
01-011-079,1132,610,0,610,0,1,609
01-011-080,1089,542,0,542,0,0,542
01-011-081,988,607,0,607,0,3,604
01-011-082,1096,638,0,637,-1,4,633
01-011-083,812,459,0,459,0,1,458
01-011-084,839,385,1,384,-1,1,383
01-011-085,997,498,0,498,0,1,497
01-011-086,1079,575,0,575,0,3,572
01-011-087,727,340,0,340,0,1,339
01-011-088,770,487,0,486,-1,1,485
01-011-089,859,446,0,446,0,1,445
01-011-090,713,369,0,369,0,2,367
01-011-091,965,462,0,462,0,2,460
01-011-092,669,363,0,363,0,0,363
01-011-093,812,458,0,457,-1,3,454
01-011-094,1114,559,0,559,0,5,554
01-011-095,1139,490,0,490,0,2,488
01-011-096,751,394,0,394,0,2,392
01-011-097,874,486,0,486,0,5,481
01-011-098,864,530,0,530,0,0,530
01-011-099,1026,686,0,686,0,0,686
01-011-100,1030,625,0,625,0,3,622
01-011-101,931,500,0,499,-1,1,498
01-011-102,824,429,0,429,0,3,426
01-011-103,714,383,0,383,0,2,381
01-011-104,749,483,0,483,0,3,480
01-011-105,709,416,0,415,-1,2,413
01-011-106,830,502,0,502,0,1,501
01-011-107,869,550,0,550,0,0,550
01-011-108,805,514,0,514,0,4,510
01-011-109,967,579,0,579,0,2,577
01-011-110,1000,631,0,631,0,2,629
01-011-111,812,508,0,507,-1,1,506
01-011-112,1138,619,0,619,0,2,617
01-011-113,1141,404,0,404,0,4,400
01-012-001,692,431,0,431,0,1,430
01-012-002,683,382,0,381,-1,1,380
01-012-003,509,281,0,281,0,4,277
01-012-004,761,497,0,497,0,4,493
01-012-005,636,317,0,317,0,0,317
01-012-006,556,328,0,328,0,2,326
01-012-007,767,461,0,461,0,3,458
01-012-008,846,533,0,533,0,1,532
01-012-009,891,582,0,582,0,2,580
01-012-010,942,607,0,607,0,4,603
01-012-011,784,533,0,532,-1,2,530
01-012-012,936,618,0,618,0,5,613
01-012-013,612,408,0,408,0,0,408
01-012-014,642,400,0,399,-1,1,398
01-012-015,688,439,0,439,0,0,439
01-012-016,668,449,0,449,0,1,448
01-012-017,939,511,0,511,0,1,510
01-012-018,865,530,0,530,0,0,530
01-012-019,801,519,0,519,0,4,515
01-012-020,750,448,0,448,0,4,444
01-012-021,736,446,0,446,0,6,440
01-012-022,504,344,0,344,0,1,343
01-012-023,2339,1893,0,1893,0,9,1884
01-012-024,578,394,0,394,0,0,394
01-012-025,772,520,0,520,0,1,519
01-012-026,710,492,0,492,0,1,491
01-012-027,696,495,0,495,0,2,493
01-012-028,988,598,0,598,0,6,592
01-012-029,702,451,0,451,0,2,449
01-012-030,901,596,0,596,0,1,595
01-012-031,706,404,0,404,0,2,402
01-012-032,781,486,0,484,-2,3,481
01-012-033,941,523,0,522,-1,2,520
01-012-034,842,564,0,564,0,9,555
01-012-035,855,591,0,591,0,0,591
01-012-036,679,450,0,450,0,0,450
01-012-037,747,501,0,501,0,2,499
01-012-038,953,612,0,611,-1,4,607
01-012-039,942,623,0,623,0,2,621
01-012-040,765,522,0,522,0,3,519
01-012-041,572,354,0,354,0,3,351
01-012-042,840,583,0,583,0,1,582
01-012-043,898,562,0,562,0,3,559
01-012-044,977,636,0,636,0,1,635
01-012-045,618,365,0,365,0,2,363
01-012-046,940,595,0,594,-1,0,594
01-012-047,1020,645,0,645,0,0,645
01-012-048,874,470,0,470,0,1,469
01-012-049,850,514,0,513,-1,3,510
01-012-050,778,548,0,548,0,0,548
01-012-051,575,369,0,369,0,2,367
01-012-052,912,601,0,601,0,2,599
01-012-053,876,543,0,543,0,4,539
01-012-054,701,454,0,455,1,10,445
01-012-055,721,457,0,456,-1,4,452
01-013-001,1090,493,0,486,-7,2,484
01-013-002,951,506,0,506,0,1,505
01-013-003,1000,578,0,578,0,2,576
01-013-004,931,558,0,556,-2,0,556
01-013-005,940,612,0,612,0,2,610
01-013-006,1181,645,0,646,1,12,634
01-013-007,1025,532,0,532,0,2,530
01-013-008,1090,592,0,591,-1,2,589
01-013-009,1108,697,6,691,-6,4,687
01-013-010,1036,662,0,662,0,2,660
01-013-011,751,504,0,504,0,5,499
01-013-012,952,522,0,522,0,0,522
01-013-013,980,535,0,533,-2,1,532
01-013-014,1047,590,2,588,-2,1,587
01-013-015,1069,629,0,627,-2,1,626
01-013-016,850,534,0,534,0,0,534
01-013-017,1133,753,0,752,-1,5,747
01-013-018,1088,640,0,640,0,3,637
01-013-019,1139,648,0,648,0,3,645
01-013-020,1187,598,0,598,0,1,597
01-013-021,1166,690,0,689,-1,1,688
01-013-022,1208,610,0,610,0,6,604
01-013-023,1093,598,0,598,0,2,596
01-013-024,1206,632,0,630,-2,4,626
01-013-025,793,423,0,423,0,2,421
01-013-026,1000,396,0,396,0,4,392
01-013-027,1014,404,1,403,-1,1,402
01-013-028,927,522,0,522,0,6,516
01-013-029,1011,559,0,559,0,2,557
01-013-030,1010,567,0,567,0,2,565
01-013-031,978,577,0,576,-1,0,576
01-013-032,972,559,1,558,-1,1,557
01-013-033,1017,451,0,451,0,2,449
01-013-034,3972,2928,0,2927,-1,3,2924
01-013-035,1211,663,0,663,0,1,662
01-013-036,1106,501,0,501,0,0,501
01-013-037,1125,593,0,587,-6,3,584
01-013-038,1072,523,1,523,0,1,522
01-013-039,1072,569,0,569,0,2,567
01-013-040,886,144,0,144,0,1,143
01-013-041,984,409,0,409,0,3,406
01-013-042,883,400,0,400,0,2,398
01-013-043,730,258,0,258,0,2,256
01-013-044,985,525,0,525,0,0,525
01-013-045,1060,343,0,343,0,0,343
01-013-046,970,287,0,287,0,4,283
01-013-047,940,411,0,411,0,1,410
01-013-048,1183,473,0,473,0,4,469
01-013-049,1089,435,0,435,0,2,433
01-013-050,984,484,0,484,0,4,480
01-013-051,937,430,0,430,0,0,430
01-013-052,1026,404,0,403,-1,2,401
01-013-053,922,481,0,481,0,1,480
01-013-054,911,509,0,509,0,1,508
01-013-055,862,451,0,451,0,4,447
01-013-056,783,410,0,410,0,1,409
01-013-057,988,474,0,474,0,0,474
01-013-058,1126,457,0,457,0,0,457
01-013-059,1002,469,0,469,0,0,469
01-013-060,1028,534,0,534,0,2,532
01-013-061,945,494,0,494,0,3,491
01-013-062,635,347,0,347,0,2,345
01-013-063,1284,554,0,554,0,6,548
01-013-064,1007,453,0,453,0,0,453
01-013-065,860,359,0,357,-2,1,356
01-013-066,886,500,0,500,0,5,495
01-013-067,1150,606,0,605,-1,0,605
01-013-068,1186,660,0,659,-1,0,659
01-013-069,1123,627,0,627,0,1,626
01-013-070,904,439,0,437,-2,5,432
01-013-071,1186,519,0,519,0,6,513
01-013-072,770,380,0,380,0,2,378
01-013-073,1161,563,0,563,0,1,562
01-013-074,1054,468,0,468,0,0,468
01-013-075,781,382,0,382,0,1,381
01-013-076,1244,407,0,407,0,5,402
01-013-077,1132,670,0,669,-1,2,667
01-013-078,905,446,0,445,-1,1,444
01-013-079,1130,619,0,617,-2,0,617
01-013-080,943,464,0,464,0,10,454
01-013-081,806,448,0,448,0,3,445
01-013-082,1251,678,0,676,-2,2,674
01-013-083,1300,618,0,617,-1,6,611
01-013-084,1064,514,0,514,0,3,511
01-013-085,1016,417,0,417,0,1,416
01-013-086,707,320,0,320,0,2,318
01-013-087,779,443,0,443,0,0,443
01-014-001,1063,615,0,615,0,0,615
01-014-002,1089,540,0,540,0,0,540
01-014-003,1067,634,0,633,-1,5,628
01-014-004,1144,671,0,671,0,2,669
01-014-005,1396,743,0,743,0,3,740
01-014-006,1185,670,0,670,0,3,667
01-014-007,1160,596,0,595,-1,3,592
01-014-008,1130,565,0,564,-1,1,563
01-014-009,1104,508,0,508,0,3,505
01-014-010,1093,546,0,546,0,4,542
01-014-011,1227,601,0,601,0,7,594
01-014-012,1078,530,0,530,0,5,525
01-014-013,995,466,0,466,0,3,463
01-014-014,1260,460,0,459,-1,2,457
01-014-015,1072,494,0,494,0,2,492
01-014-016,1212,712,0,712,0,7,705
01-014-017,1103,650,0,651,1,10,641
01-014-018,1159,610,0,610,0,1,609
01-014-019,1191,657,0,657,0,3,654
01-014-020,1270,757,0,757,0,2,755
01-014-021,1288,739,0,740,1,9,731
01-014-022,1170,525,0,525,0,4,521
01-014-023,3971,2866,1,2865,-1,4,2861
01-014-024,1168,624,0,624,0,2,622
01-014-025,1191,676,0,676,0,0,676
01-014-026,1173,585,0,585,0,1,584
01-014-027,1169,656,1,655,-1,3,652
01-014-028,1103,514,0,513,-1,0,513
01-014-029,1199,686,0,686,0,1,685
01-014-030,1139,624,0,627,3,28,599
01-014-031,1367,610,0,610,0,5,605
01-014-032,1207,705,0,705,0,1,704
01-014-033,1163,654,0,654,0,0,654
01-014-034,1193,649,0,649,0,4,645
01-014-035,1163,735,1,733,-2,5,728
01-014-036,1172,708,0,708,0,2,706
01-014-037,1271,744,0,744,0,0,744
01-014-038,1304,802,0,802,0,1,801
01-014-039,1024,569,0,569,0,2,567
01-014-040,997,608,0,607,-1,2,605
01-014-041,1209,733,0,732,-1,2,730
01-014-042,1060,639,0,639,0,1,638
01-014-043,1204,715,0,713,-2,4,709
01-014-044,1225,705,0,705,0,3,702
01-014-045,1223,603,0,603,0,4,599
01-014-046,1163,637,0,637,0,8,629
01-014-047,1241,718,0,718,0,7,711
01-014-048,1126,517,0,517,0,1,516
01-014-049,1245,631,0,631,0,1,630
01-014-050,1107,545,0,545,0,1,544
01-014-051,1152,558,0,558,0,1,557
01-014-052,1075,512,0,512,0,0,512
01-014-053,1122,509,0,509,0,1,508
01-014-054,1155,513,1,513,0,3,510
01-014-055,1238,703,1,701,-2,0,701
01-014-056,1217,728,0,728,0,3,725
01-014-057,1285,685,0,685,0,3,682
01-014-058,1012,490,0,491,1,11,480
01-014-059,1163,564,1,563,-1,5,558
01-014-060,1222,660,0,660,0,6,654
01-014-061,1275,792,0,792,0,4,788
01-014-062,1209,723,0,723,0,2,721
01-014-063,1141,725,0,724,-1,0,724
01-014-064,1139,638,0,638,0,4,634
01-014-065,1241,785,1,784,-1,5,779
01-014-066,1250,593,0,593,0,1,592
01-014-067,1095,487,0,487,0,3,484
01-014-068,1133,636,0,636,0,2,634
01-014-069,1157,610,0,610,0,2,608
01-014-070,1117,635,0,634,-1,4,630
01-014-071,1178,605,0,605,0,2,603
01-014-072,1193,626,0,626,0,1,625
01-014-073,1196,638,0,638,0,1,637
01-014-074,1223,619,0,619,0,4,615
01-014-075,1102,648,0,648,0,3,645
01-015-001,832,465,0,465,0,2,463
01-015-002,853,473,0,473,0,2,471
01-015-003,1118,607,0,607,0,0,607
01-015-004,913,486,0,486,0,1,485
01-015-005,757,442,0,442,0,2,440
01-015-006,1094,613,0,613,0,2,611
01-015-007,784,409,0,409,0,0,409
01-015-008,777,419,0,419,0,0,419
01-015-009,845,398,0,398,0,4,394
01-015-010,811,380,1,379,-1,1,378
01-015-011,825,394,0,394,0,4,390
01-015-012,1101,525,0,525,0,2,523
01-015-013,1205,525,0,524,-1,0,524
01-015-014,779,379,0,379,0,2,377
01-015-015,1946,1149,0,1149,0,2,1147
01-015-016,1147,567,0,567,0,0,567
01-015-017,759,365,0,364,-1,0,364
01-015-018,770,391,0,391,0,2,389
01-015-019,1017,486,0,486,0,2,484
01-015-020,1121,477,0,477,0,2,475
01-015-021,1032,439,0,439,0,3,436
01-015-022,1075,531,0,531,0,1,530
01-015-023,761,459,1,459,0,2,457
01-015-024,996,482,0,482,0,1,481
01-015-025,949,528,0,528,0,0,528
01-015-026,822,449,0,449,0,1,448
01-015-027,894,486,0,486,0,2,484
01-015-028,853,413,0,413,0,1,412
01-015-029,854,401,0,401,0,1,400
01-015-030,703,385,0,385,0,0,385
01-015-031,828,386,0,386,0,1,385
01-015-032,792,401,0,401,0,1,400
01-015-033,851,450,0,450,0,0,450
01-015-034,701,400,0,402,2,19,383
01-015-035,1094,581,0,581,0,0,581
01-015-036,843,450,0,450,0,0,450
01-015-037,791,441,0,441,0,2,439
01-015-038,961,504,0,504,0,0,504
01-015-039,902,468,0,468,0,4,464
01-015-040,735,319,0,319,0,1,318
01-015-041,789,328,0,327,-1,2,325
01-015-042,931,409,0,409,0,0,409
01-015-043,935,429,0,429,0,3,426
01-015-044,893,393,0,393,0,2,391
01-015-045,739,309,0,309,0,2,307
01-015-046,914,397,0,397,0,1,396
01-015-047,866,375,0,375,0,1,374
01-015-048,741,329,0,329,0,2,327
01-015-049,801,443,0,443,0,14,429
01-015-050,700,302,0,302,0,1,301
01-015-051,735,299,0,299,0,0,299
01-015-052,872,345,0,345,0,1,344
01-015-053,749,350,0,350,0,4,346
01-015-054,962,360,0,360,0,4,356
01-015-055,871,360,0,360,0,0,360
01-015-056,877,395,0,395,0,2,393
01-015-057,975,421,1,420,-1,1,419
01-015-058,831,358,0,358,0,2,356
01-015-059,844,327,0,327,0,1,326
01-015-060,916,385,0,385,0,0,385
01-015-061,1050,460,2,458,-2,0,458
01-015-062,786,343,0,343,0,0,343
01-015-063,1202,572,0,572,0,5,567
01-015-064,963,428,0,428,0,2,426
01-015-065,781,381,0,381,0,3,378
01-015-066,841,452,0,451,-1,1,450
01-015-067,968,425,0,425,0,1,424
01-015-068,799,345,0,345,0,2,343
01-015-069,830,367,0,367,0,0,367
01-015-070,916,315,0,315,0,2,313
01-016-001,1048,608,0,608,0,2,606
01-016-002,971,557,0,557,0,2,555
01-016-003,998,596,0,596,0,5,591
01-016-004,870,462,0,462,0,4,458
01-016-005,863,506,0,506,0,1,505
01-016-006,1050,535,0,535,0,1,534
01-016-007,1053,556,0,556,0,0,556
01-016-008,1021,573,0,573,0,4,569
01-016-009,994,559,0,555,-4,1,554
01-016-010,966,547,0,547,0,1,546
01-016-011,994,559,0,560,1,12,548
01-016-012,1041,595,0,595,0,0,595
01-016-013,886,472,0,472,0,0,472
01-016-014,918,532,0,532,0,2,530
01-016-015,1051,624,0,624,0,1,623
01-016-016,832,466,0,466,0,0,466
01-016-017,1686,1188,0,1186,-2,3,1183
01-016-018,881,522,0,522,0,2,520
01-016-019,743,407,0,407,0,1,406
01-016-020,743,454,0,454,0,3,451
01-016-021,746,410,0,409,-1,2,407
01-016-022,774,479,0,479,0,1,478
01-016-023,903,500,0,500,0,2,498
01-016-024,859,455,0,455,0,1,454
01-016-025,853,492,0,492,0,12,480
01-016-026,995,571,0,571,0,1,570
01-016-027,986,589,0,589,0,0,589
01-016-028,769,451,0,451,0,1,450
01-016-029,828,469,0,469,0,1,468
01-016-030,969,531,0,531,0,2,529
01-016-031,851,495,1,494,-1,1,493
01-016-032,1042,613,0,613,0,0,613
01-016-033,1113,635,0,635,0,0,635
01-016-034,926,525,0,525,0,0,525
01-016-035,1088,578,1,577,-1,3,574
01-016-036,849,539,0,539,0,2,537
01-016-037,724,448,0,448,0,1,447
01-016-038,928,592,0,592,0,0,592
01-016-039,782,443,0,443,0,0,443
01-016-040,958,587,0,587,0,2,585
01-016-041,813,431,0,430,-1,6,424
01-016-042,891,541,0,541,0,2,539
01-016-043,958,609,0,609,0,1,608
01-016-044,1001,572,0,572,0,0,572
01-016-045,956,594,1,594,0,65,529
01-016-046,746,364,0,364,0,2,362
01-016-047,682,368,0,368,0,0,368
01-016-048,943,526,1,524,-2,0,524
01-016-049,986,637,0,637,0,4,633
01-016-050,824,463,0,463,0,5,458
01-016-051,1040,545,0,545,0,1,544
01-016-052,837,503,1,502,-1,1,501
01-016-053,762,453,0,453,0,4,449
01-016-054,914,558,0,558,0,1,557
01-016-055,917,526,0,526,0,4,522
01-016-056,1311,727,0,727,0,2,725
01-016-057,1308,662,0,662,0,1,661
01-016-058,791,423,0,423,0,1,422
01-016-059,895,487,0,486,-1,0,486
01-016-060,1066,563,0,562,-1,0,562
01-017-001,857,508,0,508,0,1,507
01-017-002,863,528,0,528,0,0,528
01-017-003,962,515,0,515,0,1,514
01-017-004,851,512,0,512,0,2,510
01-017-005,745,486,0,485,-1,1,484
01-017-006,858,574,0,574,0,2,572
01-017-007,969,455,0,455,0,1,454
01-017-008,1126,504,0,504,0,1,503
01-017-009,957,392,0,392,0,1,391
01-017-010,824,322,0,322,0,1,321
01-017-011,994,392,0,392,0,7,385
01-017-012,914,426,0,425,-1,1,424
01-017-013,918,327,0,327,0,0,327
01-017-014,965,406,0,406,0,0,406
01-017-015,859,393,0,393,0,2,391
01-017-016,465,159,0,159,0,1,158
01-017-017,711,289,0,288,-1,1,287
01-017-018,872,410,0,410,0,2,408
01-017-019,974,422,0,422,0,1,421
01-017-020,808,329,0,329,0,1,328
01-017-021,1613,810,1,809,-1,11,798
01-017-022,940,439,0,437,-2,3,434
01-017-023,1010,415,0,415,0,3,412
01-017-024,918,464,0,464,0,0,464
01-017-025,1038,553,0,553,0,2,551
01-017-026,898,567,0,567,0,1,566
01-017-027,641,385,0,385,0,1,384
01-017-028,700,405,0,405,0,1,404
01-017-029,931,446,0,446,0,3,443
01-017-030,938,469,0,469,0,1,468
01-017-031,894,518,0,518,0,1,517
01-017-032,828,456,0,456,0,2,454
01-017-033,898,487,0,486,-1,0,486
01-017-034,886,450,0,450,0,1,449
01-017-035,1072,436,0,436,0,3,433
01-017-036,1011,461,0,461,0,2,459
01-017-037,1048,456,0,456,0,0,456
01-017-038,1099,558,0,557,-1,3,554
01-017-039,989,554,0,554,0,1,553
01-017-040,1096,611,0,611,0,1,610
01-017-041,1074,505,0,505,0,1,504
01-017-042,1148,592,0,593,1,9,584
01-017-043,986,512,0,512,0,3,509
01-017-044,753,359,0,359,0,1,358
01-017-045,823,415,0,415,0,0,415
01-017-046,1024,578,0,577,-1,2,575
01-017-047,1082,594,0,594,0,1,593
01-017-048,816,459,0,459,0,0,459
01-017-049,905,460,0,460,0,1,459
01-017-050,774,404,0,404,0,0,404
01-017-051,1173,586,0,586,0,1,585
01-017-052,1021,556,0,556,0,5,551
01-017-053,872,435,0,435,0,3,432
01-017-054,769,422,0,421,-1,1,420
01-017-055,937,536,0,536,0,2,534
01-017-056,1036,549,0,549,0,0,549
01-017-057,811,405,0,405,0,0,405
01-017-058,940,454,0,454,0,4,450
01-017-059,1102,568,0,568,0,2,566
01-017-060,956,442,1,442,0,1,441
01-017-061,1053,469,0,469,0,1,468
01-017-062,745,357,0,357,0,0,357
01-017-063,907,446,0,446,0,3,443
01-017-064,975,538,0,538,0,0,538
01-017-065,915,479,0,479,0,2,477
01-017-066,922,515,0,515,0,2,513
01-017-067,936,527,0,527,0,1,526
01-017-068,948,509,0,509,0,1,508
01-017-069,870,470,0,470,0,0,470
01-017-070,914,515,0,515,0,6,509
01-017-071,907,486,0,486,0,0,486
01-017-072,973,607,0,607,0,1,606
01-017-073,1009,609,0,609,0,6,603
01-017-074,724,409,0,409,0,3,406
01-017-075,974,579,0,579,0,2,577
01-018-001,1103,598,0,598,0,2,596
01-018-002,900,470,0,470,0,1,469
01-018-003,1106,579,0,580,1,11,569
01-018-004,1120,588,0,588,0,6,582
01-018-005,1150,567,0,567,0,2,565
01-018-006,984,528,0,528,0,2,526
01-018-007,929,478,0,478,0,0,478
01-018-008,918,453,0,453,0,1,452
01-018-009,829,392,0,392,0,0,392
01-018-010,966,548,0,548,0,3,545
01-018-011,1913,1191,2,1191,0,11,1180
01-018-012,855,511,0,511,0,1,510
01-018-013,1032,536,0,536,0,4,532
01-018-014,908,523,0,523,0,2,521
01-018-015,941,508,0,508,0,2,506
01-018-016,845,465,0,465,0,2,463
01-018-017,853,457,0,457,0,1,456
01-018-018,982,536,0,536,0,6,530
01-018-019,1087,614,0,614,0,5,609
01-018-020,887,489,0,489,0,0,489
01-018-021,1043,595,0,595,0,2,593
01-018-022,853,452,0,452,0,3,449
01-018-023,937,536,0,536,0,0,536
01-018-024,1063,439,0,439,0,2,437
01-018-025,985,551,1,550,-1,2,548
01-018-026,1103,485,0,485,0,1,484
01-018-027,1236,599,0,599,0,2,597
01-018-028,1028,551,0,551,0,3,548
01-018-029,1221,443,0,443,0,3,440
01-018-030,1125,465,0,465,0,0,465
01-018-031,1258,432,0,432,0,5,427
01-018-032,1071,372,0,372,0,2,370
01-018-033,1055,370,0,370,0,6,364
01-018-034,848,341,0,341,0,1,340
01-018-035,982,385,0,385,0,7,378
01-018-036,1006,366,0,366,0,1,365
01-018-037,941,396,0,396,0,0,396
01-018-038,1086,385,0,385,0,3,382
01-018-039,897,340,0,340,0,1,339
01-018-040,1056,541,0,541,0,1,540
01-018-041,1110,587,0,587,0,1,586
01-018-042,1180,584,0,583,-1,0,583
01-018-043,844,439,0,436,-3,1,435
01-018-044,1221,608,0,608,0,1,607
01-018-045,725,361,0,361,0,1,360
01-018-046,815,449,0,449,0,2,447
01-018-047,1055,567,0,566,-1,1,565
01-018-048,805,432,0,426,-6,1,425
01-018-049,1064,538,0,538,0,0,538
01-018-050,1072,615,0,615,0,0,615
01-018-051,947,503,0,503,0,4,499
01-018-052,1027,647,0,647,0,1,646
01-018-053,1174,717,0,717,0,6,711
01-018-054,1040,616,0,616,0,2,614
01-018-055,1139,564,0,564,0,9,555
01-018-056,1304,679,0,679,0,19,660
01-018-057,1115,660,0,660,0,6,654
01-018-058,1045,546,0,546,0,3,543
01-018-059,1315,709,0,709,0,2,707
01-018-060,1218,535,0,535,0,1,534
01-018-061,1358,643,0,643,0,6,637
01-018-062,1216,564,0,564,0,3,561
01-018-063,1175,626,0,626,0,2,624
01-018-064,910,431,0,431,0,0,431
01-018-065,1143,517,0,516,-1,1,515
01-018-066,734,378,0,378,0,3,375
01-018-067,1058,556,0,556,0,1,555
01-018-068,923,470,0,470,0,2,468
01-018-069,1150,583,0,583,0,1,582
01-018-070,1052,527,0,527,0,4,523
01-018-071,869,404,0,404,0,0,404
01-018-072,1120,546,0,546,0,4,542
01-018-073,1066,552,0,552,0,2,550
01-018-074,1183,572,0,571,-1,2,569
01-018-075,1216,611,0,611,0,2,609
01-018-076,961,419,0,419,0,0,419
01-019-001,793,366,0,366,0,1,365
01-019-002,980,434,0,434,0,0,434
01-019-003,904,394,0,394,0,0,394
01-019-004,869,394,0,394,0,2,392
01-019-005,915,450,0,450,0,2,448
01-019-006,847,434,0,434,0,1,433
01-019-007,841,410,0,409,-1,2,407
01-019-008,899,427,1,426,-1,1,425
01-019-009,1019,537,1,534,-3,5,529
01-019-010,970,473,0,473,0,0,473
01-019-011,969,482,0,482,0,1,481
01-019-012,960,438,0,438,0,2,436
01-019-013,878,476,1,476,0,1,475
01-019-014,892,392,0,392,0,1,391
01-019-015,994,509,0,509,0,5,504
01-019-016,885,413,0,413,0,3,410
01-019-017,996,484,0,483,-1,1,482
01-019-018,828,374,1,374,0,0,374
01-019-019,795,397,1,397,0,0,397
01-019-020,871,475,0,475,0,2,473
01-019-021,786,433,0,433,0,0,433
01-019-022,771,323,0,323,0,0,323
01-019-023,1821,1138,0,1138,0,7,1131
01-019-024,902,449,0,449,0,1,448
01-019-025,833,383,0,383,0,1,382
01-019-026,834,394,0,392,-2,5,387
01-019-027,716,343,0,343,0,0,343
01-019-028,964,375,0,375,0,0,375
01-019-029,902,512,1,512,0,5,507
01-019-030,952,498,0,498,0,1,497
01-019-031,886,540,0,540,0,1,539
01-019-032,1176,711,0,711,0,3,708
01-019-033,982,579,0,578,-1,5,573
01-019-034,960,551,0,549,-2,3,546
01-019-035,1106,594,0,594,0,3,591
01-019-036,1177,584,0,584,0,5,579
01-019-037,1087,550,1,548,-2,3,545
01-019-038,1209,600,0,599,-1,3,596
01-019-039,918,483,0,483,0,2,481
01-019-040,1076,543,0,543,0,2,541
01-019-041,1195,584,0,584,0,0,584
01-019-042,1060,559,0,559,0,6,553
01-019-043,848,401,0,399,-2,1,398
01-019-044,989,497,0,497,0,4,493
01-019-045,981,403,2,403,0,2,401
01-019-046,996,545,0,545,0,1,544
01-019-047,921,539,0,538,-1,2,536
01-019-048,1249,742,0,742,0,1,741
01-020-001,840,412,0,411,-1,3,408
01-020-002,1079,578,1,578,0,0,578
01-020-003,593,268,0,268,0,0,268
01-020-004,659,263,0,263,0,1,262
01-020-005,839,390,1,390,0,3,387
01-020-006,929,438,0,438,0,0,438
01-020-007,692,323,0,323,0,2,321
01-020-008,979,472,0,470,-2,1,469
01-020-009,866,359,0,359,0,1,358
01-020-010,722,299,0,299,0,0,299
01-020-011,1787,1048,0,1048,0,4,1044
01-020-012,871,326,0,326,0,5,321
01-020-013,996,462,0,462,0,2,460
01-020-014,725,281,0,281,0,3,278
01-020-015,755,283,0,283,0,1,282
01-020-016,938,300,0,300,0,1,299
01-020-017,928,335,0,335,0,0,335
01-020-018,723,247,0,247,0,1,246
01-020-019,1330,637,0,637,0,4,633
01-020-020,1124,473,0,473,0,2,471
01-020-021,834,394,0,393,-1,1,392
01-020-022,870,414,0,414,0,1,413
01-020-023,652,338,1,337,-1,1,336
01-020-024,658,319,0,319,0,3,316
01-020-025,800,385,5,380,-5,2,378
01-020-026,869,423,0,423,0,0,423
01-020-027,812,392,0,392,0,2,390
01-020-028,766,357,0,357,0,0,357
01-020-029,658,315,0,315,0,0,315
01-020-030,758,370,0,370,0,3,367
01-020-031,628,308,0,308,0,2,306
01-020-032,601,273,0,273,0,1,272
01-020-033,585,309,0,308,-1,3,305
01-020-034,804,366,0,365,-1,1,364
01-020-035,893,374,0,374,0,0,374
01-020-036,885,348,0,348,0,1,347
01-020-037,876,382,0,382,0,8,374
01-020-038,708,326,0,326,0,0,326
01-020-039,964,424,0,424,0,3,421
01-020-040,922,423,0,423,0,0,423
01-020-041,771,376,0,376,0,5,371
01-020-042,968,416,0,416,0,7,409
01-020-043,752,352,0,352,0,0,352
01-020-044,767,323,0,323,0,0,323
01-020-045,890,416,0,416,0,2,414
01-020-046,628,347,0,347,0,1,346
01-020-047,850,435,0,435,0,4,431
01-020-048,674,322,0,322,0,2,320
01-020-049,893,481,0,481,0,5,476
01-020-050,1009,456,0,456,0,1,455
01-020-051,734,365,3,361,-4,2,359
01-020-052,810,365,0,365,0,1,364
01-020-053,620,285,0,285,0,3,282
01-020-054,867,402,0,402,0,2,400
01-020-055,772,322,0,322,0,3,319
01-020-056,944,413,0,413,0,6,407
01-020-057,807,377,0,377,0,1,376
01-020-058,1042,439,0,439,0,1,438
01-020-059,824,422,0,422,0,1,421
01-020-060,904,381,0,381,0,5,376
01-020-061,660,232,0,232,0,0,232
01-021-001,843,452,0,452,0,2,450
01-021-002,840,444,1,443,-1,2,441
01-021-003,777,421,0,421,0,1,420
01-021-004,763,392,0,392,0,2,390
01-021-005,870,457,0,457,0,4,453
01-021-006,822,386,0,386,0,0,386
01-021-007,717,372,0,372,0,4,368
01-021-008,942,486,0,486,0,1,485
01-021-009,940,490,0,490,0,3,487
01-021-010,976,523,0,523,0,4,519
01-021-011,755,404,0,404,0,0,404
01-021-012,834,454,0,454,0,1,453
01-021-013,821,400,0,400,0,1,399
01-021-014,944,471,0,471,0,5,466
01-021-015,967,524,0,524,0,1,523
01-021-016,842,452,0,452,0,8,444
01-021-017,1018,566,0,566,0,1,565
01-021-018,914,498,0,498,0,2,496
01-021-019,756,409,0,409,0,4,405
01-021-020,664,393,0,393,0,0,393
01-021-021,785,402,0,400,-2,2,398
01-021-022,882,462,0,462,0,5,457
01-021-023,797,338,0,338,0,3,335
01-021-024,802,355,0,355,0,1,354
01-021-025,842,335,0,335,0,3,332
01-021-026,875,433,0,433,0,4,429
01-021-027,754,368,0,368,0,0,368
01-021-028,974,422,0,422,0,1,421
01-021-029,708,296,1,295,-1,0,295
01-021-030,729,288,0,288,0,3,285
01-021-031,762,314,0,314,0,0,314
01-021-032,998,414,0,414,0,5,409
01-021-033,839,322,0,322,0,3,319
01-021-034,738,223,0,223,0,2,221
01-021-035,752,200,0,200,0,1,199
01-021-036,821,325,0,325,0,4,321
01-021-037,843,389,0,389,0,1,388
01-021-038,1599,859,0,859,0,1,858
01-021-039,704,316,0,316,0,3,313
01-021-040,960,394,0,394,0,2,392
01-021-041,806,278,0,278,0,1,277
01-021-042,956,365,0,365,0,0,365
01-021-043,1032,433,0,433,0,3,430
01-021-044,736,315,0,315,0,2,313
01-021-045,686,297,2,295,-2,0,295
01-021-046,919,338,0,337,-1,1,336
01-021-047,724,276,0,276,0,1,275
01-021-048,815,434,0,434,0,1,433
01-021-049,779,433,0,433,0,0,433
01-021-050,812,379,4,378,-1,3,375
01-021-051,876,438,0,438,0,0,438
01-021-052,766,321,0,321,0,1,320
01-021-053,852,355,0,355,0,0,355
01-021-054,792,417,0,417,0,4,413
01-021-055,875,443,0,443,0,0,443
01-021-056,806,302,1,302,0,0,302
01-021-057,822,360,0,360,0,2,358
01-021-058,974,502,0,502,0,1,501
01-021-059,961,529,0,529,0,2,527
01-021-060,842,444,0,444,0,1,443
01-021-061,756,387,2,386,-1,0,386
01-021-062,850,374,0,373,-1,0,373
01-021-063,743,363,0,363,0,3,360
01-021-064,861,363,0,362,-1,0,362
01-021-065,1080,389,1,389,0,1,388
01-021-066,918,349,0,349,0,2,347
01-021-067,868,301,0,301,0,11,290
01-021-068,966,493,0,493,0,2,491
01-021-069,761,385,0,385,0,2,383
01-021-070,710,223,0,223,0,0,223
01-022-001,1067,688,0,688,0,0,688
01-022-002,927,596,0,595,-1,2,593
01-022-003,1176,739,0,737,-2,3,734
01-022-004,1294,763,0,763,0,2,761
01-022-005,1366,901,0,901,0,4,897
01-022-006,1327,798,0,798,0,0,798
01-022-007,951,452,0,451,-1,4,447
01-022-008,831,381,0,381,0,2,379
01-022-009,819,351,0,351,0,2,349
01-022-010,1382,899,0,899,0,1,898
01-022-011,1176,587,0,584,-3,3,581
01-022-012,1222,762,0,762,0,0,762
01-022-013,1182,620,0,621,1,11,610
01-022-014,1149,661,0,661,0,1,660
01-022-015,1051,582,0,582,0,0,582
01-022-016,1218,667,0,665,-2,4,661
01-022-017,982,517,0,517,0,1,516
01-022-018,1017,476,0,475,-1,1,474
01-022-019,1142,685,0,685,0,2,683
01-022-020,1175,745,1,744,-1,1,743
01-022-021,1141,671,0,671,0,4,667
01-022-022,992,613,0,613,0,1,612
01-022-023,1208,677,0,677,0,1,676
01-022-024,1276,743,0,743,0,4,739
01-022-025,1013,569,0,569,0,1,568
01-022-026,1174,587,0,587,0,1,586
01-022-027,1232,733,0,733,0,3,730
01-022-028,1125,666,1,665,-1,3,662
01-022-029,1307,627,1,626,-1,0,626
01-022-030,1166,590,0,590,0,2,588
01-022-031,1227,666,0,666,0,3,663
01-022-032,1186,670,0,670,0,3,667
01-022-033,1203,632,0,631,-1,1,630
01-022-034,1151,551,1,550,-1,0,550
01-022-035,1240,545,0,545,0,0,545
01-022-036,1425,648,0,648,0,3,645
01-022-037,1308,605,0,605,0,4,601
01-023-001,652,321,0,321,0,3,318
01-023-002,746,337,0,337,0,1,336
01-023-003,972,465,0,465,0,0,465
01-023-004,670,374,0,374,0,3,371
01-023-005,609,257,0,257,0,1,256
01-023-006,852,418,0,417,-1,1,416
01-023-007,711,296,0,296,0,0,296
01-023-008,628,238,0,238,0,0,238
01-023-009,629,307,0,307,0,1,306
01-023-010,618,265,0,265,0,1,264
01-023-011,671,321,0,320,-1,2,318
01-023-012,790,372,0,372,0,5,367
01-023-013,634,324,0,324,0,1,323
01-023-014,745,314,0,314,0,3,311
01-023-015,681,279,0,279,0,1,278
01-023-016,732,349,0,348,-1,1,347
01-023-017,925,508,0,508,0,1,507
01-023-018,699,299,0,299,0,2,297
01-023-019,956,463,0,463,0,2,461
01-023-020,672,283,0,283,0,1,282
01-023-021,838,310,0,310,0,0,310
01-023-022,894,429,0,429,0,4,425
01-023-023,740,317,0,317,0,2,315
01-023-024,724,359,0,359,0,4,355
02-001-001,554,223,0,223,0,0,223
02-002-001,152,40,0,40,0,1,39
02-003-001,324,144,0,144,0,1,143
02-004-001,64,41,0,41,0,0,41
02-005-001,255,96,0,96,0,1,95
02-006-001,816,144,0,144,0,1,143
02-007-001,109,60,0,60,0,1,59
02-008-001,290,92,0,92,0,2,90
02-009-001,144,52,0,52,0,0,52
02-010-001,161,70,0,70,0,1,69
02-011-001,586,227,0,227,0,2,225
02-012-001,86,33,0,33,0,0,33
02-013-001,289,110,0,109,-1,0,109
02-014-001,235,70,0,70,0,0,70
02-015-001,640,181,0,181,0,0,181
02-016-001,148,59,0,59,0,0,59
02-017-001,354,128,0,128,0,2,126
02-018-001,101,61,0,61,0,0,61
02-019-001,153,63,0,63,0,0,63
02-020-001,138,38,0,38,0,0,38
02-021-001,454,176,0,176,0,1,175
02-022-001,326,125,0,125,0,0,125
02-023-001,685,249,0,249,0,3,246
02-023-002,703,253,0,253,0,1,252
02-023-003,662,228,0,228,0,0,228
02-024-001,678,226,0,226,0,1,225
02-025-001,94,42,0,42,0,0,42
02-026-001,195,89,0,89,0,0,89
02-027-001,833,327,0,327,0,2,325
02-028-001,623,267,0,267,0,3,264
02-029-001,426,204,0,204,0,1,203
02-030-001,199,79,0,79,0,1,78
02-031-001,336,129,0,129,0,2,127
02-032-001,183,71,0,71,0,2,69
02-033-001,883,364,0,364,0,2,362
02-034-001,347,123,0,123,0,0,123
02-035-001,220,79,0,79,0,0,79
02-036-001,209,86,0,86,0,0,86
02-036-002,36,24,0,24,0,0,24
02-036-003,70,33,0,33,0,0,33
02-037-001,318,110,0,110,0,0,110
02-038-001,108,40,0,40,0,0,40
02-039-001,255,78,0,78,0,2,76
02-040-001,709,313,0,313,0,1,312
02-040-002,664,289,0,289,0,0,289
02-040-003,862,443,0,443,0,2,441
02-040-004,656,311,0,311,0,0,311
02-041-001,484,178,0,178,0,2,176
02-041-002,411,114,0,114,0,0,114
02-042-001,70,28,0,28,0,0,28
02-043-001,117,47,0,47,0,0,47
02-044-001,530,157,0,157,0,1,156
02-045-001,71,34,0,34,0,1,33
02-046-001,291,62,0,62,0,10,52
02-047-001,503,228,0,228,0,1,227
02-048-001,319,106,0,106,0,0,106
02-049-001,130,64,0,64,0,2,62
02-050-001,165,52,0,52,0,0,52
02-051-001,461,133,0,133,0,0,133
02-052-001,67,31,0,31,0,1,30
02-053-001,556,175,0,174,-1,1,173
02-054-001,149,56,0,56,0,1,55
02-055-001,185,68,0,68,0,0,68
02-056-001,389,137,0,137,0,1,136
02-057-001,131,59,0,59,0,1,58
02-058-001,103,36,0,36,0,1,35
02-059-001,209,56,0,56,0,0,56
02-060-001,68,14,0,14,0,0,14
02-061-001,552,210,0,210,0,1,209
02-062-001,149,61,1,61,0,1,60
02-063-001,337,112,0,112,0,0,112
02-064-001,817,257,0,257,0,2,255
02-064-002,746,305,0,305,0,0,305
02-065-001,793,290,1,289,-1,2,287
02-066-001,244,81,0,81,0,0,81
02-067-001,624,234,0,234,0,0,234
02-068-001,179,87,0,87,0,0,87
02-069-001,297,103,0,103,0,1,102
02-070-001,60,37,0,37,0,1,36
02-071-001,290,89,0,89,0,1,88
02-072-001,241,81,0,81,0,0,81
02-073-001,157,62,0,62,0,0,62
02-074-001,155,89,0,89,0,3,86
02-075-001,112,35,0,35,0,0,35
02-076-001,723,264,0,264,0,2,262
02-077-001,240,85,0,85,0,1,84
02-078-001,404,142,0,142,0,0,142
02-079-001,374,175,0,175,0,0,175
02-079-002,256,88,0,88,0,0,88
02-080-001,162,41,0,41,0,0,41
02-081-001,258,56,0,56,0,0,56
02-082-001,220,58,0,58,0,2,56
02-083-001,488,177,0,177,0,3,174
02-083-002,184,61,0,61,0,4,57
02-084-001,623,246,0,246,0,0,246
02-084-002,540,193,0,193,0,0,193
02-084-003,141,47,0,47,0,0,47
02-085-001,316,112,0,112,0,0,112
02-086-001,577,225,1,224,-1,1,223
02-087-001,106,43,0,43,0,0,43
02-088-001,230,50,0,50,0,0,50
02-089-001,728,332,0,332,0,3,329
02-089-002,915,442,0,442,0,2,440
02-089-003,1184,697,0,697,0,6,691
02-089-004,1139,440,0,440,0,3,437
02-090-001,243,142,0,142,0,2,140
02-091-001,117,59,0,59,0,1,58
02-092-001,330,119,0,119,0,0,119
02-093-001,288,98,0,98,0,1,97
02-094-001,365,128,0,128,0,0,128
02-095-001,850,314,0,314,0,3,311
02-095-002,853,331,0,331,0,2,329
02-096-001,340,150,0,150,0,1,149
02-096-002,502,181,0,181,0,2,179
02-097-001,177,68,0,68,0,0,68
02-098-001,370,108,0,108,0,0,108
02-098-002,401,147,0,147,0,0,147
02-099-001,476,199,0,199,0,3,196
02-100-001,45,27,0,27,0,1,26
02-101-001,982,404,0,404,0,1,403
02-101-002,863,389,0,389,0,2,387
02-101-003,909,335,0,335,0,1,334
02-102-001,52,28,0,28,0,0,28
02-103-001,175,72,0,72,0,0,72
02-104-001,207,85,0,85,0,2,83
02-105-001,176,86,0,86,0,1,85
02-106-001,101,46,0,46,0,0,46
02-107-001,193,83,0,83,0,0,83
02-108-001,221,75,0,75,0,1,74
02-109-001,125,50,0,50,0,1,49
02-110-001,162,55,0,55,0,3,52
02-111-001,272,108,0,108,0,2,106
02-112-001,250,84,0,84,0,3,81
02-113-001,256,111,0,111,0,0,111
02-114-001,50,32,0,32,0,2,30
02-115-001,1104,477,0,476,-1,0,476
02-116-001,143,75,0,75,0,1,74
02-117-001,390,161,0,161,0,1,160
02-118-001,571,196,0,196,0,2,194
02-119-001,743,199,0,199,0,0,199
02-120-001,157,57,0,57,0,0,57
02-121-001,62,28,0,28,0,0,28
02-122-001,88,28,0,28,0,0,28
02-123-001,95,45,0,45,0,0,45
02-124-001,193,62,0,62,0,0,62
02-125-001,152,53,0,53,0,1,52
02-126-001,408,131,0,131,0,1,130
02-127-001,174,64,0,64,0,0,64
02-128-001,111,59,0,59,0,0,59
02-129-001,201,88,0,88,0,0,88
02-130-001,247,89,0,89,0,2,87
02-131-001,155,65,0,65,0,2,63
02-132-001,124,62,0,62,0,0,62
02-132-002,76,16,0,16,0,0,16
02-133-001,101,35,0,35,0,0,35
02-134-001,170,52,0,52,0,0,52
02-135-001,256,100,0,100,0,0,100
02-136-001,251,82,0,82,0,0,82
02-137-001,933,312,0,312,0,4,308
02-137-002,896,335,0,335,0,1,334
02-137-003,1099,443,0,443,0,2,441
02-137-004,1092,438,0,438,0,1,437
02-137-005,1052,352,0,351,-1,0,351
02-137-006,1194,397,0,397,0,1,396
02-137-007,862,343,1,342,-1,2,340
02-137-008,852,395,0,395,0,0,395
02-137-009,1307,506,0,506,0,2,504
02-137-010,726,293,0,293,0,2,291
02-137-011,778,333,0,333,0,0,333
02-137-012,1195,342,0,342,0,6,336
02-137-013,1195,400,0,399,-1,1,398
02-137-014,1154,421,0,421,0,0,421
02-137-015,1183,434,0,434,0,1,433
02-137-016,910,294,0,294,0,1,293
02-137-017,1325,377,0,377,0,0,377
02-137-018,838,365,0,365,0,3,362
02-137-019,752,344,0,344,0,2,342
02-137-020,342,158,1,157,-1,0,157
02-137-021,610,210,0,210,0,1,209
02-137-022,158,83,0,83,0,0,83
02-138-001,209,65,0,65,0,1,64
02-139-001,60,38,0,38,0,0,38
02-140-001,1008,404,0,404,0,0,404
02-140-002,882,457,0,457,0,3,454
02-140-003,1024,462,0,462,0,0,462
02-140-004,946,434,0,434,0,1,433
02-140-005,976,408,0,408,0,1,407
02-141-001,167,59,0,59,0,2,57
02-142-001,179,59,0,59,0,0,59
02-143-001,562,234,0,234,0,1,233
02-144-001,820,253,0,253,0,1,252
02-145-001,584,252,0,252,0,1,251
02-145-002,488,137,0,137,0,1,136
02-146-001,276,102,0,102,0,2,100
02-147-001,153,83,0,83,0,1,82
02-148-001,1075,452,0,452,0,2,450
02-148-002,964,333,0,333,0,1,332
02-149-001,320,110,0,110,0,0,110
02-150-001,410,141,0,141,0,3,138
02-151-001,163,59,0,59,0,0,59
02-152-001,220,73,0,73,0,0,73
02-153-001,236,69,0,69,0,0,69
02-154-001,160,42,0,42,0,0,42
02-155-001,767,279,0,279,0,3,276
02-156-001,626,219,0,219,0,2,217
02-157-001,439,207,0,207,0,0,207
02-157-002,97,56,0,56,0,0,56
02-158-001,56,30,0,30,0,0,30
02-159-001,237,71,0,71,0,0,71
02-160-001,257,109,0,109,0,0,109
02-161-001,827,363,0,363,0,3,360
02-162-001,158,60,0,60,0,0,60
02-163-001,761,277,0,277,0,0,277
02-164-001,155,70,0,70,0,3,67
02-165-001,51,25,0,25,0,0,25
02-166-001,64,42,0,42,0,2,40
02-167-001,186,116,0,116,0,3,113
02-168-001,281,111,0,111,0,2,109
02-169-001,975,356,0,356,0,2,354
02-169-002,911,282,0,282,0,0,282
02-170-001,648,285,0,285,0,2,283
02-171-001,164,71,0,71,0,1,70
02-172-001,412,140,0,140,0,0,140
02-173-001,358,163,0,163,0,1,162
02-174-001,710,256,0,256,0,0,256
02-174-002,245,112,0,112,0,2,110
02-175-001,662,293,0,293,0,6,287
02-175-002,659,304,0,304,0,0,304
02-176-001,355,154,0,154,0,0,154
02-177-001,226,90,0,90,0,0,90
02-178-001,206,52,0,52,0,0,52
02-179-001,91,40,0,40,0,0,40
02-180-001,260,98,0,98,0,2,96
02-180-002,372,154,0,154,0,0,154
02-181-001,824,386,0,386,0,2,384
02-181-002,635,268,0,268,0,0,268
02-181-003,586,248,0,248,0,0,248
02-181-004,840,370,0,370,0,1,369
02-181-005,582,256,0,256,0,1,255
02-181-006,615,281,0,281,0,4,277
02-181-007,848,393,0,393,0,2,391
02-181-008,702,322,0,322,0,3,319
02-181-009,613,160,0,160,0,2,158
02-181-010,857,305,0,305,0,0,305
02-181-011,807,276,0,276,0,1,275
02-181-012,934,378,0,378,0,2,376
02-181-013,731,353,0,353,0,1,352
02-181-014,778,365,0,365,0,1,364
02-181-015,810,310,0,310,0,0,310
02-181-016,821,247,0,247,0,2,245
02-181-017,789,219,0,219,0,1,218
02-181-018,828,273,0,273,0,0,273
02-181-019,743,279,0,279,0,4,275
02-181-020,106,33,0,33,0,0,33
02-181-021,197,82,0,82,0,1,81
02-181-022,59,20,0,20,0,0,20
02-181-023,481,182,0,182,0,0,182
02-182-001,147,54,0,54,0,0,54
02-183-001,129,52,0,52,0,0,52
02-184-001,453,136,0,136,0,0,136
02-184-002,241,68,0,68,0,0,68
02-185-001,137,62,0,62,0,0,62
02-186-001,110,52,0,52,0,1,51
02-187-001,479,122,0,122,0,1,121
02-188-001,254,100,0,100,0,0,100
02-189-001,594,190,0,190,0,0,190
02-189-002,606,194,0,194,0,0,194
02-190-001,753,347,0,347,0,2,345
02-190-002,796,353,0,353,0,4,349
02-191-001,580,304,1,302,-2,0,302
02-192-001,312,136,0,136,0,2,134
02-193-001,552,224,0,224,0,1,223
02-194-001,279,117,0,117,0,1,116
02-195-001,255,122,0,122,0,0,122
02-196-001,100,36,0,36,0,0,36
02-196-002,94,43,0,43,0,0,43
02-197-001,193,61,0,61,0,0,61
02-198-001,124,53,0,53,0,0,53
02-199-001,62,22,0,22,0,0,22
02-200-001,506,208,0,208,0,2,206
02-201-001,235,114,0,114,0,2,112
02-202-001,873,432,0,432,0,1,431
02-203-001,237,97,0,97,0,2,95
02-204-001,110,70,0,70,0,4,66
02-205-001,340,109,0,109,0,0,109
02-206-001,288,130,0,130,0,2,128
02-207-001,123,56,0,56,0,0,56
02-208-001,72,43,0,43,0,1,42
02-209-001,225,93,0,93,0,0,93
02-210-001,338,166,0,166,0,1,165
02-210-002,373,182,0,182,0,2,180
02-211-001,284,93,0,93,0,0,93
02-212-001,133,73,0,73,0,0,73
02-213-001,956,369,0,369,0,0,369
02-213-002,850,337,0,337,0,1,336
02-214-001,133,63,0,63,0,0,63
02-215-001,164,76,0,76,0,0,76
02-216-001,103,48,0,48,0,0,48
02-217-001,800,332,0,332,0,1,331
02-217-002,585,236,0,236,0,0,236
02-217-003,629,214,0,214,0,3,211
02-217-004,597,211,0,211,0,0,211
02-217-005,801,315,0,315,0,2,313
02-217-006,862,328,0,328,0,3,325
02-217-007,851,299,0,299,0,1,298
02-217-008,817,276,0,276,0,1,275
02-217-009,1029,400,0,400,0,3,397
02-217-010,865,278,0,278,0,1,277
02-217-011,721,345,0,345,0,8,337
02-217-012,988,268,0,268,0,1,267
02-217-013,730,324,0,324,0,0,324
02-217-014,684,177,0,177,0,0,177
02-217-015,599,206,0,206,0,3,203
02-217-016,745,242,0,242,0,5,237
02-217-017,645,219,0,219,0,1,218
02-217-018,863,413,0,413,0,0,413
02-217-019,858,394,0,394,0,1,393
02-217-020,658,258,0,258,0,1,257
02-217-021,914,422,0,421,-1,1,420
02-217-022,1198,487,0,487,0,1,486
02-217-023,988,480,0,480,0,11,469
02-217-024,157,89,0,89,0,0,89
02-217-025,723,251,0,251,0,0,251
02-217-026,611,251,0,251,0,0,251
02-217-027,995,536,0,536,0,1,535
02-217-028,856,455,0,455,0,1,454
02-217-029,724,352,0,352,0,2,350
02-217-030,764,374,0,374,0,0,374
02-217-031,644,267,0,267,0,1,266
02-217-032,720,304,0,304,0,2,302
02-217-033,803,413,0,413,0,1,412
02-217-034,729,387,0,387,0,0,387
02-217-035,575,268,0,268,0,1,267
02-217-036,602,273,0,272,-1,0,272
02-217-037,731,407,0,407,0,1,406
02-217-038,916,450,0,450,0,0,450
02-217-039,797,310,0,310,0,0,310
02-217-040,653,223,0,223,0,0,223
02-217-041,1092,504,0,504,0,3,501
02-217-042,641,270,0,270,0,3,267
02-217-043,596,226,0,226,0,2,224
02-217-044,582,219,0,219,0,1,218
02-217-045,592,284,0,284,0,1,283
02-217-046,740,392,0,392,0,0,392
02-217-047,2729,1481,1,1480,-1,5,1475
02-217-048,591,300,0,300,0,0,300
02-217-049,626,359,0,359,0,1,358
02-217-050,601,349,0,348,-1,2,346
02-217-051,679,352,0,352,0,4,348
02-217-052,657,342,0,342,0,1,341
02-217-053,774,401,2,399,-2,2,397
02-217-054,918,493,0,493,0,4,489
02-217-055,645,376,0,375,-1,1,374
02-217-056,734,381,0,381,0,3,378
02-217-057,624,306,0,306,0,1,305
02-217-058,715,379,0,379,0,3,376
02-217-059,667,308,0,308,0,3,305
02-217-060,766,409,0,409,0,1,408
02-217-061,729,359,1,358,-1,1,357
02-217-062,582,305,0,305,0,1,304
02-217-063,623,315,0,315,0,0,315
02-217-064,656,371,0,371,0,3,368
02-217-065,579,315,0,315,0,1,314
02-217-066,591,363,0,363,0,6,357
02-217-067,686,395,0,395,0,1,394
02-217-068,583,356,0,356,0,1,355
02-217-069,742,460,0,460,0,0,460
02-217-070,968,571,0,571,0,4,567
02-217-071,861,499,0,499,0,2,497
02-217-072,622,372,0,372,0,4,368
02-217-073,648,320,0,320,0,1,319
02-217-074,646,278,0,278,0,0,278
02-217-075,614,300,0,300,0,0,300
02-217-076,867,492,0,491,-1,2,489
02-217-077,925,545,0,545,0,2,543
02-217-078,609,296,0,296,0,1,295
02-217-079,596,280,0,280,0,2,278
02-217-080,628,284,0,284,0,2,282
02-217-081,589,261,0,260,-1,3,257
02-217-082,598,254,0,254,0,2,252
02-217-083,600,289,0,289,0,4,285
02-217-084,684,301,0,301,0,2,299
02-217-085,682,328,0,328,0,3,325
02-217-086,598,330,0,330,0,1,329
02-217-087,613,281,0,281,0,2,279
02-217-088,768,401,0,400,-1,6,394
02-217-089,595,276,0,276,0,0,276
02-217-090,753,271,0,271,0,3,268
02-217-091,650,361,0,361,0,0,361
02-217-092,630,306,0,305,-1,1,304
02-217-093,1086,557,0,557,0,1,556
02-217-094,990,385,0,385,0,1,384
02-217-095,1042,502,0,502,0,5,497
02-217-096,899,433,0,433,0,3,430
02-217-097,940,485,0,485,0,1,484
02-217-098,916,436,0,436,0,1,435
02-217-099,990,495,0,495,0,0,495
02-217-100,1137,615,0,615,0,1,614
02-217-101,1013,474,0,473,-1,0,473
02-217-102,1122,521,0,521,0,0,521
02-217-103,1002,464,0,464,0,4,460
02-217-104,805,450,0,450,0,4,446
02-217-105,730,379,0,379,0,0,379
02-217-106,620,336,0,336,0,1,335
02-217-107,762,360,2,360,0,3,357
02-217-108,802,373,0,373,0,0,373
02-217-109,673,252,0,252,0,4,248
02-217-110,660,267,0,267,0,0,267
02-217-111,824,310,0,309,-1,1,308
02-217-112,732,268,0,268,0,2,266
02-217-113,687,298,0,298,0,0,298
02-217-114,640,291,0,291,0,2,289
02-217-115,765,290,0,290,0,2,288
02-217-116,836,394,0,394,0,1,393
02-217-117,669,291,0,291,0,0,291
02-217-118,725,286,0,286,0,0,286
02-217-119,795,312,0,311,-1,0,311
02-217-120,616,269,0,269,0,2,267
02-217-121,640,222,0,222,0,1,221
02-217-122,635,260,0,260,0,0,260
02-217-123,811,315,0,315,0,0,315
02-217-124,1099,477,0,477,0,1,476
02-217-125,910,462,1,460,-2,0,460
02-217-126,655,247,4,243,-4,1,242
02-217-127,606,254,0,254,0,0,254
02-217-128,801,316,0,316,0,1,315
02-217-129,888,329,0,329,0,0,329
02-217-130,916,343,0,343,0,1,342
02-217-131,911,362,0,362,0,0,362
02-217-132,599,232,0,232,0,0,232
02-217-133,968,411,0,411,0,6,405
02-217-134,817,360,1,359,-1,0,359
02-217-135,674,286,0,286,0,2,284
02-217-136,995,404,0,402,-2,0,402
02-217-137,1008,421,0,421,0,1,420
02-217-138,1351,607,0,607,0,2,605
02-217-139,910,367,0,367,0,1,366
02-217-140,1254,440,0,440,0,0,440
02-217-141,775,291,0,291,0,1,290
02-217-142,979,410,0,410,0,2,408
02-217-143,989,403,0,403,0,0,403
02-217-144,878,407,0,407,0,0,407
02-217-145,960,360,0,360,0,0,360
02-217-146,1092,498,0,498,0,1,497
02-217-147,832,327,0,327,0,2,325
02-217-148,801,381,0,381,0,1,380
02-217-149,707,261,0,261,0,6,255
02-218-001,87,34,0,34,0,0,34
02-219-001,92,44,0,44,0,1,43
02-220-001,644,302,0,302,0,1,301
02-221-001,1113,541,0,541,0,1,540
02-221-002,1111,521,0,521,0,1,520
02-221-003,1004,405,0,405,0,4,401
02-222-001,177,109,0,109,0,0,109
02-223-001,1014,464,0,464,0,1,463
02-224-001,143,50,0,50,0,2,48
02-225-001,164,67,0,67,0,1,66
02-226-001,139,33,0,33,0,1,32
02-227-001,429,184,0,184,0,1,183
02-228-001,270,90,0,90,0,0,90
02-229-001,166,82,0,82,0,0,82
02-230-001,105,40,0,40,0,0,40
02-231-001,659,205,0,205,0,1,204
02-231-002,563,226,0,226,0,1,225
02-231-003,762,298,0,298,0,1,297
02-231-004,556,203,0,203,0,2,201
02-232-001,517,190,0,190,0,2,188
02-233-001,679,249,0,249,0,0,249
02-233-002,781,257,0,257,0,5,252
02-233-003,810,279,0,279,0,0,279
02-234-001,663,284,0,284,0,1,283
02-234-002,587,254,0,253,-1,0,253
02-234-003,897,310,0,310,0,2,308
02-234-004,939,373,0,373,0,0,373
02-234-005,997,414,0,414,0,0,414
02-234-006,985,412,0,412,0,1,411
02-234-007,991,358,0,358,0,0,358
02-234-008,851,356,0,356,0,0,356
02-234-009,1051,350,0,350,0,1,349
02-235-001,115,45,0,45,0,4,41
02-236-001,310,80,0,80,0,0,80
02-237-001,661,254,0,254,0,1,253
02-237-002,587,258,0,258,0,3,255
02-238-001,382,148,0,148,0,1,147
02-239-001,262,58,0,58,0,0,58
02-240-001,205,74,0,74,0,0,74
02-240-002,128,46,0,46,0,0,46
02-241-001,180,61,0,61,0,0,61
02-242-001,140,68,0,68,0,0,68
02-243-001,274,65,0,65,0,1,64
02-243-002,71,31,0,31,0,0,31
02-244-001,655,269,0,269,0,1,268
02-245-001,646,310,0,310,0,1,309
02-246-001,265,100,0,100,0,0,100
02-247-001,765,302,0,302,0,1,301
02-247-002,173,77,0,77,0,0,77
02-248-001,181,85,0,85,0,1,84
02-249-001,255,85,0,85,0,0,85
02-250-001,93,52,0,52,0,0,52
02-251-001,35,16,0,16,0,0,16
02-252-001,986,339,0,339,0,2,337
02-252-002,934,343,0,343,0,3,340
02-253-001,291,127,0,127,0,0,127
02-254-001,743,289,0,289,0,3,286
02-254-002,704,211,0,211,0,1,210
02-255-001,118,48,0,48,0,0,48
02-256-001,393,156,0,156,0,0,156
02-257-001,244,78,0,78,0,0,78
02-258-001,295,102,0,102,0,0,102
02-259-001,77,36,0,36,0,1,35
02-260-001,404,129,0,129,0,2,127
02-260-002,256,92,0,92,0,0,92
02-261-001,927,337,1,336,-1,0,336
02-261-002,583,188,0,188,0,0,188
02-261-003,667,256,0,256,0,0,256
02-261-004,736,296,0,296,0,1,295
02-261-005,793,257,1,256,-1,3,253
02-261-006,763,255,0,255,0,3,252
02-261-007,655,250,0,250,0,0,250
02-261-008,172,50,0,50,0,0,50
02-262-001,463,189,0,189,0,0,189
02-263-001,1019,400,0,400,0,2,398
02-263-002,1095,439,0,439,0,3,436
02-263-003,1015,393,0,393,0,4,389
02-263-004,702,297,0,297,0,2,295
02-263-005,589,245,0,245,0,1,244
02-263-006,1057,355,0,355,0,1,354
02-263-007,1030,417,0,417,0,1,416
02-263-008,666,250,0,250,0,0,250
02-263-009,587,218,0,218,0,1,217
02-263-010,255,75,0,75,0,2,73
02-263-011,532,149,0,149,0,1,148
02-264-001,229,96,0,96,0,0,96
02-265-001,116,50,0,50,0,0,50
02-266-001,55,24,0,24,0,0,24
02-267-001,99,40,0,40,0,0,40
02-268-001,305,105,0,105,0,2,103
02-269-001,190,71,0,71,0,1,70
02-270-001,222,90,0,90,0,0,90
02-271-001,71,32,0,32,0,0,32
02-272-001,251,65,0,65,0,0,65
02-273-001,44,26,0,26,0,0,26
02-274-001,194,58,0,58,0,1,57
02-275-001,157,52,0,52,0,0,52
02-276-001,245,70,0,70,0,0,70
02-277-001,222,83,0,83,0,0,83
02-278-001,95,50,0,50,0,0,50
02-279-001,120,57,0,57,0,0,57
02-280-001,433,131,0,131,0,2,129
02-281-001,220,103,0,103,0,1,102
02-282-001,124,65,0,65,0,0,65
02-283-001,828,276,0,276,0,2,274
02-284-001,729,278,0,278,0,0,278
02-284-002,705,218,0,218,0,1,217
02-285-001,64,41,0,41,0,0,41
02-286-001,98,36,0,36,0,0,36
02-287-001,162,46,0,46,0,0,46
02-288-001,904,273,0,273,0,5,268
02-289-001,109,44,0,44,0,0,44
02-290-001,128,53,0,53,0,0,53
02-291-001,104,34,0,34,0,0,34
02-292-001,682,150,0,150,0,1,149
02-293-001,117,49,0,49,0,1,48
02-294-001,648,278,0,278,0,2,276
02-294-002,505,171,0,171,0,1,170
02-295-001,928,420,1,419,-1,2,417
02-295-002,839,384,0,384,0,0,384
02-295-003,167,77,0,77,0,1,76
02-296-001,223,132,0,132,0,0,132
02-297-001,668,261,0,261,0,1,260
02-298-001,199,86,0,86,0,0,86
02-299-001,266,91,0,91,0,0,91
02-300-001,358,185,0,185,0,0,185
02-301-001,237,73,0,73,0,0,73
03-001-001,1401,565,0,565,0,3,562
03-001-002,1321,481,1,480,-1,3,477
03-002-001,839,299,0,299,0,0,299
03-002-002,828,274,0,274,0,1,273
03-003-001,799,289,0,289,0,7,282
03-003-002,745,283,0,283,0,3,280
03-004-001,976,415,0,415,0,3,412
03-004-002,1234,519,0,519,0,1,518
03-004-003,871,403,0,403,0,0,403
03-004-004,1008,427,0,427,0,0,427
03-004-005,1000,495,0,495,0,4,491
03-004-006,1119,518,0,518,0,0,518
03-004-007,917,471,0,471,0,2,469
03-004-008,778,351,0,351,0,2,349
03-004-009,923,438,0,438,0,7,431
03-004-010,1057,478,0,478,0,1,477
03-004-011,798,388,0,387,-1,2,385
03-004-012,958,496,0,496,0,5,491
03-004-013,861,413,0,413,0,2,411
03-004-014,1033,438,0,437,-1,3,434
03-004-015,1103,465,0,465,0,3,462
03-004-016,1186,452,0,452,0,1,451
03-004-017,930,423,0,423,0,1,422
03-004-018,920,414,0,414,0,4,410
03-004-019,648,335,1,335,0,1,334
03-004-020,1241,584,0,583,-1,1,582
03-004-021,1127,508,0,507,-1,1,506
03-004-022,973,361,0,361,0,1,360
03-004-023,989,405,0,405,0,2,403
03-004-024,1079,443,0,442,-1,1,441
03-004-025,912,353,0,353,0,4,349
03-004-026,814,356,0,356,0,0,356
03-004-027,991,435,0,435,0,2,433
03-004-028,708,306,0,306,0,0,306
03-004-029,1100,376,0,376,0,1,375
03-004-030,221,60,0,60,0,0,60
03-004-031,374,116,0,116,0,0,116
03-004-032,486,153,0,153,0,0,153
03-005-001,747,357,0,357,0,0,357
03-005-002,988,284,0,284,0,4,280
03-005-003,1097,440,0,440,0,5,435
03-006-001,1069,341,0,341,0,1,340
03-006-002,142,41,0,41,0,0,41
03-007-001,932,315,0,315,0,1,314
03-007-002,925,296,2,296,0,1,295
03-007-003,819,317,0,317,0,6,311
03-007-004,936,335,0,335,0,8,327
03-007-005,882,343,0,342,-1,0,342
03-007-006,928,416,0,416,0,4,412
03-008-001,1096,350,0,350,0,5,345
03-008-002,1080,362,0,362,0,7,355
03-009-001,935,309,0,309,0,1,308
03-010-001,137,72,0,72,0,0,72
03-011-001,273,101,0,101,0,1,100
03-012-001,652,257,0,257,0,2,255
03-012-002,639,247,0,247,0,2,245
03-013-001,842,321,0,321,0,0,321
03-013-002,850,351,0,351,0,0,351
03-014-001,1062,366,0,366,0,3,363
03-015-001,756,281,0,281,0,2,279
03-015-002,730,300,0,300,0,3,297
03-016-001,947,342,0,342,0,1,341
03-016-002,893,350,0,350,0,2,348
03-016-003,326,129,0,129,0,0,129
03-017-001,219,87,0,87,0,0,87
03-018-001,654,248,0,248,0,1,247
03-018-002,623,278,0,278,0,1,277
03-018-003,641,279,0,279,0,4,275
03-019-001,582,255,0,255,0,1,254
03-019-002,629,224,0,224,0,5,219
03-020-001,622,238,0,238,0,0,238
03-020-002,836,282,0,282,0,4,278
03-021-001,845,365,0,365,0,5,360
03-021-002,854,326,0,326,0,4,322
03-022-001,658,233,0,233,0,1,232
03-023-001,682,242,0,242,0,1,241
03-023-002,587,233,0,233,0,4,229
03-024-001,781,299,0,299,0,6,293
03-024-002,750,322,0,322,0,1,321
03-024-003,169,59,0,59,0,0,59
03-025-001,275,119,0,119,0,1,118
03-026-001,625,192,0,192,0,0,192
03-026-002,583,172,0,172,0,0,172
03-027-001,752,304,0,304,0,5,299
03-028-001,908,317,0,317,0,5,312
03-028-002,845,379,0,379,0,3,376
03-028-003,940,303,0,302,-1,1,301
03-029-001,672,254,0,254,0,4,250
03-030-001,467,140,0,140,0,2,138
03-031-001,780,280,0,280,0,5,275
03-031-002,814,279,0,279,0,1,278
03-031-003,782,240,0,240,0,1,239
03-031-004,767,198,0,198,0,0,198
03-032-001,784,326,0,326,0,1,325
03-032-002,863,302,0,302,0,0,302
03-032-003,823,325,0,325,0,0,325
03-033-001,1112,403,0,403,0,0,403
03-033-002,1210,404,0,404,0,2,402
03-034-001,508,180,0,180,0,0,180
03-035-001,768,273,0,273,0,2,271
03-035-002,613,232,0,232,0,0,232
03-036-001,785,304,0,304,0,0,304
03-037-001,958,346,0,346,0,1,345
03-037-002,593,236,0,236,0,1,235
03-038-001,701,267,0,267,0,3,264
03-038-002,608,218,0,218,0,0,218
03-039-001,724,316,0,316,0,2,314
03-040-001,929,393,0,393,0,1,392
03-041-001,914,284,1,283,-1,6,277
03-041-002,910,350,0,350,0,2,348
03-042-001,740,257,0,257,0,1,256
03-042-002,921,290,0,290,0,2,288
03-043-001,782,341,0,341,0,5,336
03-044-001,799,309,0,309,0,2,307
03-045-001,854,357,0,357,0,3,354
03-045-002,851,337,0,337,0,2,335
03-045-003,737,299,0,299,0,0,299
03-046-001,704,317,0,317,0,3,314
03-047-001,887,462,0,462,0,3,459
03-047-002,930,406,0,406,0,1,405
03-047-003,941,425,0,425,0,0,425
03-047-004,57,28,0,28,0,1,27
03-047-005,77,16,0,16,0,0,16
03-048-001,1382,511,0,511,0,3,508
03-048-002,1241,469,0,469,0,0,469
03-048-003,1087,350,0,350,0,3,347
03-049-001,867,326,0,326,0,1,325
03-049-002,770,242,0,242,0,3,239
03-050-001,658,279,0,279,0,3,276
03-050-002,188,95,0,95,0,0,95
03-050-003,123,39,0,39,0,0,39
03-050-004,136,65,0,65,0,1,64
03-051-001,539,194,0,194,0,0,194
03-052-001,803,313,0,313,0,4,309
03-052-002,1006,402,0,402,0,4,398
03-052-003,838,330,0,330,0,1,329
03-052-004,880,252,0,252,0,5,247
03-052-005,971,370,0,370,0,0,370
03-052-006,254,87,0,87,0,0,87
03-053-001,1136,447,0,447,0,7,440
03-053-002,1033,406,0,406,0,4,402
03-054-001,834,255,0,253,-2,2,251
03-054-002,914,409,0,409,0,3,406
03-054-003,945,384,1,383,-1,3,380
03-054-004,848,262,4,269,7,53,216
03-054-005,854,307,0,307,0,2,305
03-054-006,804,351,0,351,0,4,347
03-054-007,813,309,0,309,0,2,307
03-054-008,931,343,0,343,0,4,339
03-055-001,1096,420,0,420,0,2,418
03-055-002,950,388,0,388,0,1,387
03-056-001,904,436,0,436,0,1,435
03-056-002,938,449,0,449,0,0,449
03-056-003,883,451,0,451,0,0,451
03-056-004,765,308,0,308,0,5,303
03-056-005,752,353,0,353,0,7,346
03-056-006,961,375,0,375,0,1,374
03-056-007,731,304,0,304,0,4,300
03-056-008,852,318,0,318,0,3,315
03-056-009,170,70,0,70,0,1,69
03-056-010,775,262,0,262,0,2,260
03-056-011,793,303,0,303,0,0,303
03-056-012,648,347,0,347,0,7,340
03-056-013,929,479,0,479,0,1,478
03-056-014,725,336,0,336,0,0,336
03-056-015,796,433,0,433,0,3,430
03-056-016,825,416,0,416,0,1,415
03-056-017,772,310,0,310,0,0,310
03-057-001,815,319,0,319,0,5,314
03-058-001,732,214,0,214,0,4,210
03-058-002,754,212,0,212,0,1,211
03-059-001,1031,339,0,339,0,0,339
03-059-002,996,351,0,351,0,1,350
03-059-003,803,392,0,392,0,2,390
03-059-004,774,373,0,373,0,1,372
03-059-005,915,379,0,379,0,3,376
03-059-006,950,336,0,336,0,1,335
03-059-007,601,155,0,155,0,14,141
03-059-008,790,323,0,323,0,2,321
03-060-001,812,434,0,434,0,0,434
03-060-002,1123,605,0,605,0,2,603
03-060-003,829,420,0,420,0,3,417
03-060-004,912,513,0,512,-1,0,512
03-060-005,583,306,0,306,0,0,306
03-060-006,993,345,0,345,0,5,340
03-060-007,1033,402,0,402,0,0,402
03-060-008,1231,430,0,430,0,4,426
03-060-009,960,439,0,439,0,6,433
03-060-010,871,441,0,441,0,0,441
03-060-011,1096,499,0,499,0,0,499
03-060-012,819,360,0,360,0,1,359
03-060-013,771,388,0,388,0,4,384
03-060-014,860,401,0,401,0,4,397
03-060-015,872,453,0,453,0,2,451
03-060-016,883,506,0,506,0,3,503
03-060-017,774,412,0,412,0,2,410
03-060-018,712,277,0,277,0,1,276
03-060-019,1169,538,0,538,0,5,533
03-060-020,832,339,0,339,0,2,337
03-060-021,868,380,0,380,0,6,374
03-060-022,951,356,0,356,0,2,354
03-060-023,894,361,2,358,-3,2,356
03-060-024,1040,337,0,337,0,0,337
03-060-025,580,184,0,184,0,0,184
03-060-026,1009,355,0,355,0,1,354
03-060-027,818,464,0,464,0,6,458
03-060-028,1048,403,0,403,0,1,402
03-060-029,1104,434,0,434,0,2,432
03-060-030,832,362,4,358,-4,0,358
03-060-031,723,346,0,346,0,1,345
03-060-032,919,372,0,372,0,1,371
03-060-033,633,277,0,277,0,2,275
03-060-034,1113,452,0,452,0,0,452
03-060-035,853,373,0,372,-1,2,370
03-060-036,981,406,0,406,0,1,405
03-060-037,1058,397,2,397,0,2,395
03-060-038,828,333,0,333,0,1,332
03-060-039,657,355,0,355,0,1,354
03-060-040,939,578,0,578,0,1,577
03-060-041,1022,521,0,521,0,2,519
03-060-042,809,455,0,456,1,16,440
03-060-043,1087,467,0,467,0,4,463
03-060-044,1018,442,0,441,-1,3,438
03-060-045,621,358,0,358,0,3,355
03-060-046,1033,491,0,491,0,2,489
03-060-047,1447,949,0,949,0,3,946
03-060-048,1092,566,0,566,0,2,564
03-060-049,1040,480,0,480,0,4,476
03-060-050,512,289,0,288,-1,0,288
03-060-051,758,322,0,322,0,4,318
03-060-052,1018,461,0,461,0,1,460
03-060-053,1067,502,0,502,0,2,500
03-060-054,871,386,0,386,0,0,386
03-060-055,800,139,0,139,0,0,139
03-060-056,708,146,0,146,0,3,143
03-060-057,871,390,2,387,-3,0,387
03-060-058,1151,593,0,593,0,1,592
03-060-059,1058,497,0,497,0,4,493
03-060-060,598,292,0,292,0,1,291
03-060-061,565,246,0,246,0,0,246
03-060-062,878,413,0,413,0,1,412
03-060-063,757,316,0,316,0,0,316
03-060-064,1063,519,0,519,0,3,516
03-060-065,918,420,0,420,0,1,419
03-060-066,925,382,0,381,-1,3,378
03-060-067,1006,466,0,466,0,2,464
03-060-068,599,192,0,192,0,0,192
03-060-069,978,415,0,415,0,1,414
03-060-070,1046,430,0,430,0,0,430
03-060-071,700,164,0,164,0,0,164
03-060-072,801,264,0,264,0,1,263
03-060-073,1186,347,0,347,0,1,346
03-060-074,1054,520,0,520,0,0,520
03-060-075,1154,487,0,487,0,3,484
03-060-076,845,273,0,273,0,3,270
03-060-077,699,248,0,248,0,0,248
03-060-078,588,204,0,204,0,2,202
03-060-079,937,440,0,439,-1,3,436
03-060-080,723,305,0,305,0,2,303
03-060-081,878,410,0,410,0,3,407
03-060-082,1099,478,0,478,0,0,478
03-060-083,750,221,0,221,0,0,221
03-060-084,630,281,0,281,0,1,280
03-060-085,1172,369,0,369,0,0,369
03-060-086,1355,426,0,426,0,0,426
03-060-087,1194,492,0,492,0,2,490
03-060-088,1235,532,0,531,-1,0,531
03-060-089,1185,357,0,357,0,2,355
03-060-090,1025,367,0,367,0,0,367
03-060-091,572,161,0,161,0,2,159
03-060-092,1012,463,0,463,0,2,461
03-060-093,771,305,0,304,-1,1,303
03-060-094,884,404,0,404,0,0,404
03-060-095,663,173,0,173,0,0,173
03-060-096,584,153,0,153,0,0,153
03-061-001,623,247,0,247,0,0,247
03-061-002,666,232,0,232,0,0,232
03-061-003,704,228,0,228,0,1,227
03-061-004,102,31,0,31,0,0,31
03-062-001,1022,361,0,361,0,2,359
03-062-002,1017,377,0,377,0,0,377
03-062-003,985,409,0,409,0,1,408
03-062-004,958,381,0,381,0,0,381
03-062-005,1145,407,0,407,0,3,404
03-063-001,357,126,0,126,0,1,125
03-064-001,751,363,0,361,-2,6,355
03-064-002,630,308,0,308,0,0,308
03-064-003,702,347,0,347,0,2,345
03-064-004,682,305,0,304,-1,0,304
03-064-005,675,330,0,330,0,2,328
03-064-006,720,335,0,335,0,4,331
03-064-007,708,364,0,364,0,2,362
03-064-008,823,335,0,335,0,2,333
03-064-009,693,320,0,320,0,1,319
03-064-010,711,333,0,333,0,2,331
03-064-011,751,378,0,378,0,0,378
03-064-012,707,276,0,276,0,0,276
03-064-013,759,262,0,262,0,2,260
03-064-014,755,378,0,378,0,0,378
03-064-015,665,336,0,336,0,0,336
03-064-016,755,359,0,359,0,4,355
03-065-001,936,434,0,434,0,2,432
03-065-002,605,312,0,312,0,2,310
03-065-003,862,397,0,397,0,2,395
03-065-004,754,301,0,301,0,0,301
03-065-005,810,353,0,353,0,1,352
03-065-006,803,362,0,362,0,4,358
03-065-007,897,450,0,450,0,0,450
03-065-008,702,333,0,333,0,2,331
03-065-009,709,311,1,309,-2,0,309
03-065-010,834,424,0,424,0,1,423
03-065-011,875,397,0,397,0,4,393
03-065-012,934,412,0,411,-1,4,407
03-065-013,684,283,0,282,-1,1,281
03-065-014,996,405,0,405,0,1,404
03-065-015,863,329,2,329,0,1,328
03-065-016,1043,390,0,390,0,3,387
03-065-017,954,396,0,396,0,2,394
03-065-018,210,62,0,62,0,0,62
03-065-019,303,98,0,98,0,0,98
03-065-020,869,264,0,264,0,0,264
03-065-021,1056,360,0,360,0,2,358
03-065-022,413,158,0,158,0,0,158
03-065-023,611,217,0,217,0,2,215
03-065-024,762,285,0,285,0,3,282
03-065-025,941,356,0,356,0,3,353
03-065-026,842,391,0,387,-4,2,385
03-065-027,802,368,0,368,0,2,366
03-065-028,852,413,0,413,0,4,409
03-065-029,607,178,0,178,0,1,177
03-065-030,729,278,0,278,0,2,276
03-065-031,1092,360,0,360,0,0,360
03-066-001,771,418,0,418,0,0,418
03-066-002,567,254,0,254,0,4,250
03-066-003,823,307,0,307,0,5,302
03-066-004,1069,219,0,219,0,2,217
03-066-005,864,437,0,437,0,1,436
03-066-006,752,338,0,338,0,1,337
03-066-007,647,307,0,307,0,1,306
03-066-008,746,348,0,348,0,0,348
03-066-009,830,380,0,380,0,4,376
03-066-010,1142,261,0,261,0,4,257
03-066-011,802,276,0,276,0,0,276
03-066-012,732,280,0,280,0,2,278
03-066-013,865,372,0,372,0,1,371
03-066-014,677,197,0,197,0,0,197
03-066-015,746,337,0,337,0,1,336
03-066-016,680,317,0,317,0,1,316
03-066-017,641,294,0,293,-1,1,292
03-066-018,881,351,0,351,0,0,351
03-066-019,658,238,0,238,0,0,238
03-066-020,715,272,0,272,0,2,270
03-066-021,706,274,0,274,0,0,274
03-066-022,687,354,0,354,0,1,353
03-066-023,623,255,0,255,0,0,255
03-066-024,696,248,0,248,0,0,248
03-066-025,692,298,0,298,0,5,293
03-066-026,645,308,0,307,-1,2,305
03-066-027,718,285,0,285,0,1,284
03-066-028,625,245,0,245,0,0,245
03-066-029,850,308,0,308,0,5,303
03-066-030,768,238,0,238,0,1,237
03-067-001,862,320,0,320,0,0,320
03-067-002,823,337,0,337,0,3,334
03-067-003,1023,425,0,425,0,2,423
03-067-004,1049,454,0,454,0,2,452
03-067-005,1157,468,0,468,0,0,468
03-067-006,1154,364,0,364,0,2,362
03-067-007,1152,336,0,336,0,1,335
03-067-008,1152,353,0,353,0,1,352
03-067-009,230,81,0,81,0,0,81
03-067-010,418,210,0,210,0,0,210
03-068-001,244,73,0,73,0,0,73
03-068-002,917,327,0,327,0,3,324
03-068-003,852,259,0,259,0,3,256
03-069-001,557,246,0,246,0,3,243
03-070-001,1224,380,0,380,0,3,377
03-071-001,595,184,0,184,0,1,183
03-071-002,653,240,0,240,0,0,240
03-072-001,512,163,0,163,0,1,162
03-073-001,952,395,0,395,0,0,395
03-073-002,770,327,0,327,0,2,325
03-073-003,118,45,0,45,0,1,44
03-074-001,579,243,0,243,0,1,242
03-075-001,1371,545,0,545,0,6,539
03-076-001,796,339,0,339,0,5,334
03-076-002,1008,368,0,368,0,2,366
03-076-003,756,204,0,204,0,0,204
03-076-004,827,327,0,327,0,3,324
03-076-005,904,432,0,427,-5,1,426
03-076-006,1002,382,0,382,0,2,380
03-076-007,1116,402,0,402,0,3,399
03-076-008,308,102,0,102,0,1,101
03-077-001,1378,516,0,516,0,15,501
03-078-001,1081,466,0,466,0,3,463
03-078-002,1015,481,0,480,-1,1,479
03-078-003,1153,525,0,525,0,0,525
03-078-004,1151,304,0,304,0,1,303
03-078-005,1213,321,0,321,0,2,319
03-078-006,1169,392,0,392,0,0,392
03-078-007,1258,354,0,354,0,1,353
03-078-008,580,170,0,170,0,5,165
03-078-009,597,206,0,206,0,0,206
03-079-001,800,324,0,324,0,0,324
03-079-002,622,262,0,262,0,1,261
03-079-003,945,372,0,372,0,0,372
03-079-004,1106,437,0,437,0,9,428
03-079-005,368,117,0,117,0,0,117
03-080-001,789,271,0,271,0,2,269
03-080-002,780,278,0,278,0,2,276
03-080-003,742,173,0,173,0,1,172
03-081-001,411,139,0,139,0,1,138
03-082-001,784,303,0,303,0,0,303
03-082-002,827,344,0,344,0,1,343
03-082-003,786,317,0,317,0,1,316
03-082-004,818,273,0,273,0,0,273
03-082-005,832,228,0,228,0,5,223
03-082-006,96,49,0,49,0,2,47
03-083-001,687,300,0,300,0,2,298
03-083-002,699,349,0,349,0,1,348
03-084-001,370,192,0,192,0,2,190
03-085-001,996,316,0,316,0,4,312
03-085-002,902,288,0,288,0,3,285
03-086-001,871,267,0,267,0,5,262
03-086-002,627,260,0,260,0,0,260
03-087-001,956,355,2,353,-2,2,351
03-087-002,921,328,0,328,0,2,326
03-088-001,378,179,0,179,0,2,177
03-089-001,944,284,0,284,0,2,282
03-089-002,890,297,0,297,0,0,297
03-089-003,838,281,0,281,0,4,277
03-090-001,644,223,0,223,0,3,220
03-091-001,949,347,0,347,0,2,345
03-092-001,738,292,0,292,0,3,289
03-092-002,693,251,0,251,0,6,245
03-093-001,627,281,0,281,0,0,281
03-093-002,614,201,0,202,1,10,192
03-094-001,785,274,0,274,0,5,269
03-095-001,1023,326,0,326,0,3,323
03-096-001,759,330,0,329,-1,0,329
03-096-002,961,355,0,355,0,1,354
03-096-003,697,308,0,308,0,0,308
03-096-004,857,340,0,340,0,4,336
03-096-005,963,339,0,339,0,0,339
03-096-006,1014,342,0,340,-2,3,337
03-097-001,1054,375,0,375,0,4,371
03-098-001,1139,527,0,527,0,2,525
03-098-002,1159,470,0,470,0,1,469
03-098-003,965,429,0,429,0,2,427
03-098-004,939,299,0,299,0,1,298
03-098-005,829,326,0,326,0,0,326
03-098-006,836,322,0,322,0,1,321
03-099-001,1019,400,0,400,0,6,394
03-099-002,930,388,0,388,0,2,386
03-099-003,1013,366,0,366,0,3,363
03-100-001,653,180,0,180,0,0,180
03-100-002,711,233,1,232,-1,4,228
03-100-003,694,265,0,265,0,1,264
03-100-004,660,216,0,216,0,2,214
03-100-005,655,200,0,200,0,3,197
03-100-006,689,233,0,232,-1,0,232
03-100-007,710,221,0,221,0,1,220
03-100-008,288,83,0,83,0,0,83
03-101-001,995,417,0,417,0,7,410
03-102-001,756,243,0,243,0,0,243
03-102-002,846,270,0,270,0,1,269
03-102-003,716,250,0,250,0,3,247
03-103-001,989,388,0,388,0,1,387
03-103-002,951,433,0,433,0,3,430
03-104-001,618,215,0,215,0,0,215
03-104-002,885,435,0,435,0,1,434
03-105-001,1150,431,0,431,0,0,431
03-106-001,906,348,0,348,0,1,347
03-107-001,1155,452,0,452,0,3,449
03-107-002,1196,339,0,338,-1,2,336
03-108-001,968,343,0,343,0,2,341
03-109-001,694,315,0,315,0,2,313
03-109-002,691,251,0,252,1,10,242
03-110-001,757,250,0,250,0,0,250
03-110-002,689,212,0,212,0,2,210
03-110-003,612,222,0,222,0,3,219
03-110-004,640,202,0,202,0,2,200
03-110-005,621,255,0,255,0,2,253
03-110-006,659,242,0,242,0,1,241
03-111-001,1217,472,0,472,0,1,471
03-111-002,1372,696,0,695,-1,8,687
03-111-003,1232,579,0,577,-2,1,576
03-111-004,1253,499,0,499,0,0,499
03-111-005,1216,453,0,453,0,0,453
03-111-006,1193,422,0,422,0,0,422
03-111-007,673,177,0,177,0,1,176
03-111-008,384,148,0,148,0,0,148
03-111-009,433,160,0,160,0,0,160
03-111-010,320,79,0,79,0,1,78
03-112-001,666,260,0,260,0,6,254
03-113-001,596,185,0,185,0,3,182
03-113-002,805,288,0,288,0,1,287
03-113-003,726,246,0,246,0,0,246
03-113-004,801,236,0,236,0,2,234
03-113-005,790,217,0,217,0,2,215
03-114-001,778,310,0,310,0,4,306
03-115-001,165,77,0,77,0,0,77
03-116-001,316,171,0,171,0,3,168
03-117-001,938,369,0,369,0,0,369
03-117-002,992,397,0,397,0,1,396
03-117-003,897,362,0,362,0,0,362
03-118-001,985,406,0,406,0,0,406
03-118-002,839,318,0,318,0,2,316
03-119-001,627,232,0,232,0,0,232
04-001-001,689,222,0,222,0,3,219
04-002-001,690,205,0,205,0,4,201
04-002-002,689,250,0,250,0,0,250
04-002-003,585,157,0,157,0,1,156
04-002-004,833,246,0,246,0,0,246
04-002-005,927,318,0,318,0,1,317
04-002-006,813,225,0,225,0,1,224
04-003-001,1093,378,0,378,0,8,370
04-003-002,1025,350,0,350,0,2,348
04-003-003,1074,465,0,464,-1,4,460
04-003-004,1073,450,0,450,0,1,449
04-003-005,1065,475,0,475,0,5,470
04-003-006,1147,514,0,514,0,0,514
04-003-007,933,406,0,406,0,3,403
04-003-008,912,374,0,374,0,3,371
04-003-009,946,416,0,416,0,0,416
04-003-010,976,268,0,268,0,1,267
04-003-011,845,289,0,289,0,3,286
04-003-012,957,251,0,251,0,0,251
04-003-013,905,341,0,341,0,2,339
04-003-014,915,346,0,346,0,0,346
04-003-015,882,301,0,301,0,3,298
04-003-016,910,190,0,190,0,2,188
04-004-001,655,315,0,315,0,4,311
04-004-002,605,319,0,319,0,1,318
04-004-003,598,330,0,329,-1,0,329
04-004-004,894,459,0,459,0,1,458
04-004-005,854,496,0,496,0,1,495
04-004-006,548,289,0,289,0,3,286
04-004-007,842,380,0,380,0,0,380
04-004-008,643,231,0,231,0,0,231
04-004-009,922,379,0,379,0,3,376
04-004-010,776,318,0,318,0,0,318
04-004-011,937,483,3,480,-3,5,475
04-004-012,612,237,0,237,0,0,237
04-004-013,485,236,0,236,0,1,235
04-004-014,667,329,0,329,0,1,328
04-004-015,773,421,1,420,-1,2,418
04-004-016,772,291,0,291,0,1,290
04-004-017,832,385,0,385,0,2,383
04-004-018,567,285,0,285,0,5,280
04-004-019,930,476,0,476,0,3,473
04-004-020,831,384,0,384,0,0,384
04-004-021,717,337,0,337,0,3,334
04-004-022,709,310,0,310,0,3,307
04-004-023,667,244,0,242,-2,2,240
04-004-024,569,205,0,205,0,0,205
04-004-025,493,192,0,192,0,0,192
04-004-026,567,244,1,244,0,2,242
04-004-027,687,266,0,266,0,1,265
04-004-028,882,417,0,416,-1,0,416
04-004-029,1127,691,0,690,-1,5,685
04-004-030,943,506,0,505,-1,4,501
04-004-031,618,275,0,275,0,0,275
04-004-032,697,261,0,261,0,1,260
04-004-033,662,295,0,295,0,0,295
04-004-034,628,297,0,297,0,2,295
04-004-035,764,265,0,265,0,0,265
04-004-036,694,316,0,316,0,4,312
04-004-037,675,265,1,263,-2,1,262
04-004-038,660,351,0,351,0,0,351
04-004-039,732,299,0,299,0,3,296
04-004-040,601,233,0,233,0,0,233
04-004-041,1012,385,0,385,0,3,382
04-004-042,758,342,0,342,0,0,342
04-004-043,582,276,0,276,0,1,275
04-004-044,788,333,0,333,0,1,332
04-004-045,563,226,0,226,0,1,225
04-004-046,848,344,0,344,0,0,344
04-004-047,940,407,0,407,0,0,407
04-004-048,952,406,0,406,0,0,406
04-004-049,800,344,0,344,0,2,342
04-004-050,864,403,0,403,0,1,402
04-004-051,964,411,0,411,0,1,410
04-004-052,835,299,1,298,-1,3,295
04-004-053,535,300,0,300,0,2,298
04-004-054,166,57,0,57,0,0,57
04-004-055,232,72,0,72,0,0,72
04-004-056,752,359,0,360,1,10,350
04-004-057,834,360,0,360,0,1,359
04-004-058,608,256,0,256,0,0,256
04-004-059,607,199,0,196,-3,1,195
04-004-060,817,366,0,366,0,3,363
04-004-061,263,103,0,103,0,1,102
04-004-062,1097,444,0,444,0,2,442
04-004-063,646,284,0,284,0,0,284
04-004-064,786,350,0,350,0,1,349
04-004-065,614,292,0,292,0,3,289
04-004-066,499,210,0,210,0,2,208
04-004-067,755,258,0,257,-1,1,256
04-004-068,784,277,0,277,0,4,273
04-005-001,607,236,0,236,0,0,236
04-005-002,651,234,0,234,0,0,234
04-005-003,662,214,0,214,0,4,210
04-006-001,535,282,0,282,0,1,281
04-006-002,428,173,0,173,0,2,171
04-006-003,452,153,0,153,0,2,151
04-006-004,455,224,0,224,0,0,224
04-006-005,674,285,0,285,0,3,282
04-006-006,508,224,0,224,0,3,221
04-006-007,43,25,0,25,0,1,24
04-007-001,810,287,0,287,0,5,282
04-008-001,789,372,0,371,-1,2,369
04-009-001,899,257,0,257,0,2,255
04-009-002,904,279,0,279,0,0,279
04-010-001,679,290,0,290,0,0,290
04-010-002,698,262,0,262,0,0,262
04-010-003,86,24,0,24,0,0,24
04-011-001,252,110,0,110,0,0,110
04-012-001,1007,414,0,414,0,1,413
04-012-002,1067,320,0,320,0,1,319
04-013-001,357,170,0,170,0,1,169
04-014-001,824,323,0,321,-2,2,319
04-014-002,826,239,0,239,0,0,239
04-014-003,833,285,0,285,0,1,284
04-014-004,750,249,0,249,0,3,246
04-014-005,816,308,0,308,0,0,308
04-015-001,781,190,0,190,0,6,184
04-015-002,761,266,0,266,0,1,265
04-015-003,864,240,0,240,0,0,240
04-015-004,698,250,0,250,0,2,248
04-015-005,689,238,0,238,0,0,238
04-015-006,697,216,0,216,0,1,215
04-015-007,819,256,0,256,0,0,256
04-015-008,795,231,0,231,0,2,229
04-016-001,834,235,0,234,-1,3,231
04-016-002,637,224,0,224,0,0,224
04-016-003,688,233,0,233,0,2,231
04-016-004,620,221,0,221,0,5,216
04-016-005,653,210,0,210,0,2,208
04-017-001,660,245,0,245,0,2,243
04-017-002,594,217,0,217,0,1,216
04-017-003,442,139,0,139,0,2,137
04-018-001,483,214,0,214,0,2,212
04-019-001,1021,274,0,274,0,1,273
04-020-001,478,142,0,142,0,2,140
04-020-002,613,247,1,246,-1,5,241
04-020-003,659,207,0,207,0,2,205
04-020-004,597,209,0,209,0,2,207
04-020-005,692,273,0,273,0,2,271
04-020-006,702,172,0,172,0,2,170
04-021-001,899,346,0,346,0,3,343
04-021-002,843,346,0,346,0,6,340
04-021-003,881,284,0,284,0,4,280
04-021-004,1006,339,0,339,0,3,336
04-021-005,987,368,0,368,0,5,363
04-022-001,944,271,0,271,0,2,269
04-022-002,992,382,0,382,0,3,379
04-022-003,1022,313,0,313,0,2,311
04-023-001,560,245,0,245,0,1,244
04-023-002,475,239,0,239,0,1,238
04-024-001,584,173,0,173,0,0,173
04-025-001,683,306,0,306,0,3,303
04-025-002,697,307,0,307,0,1,306
04-025-003,700,236,0,236,0,0,236
04-025-004,730,282,0,282,0,1,281
04-025-005,647,295,0,295,0,3,292
04-025-006,668,270,0,270,0,0,270
04-025-007,728,200,0,200,0,2,198
04-025-008,637,180,0,180,0,0,180
04-025-009,666,222,0,222,0,0,222
04-025-010,638,278,0,278,0,0,278
04-025-011,779,261,0,261,0,0,261
04-025-012,717,236,0,236,0,2,234
04-025-013,635,145,0,145,0,3,142
04-025-014,592,205,0,205,0,3,202
04-025-015,122,48,0,48,0,3,45
04-025-016,789,307,0,307,0,1,306
04-025-017,555,110,0,110,0,0,110
04-026-001,1138,527,0,527,0,2,525
04-026-002,1054,526,0,526,0,0,526
04-026-003,1132,584,0,584,0,3,581
04-026-004,834,391,0,391,0,3,388
04-026-005,805,320,1,318,-2,2,316
04-026-006,814,366,0,366,0,2,364
04-026-007,1028,372,1,371,-1,1,370
04-026-008,942,455,0,455,0,3,452
04-026-009,718,346,0,346,0,2,344
04-026-010,809,405,0,404,-1,1,403
04-026-011,735,291,0,291,0,1,290
04-026-012,726,270,0,270,0,0,270
04-026-013,679,255,0,255,0,0,255
04-026-014,1030,351,0,351,0,5,346
04-026-015,802,395,0,394,-1,3,391
04-026-016,933,456,0,456,0,2,454
04-026-017,728,284,0,284,0,0,284
04-026-018,701,280,0,280,0,0,280
04-026-019,1191,434,0,434,0,6,428
04-026-020,766,368,0,368,0,3,365
04-026-021,903,402,0,402,0,2,400
04-026-022,850,383,0,383,0,2,381
04-026-023,1050,479,0,479,0,5,474
04-026-024,748,292,1,291,-1,2,289
04-026-025,930,437,0,437,0,3,434
04-026-026,805,307,0,307,0,3,304
04-026-027,636,238,0,238,0,0,238
04-026-028,607,256,0,256,0,1,255
04-026-029,661,258,0,258,0,2,256
04-026-030,148,50,0,50,0,1,49
04-027-001,537,233,0,233,0,1,232
04-028-001,487,214,1,213,-1,2,211
04-028-002,389,172,0,172,0,5,167
04-029-001,483,234,0,234,0,3,231
04-030-001,688,244,0,244,0,0,244
04-031-001,709,286,0,286,0,3,283
04-031-002,682,252,0,252,0,1,251
04-031-003,119,47,0,47,0,0,47
04-032-001,309,104,0,104,0,1,103
04-033-001,745,262,0,262,0,3,259
04-033-002,721,262,0,262,0,1,261
04-034-001,754,234,0,234,0,1,233
04-034-002,729,241,0,241,0,1,240
04-034-003,825,267,0,267,0,2,265
04-034-004,638,191,1,190,-1,2,188
04-035-001,793,434,0,434,0,6,428
04-035-002,325,115,0,115,0,0,115
04-036-001,398,151,0,151,0,3,148
04-037-001,613,230,0,230,0,1,229
04-037-002,642,281,0,281,0,2,279
04-037-003,660,255,1,254,-1,1,253
04-037-004,585,219,0,219,0,4,215
04-037-005,619,242,0,242,0,1,241
04-037-006,589,251,0,251,0,1,250
04-037-007,447,160,0,160,0,1,159
04-038-001,817,254,0,254,0,2,252
04-038-002,950,214,0,214,0,4,210
04-038-003,890,261,0,261,0,0,261
04-038-004,917,346,0,346,0,1,345
04-039-001,492,186,0,186,0,3,183
04-040-001,676,234,0,234,0,1,233
04-040-002,688,216,0,216,0,2,214
04-040-003,684,220,0,220,0,2,218
04-041-001,404,129,0,129,0,0,129
04-042-001,568,220,0,220,0,2,218
04-042-002,631,209,0,209,0,6,203
04-043-001,686,216,0,216,0,1,215
04-043-002,645,210,0,211,1,9,202
04-043-003,811,228,0,228,0,3,225
04-044-001,782,283,0,283,0,0,283
04-044-002,654,238,0,236,-2,3,233
04-045-001,608,215,0,215,0,2,213
04-045-002,489,156,0,156,0,0,156
04-045-003,586,179,0,179,0,2,177
04-046-001,184,73,0,73,0,0,73
04-047-001,529,196,0,196,0,1,195
04-047-002,269,104,0,104,0,0,104
04-048-001,953,370,0,370,0,3,367
04-048-002,811,374,0,372,-2,3,369
04-048-003,823,353,0,353,0,6,347
04-048-004,277,93,0,93,0,1,92
04-049-001,1055,271,0,271,0,1,270
04-049-002,1014,382,0,382,0,3,379
04-049-003,1048,420,0,420,0,1,419
04-049-004,1035,374,0,374,0,3,371
04-049-005,907,395,0,395,0,3,392
04-049-006,1128,288,0,288,0,3,285
04-049-007,1066,419,0,419,0,2,417
04-049-008,968,358,0,357,-1,1,356
04-050-001,775,253,0,253,0,1,252
04-050-002,83,42,0,42,0,0,42
04-051-001,703,238,0,238,0,1,237
04-051-002,597,248,0,248,0,1,247
04-051-003,697,258,0,258,0,0,258
04-051-004,736,360,0,360,0,2,358
04-051-005,802,293,0,293,0,1,292
04-051-006,727,217,0,217,0,2,215
04-052-001,835,364,0,363,-1,2,361
04-052-002,920,365,0,365,0,2,363
04-052-003,1012,375,0,375,0,2,373
04-052-004,1057,390,0,390,0,0,390
04-052-005,951,321,0,321,0,1,320
04-053-001,852,282,0,282,0,5,277
04-053-002,885,321,0,321,0,3,318
04-054-001,490,163,0,163,0,0,163
04-054-002,541,169,0,169,0,0,169
04-055-001,1058,465,0,465,0,2,463
04-056-001,376,109,0,109,0,0,109
04-056-002,321,113,0,113,0,0,113
04-056-003,373,121,0,121,0,0,121
04-057-001,907,323,0,323,0,1,322
04-057-002,1138,489,0,488,-1,5,483
04-057-003,947,365,0,365,0,1,364
04-057-004,1117,422,0,422,0,0,422
04-058-001,960,277,0,277,0,3,274
04-058-002,926,272,0,272,0,1,271
04-059-001,742,400,0,399,-1,1,398
04-059-002,689,290,0,290,0,2,288
04-059-003,678,255,0,255,0,0,255
04-059-004,784,298,0,298,0,3,295
04-059-005,611,266,0,266,0,0,266
04-059-006,882,372,0,372,0,1,371
04-059-007,430,217,0,217,0,1,216
04-059-008,536,260,0,260,0,0,260
04-059-009,486,241,0,241,0,0,241
04-059-010,775,338,0,338,0,5,333
04-059-011,612,285,0,285,0,4,281
04-059-012,697,299,0,299,0,1,298
04-059-013,592,270,0,270,0,2,268
04-059-014,558,240,0,240,0,0,240
04-059-015,508,209,0,209,0,2,207
04-059-016,126,46,0,46,0,0,46
04-059-017,652,255,0,255,0,1,254
04-059-018,522,242,0,242,0,2,240
04-059-019,733,370,0,370,0,1,369
04-059-020,936,368,0,366,-2,0,366
04-059-021,721,332,0,332,0,2,330
04-059-022,747,266,0,266,0,0,266
04-059-023,1040,463,0,463,0,4,459
04-059-024,976,458,0,458,0,0,458
04-059-025,913,383,0,383,0,5,378
04-059-026,837,347,0,347,0,1,346
04-059-027,792,320,0,320,0,0,320
04-059-028,405,206,0,206,0,0,206
04-059-029,373,132,0,132,0,2,130
04-059-030,867,258,0,258,0,1,257
04-059-031,862,323,0,323,0,1,322
04-059-032,620,178,1,177,-1,0,177
04-059-033,683,242,0,242,0,1,241
04-059-034,164,55,0,55,0,0,55
04-059-035,151,58,0,58,0,0,58
04-059-036,658,289,0,289,0,0,289
04-059-037,85,35,0,35,0,0,35
04-060-001,309,136,0,136,0,0,136
04-061-001,759,276,0,276,0,3,273
04-061-002,552,193,0,193,0,1,192
04-062-001,232,127,0,127,0,3,124
04-062-002,68,31,0,31,0,0,31
04-063-001,985,346,0,346,0,3,343
04-063-002,991,311,0,311,0,1,310
04-063-003,1005,296,0,296,0,3,293
04-063-004,1021,366,0,366,0,2,364
04-063-005,1012,224,0,224,0,2,222
04-063-006,892,288,0,288,0,3,285
04-063-007,1116,424,0,424,0,1,423
04-063-008,923,280,0,280,0,2,278
04-064-001,565,180,0,180,0,3,177
04-064-002,547,212,0,212,0,0,212
04-064-003,126,49,0,49,0,0,49
04-064-004,60,30,0,30,0,0,30
04-065-001,659,257,0,257,0,0,257
04-065-002,798,303,0,303,0,0,303
04-065-003,723,270,0,270,0,2,268
04-066-001,994,560,0,560,0,1,559
04-066-002,959,371,0,371,0,4,367
04-066-003,761,322,0,322,0,4,318
04-066-004,638,294,0,294,0,0,294
04-066-005,779,390,0,390,0,2,388
04-066-006,693,271,0,271,0,0,271
04-066-007,607,228,0,228,0,2,226
04-066-008,952,377,0,377,0,4,373
04-066-009,223,74,0,74,0,0,74
04-066-010,1123,635,0,635,0,3,632
04-066-011,864,347,0,347,0,3,344
04-066-012,905,371,0,371,0,0,371
04-066-013,781,294,0,294,0,0,294
04-066-014,895,292,0,292,0,0,292
04-066-015,775,284,0,284,0,3,281
04-066-016,232,79,0,79,0,0,79
04-066-017,400,140,0,140,0,1,139
04-066-018,470,166,0,166,0,0,166
04-067-001,1045,341,0,341,0,6,335
04-067-002,1065,427,0,427,0,2,425
04-067-003,952,345,0,345,0,1,344
04-067-004,1061,392,0,392,0,1,391
04-067-005,1039,318,0,318,0,0,318
04-067-006,1067,394,0,394,0,0,394
04-067-007,1117,230,0,230,0,2,228
04-068-001,677,261,0,261,0,3,258
04-069-001,587,248,0,248,0,1,247
04-069-002,707,283,1,282,-1,1,281
04-070-001,484,214,0,214,0,0,214
04-070-002,677,269,0,269,0,1,268
04-070-003,498,251,0,251,0,0,251
04-070-004,501,226,0,226,0,2,224
04-070-005,533,195,0,195,0,4,191
04-070-006,542,264,0,264,0,2,262
04-070-007,751,361,0,361,0,2,359
04-070-008,782,315,0,315,0,3,312
04-071-001,776,240,0,240,0,1,239
04-071-002,626,234,0,234,0,0,234
04-071-003,744,258,0,258,0,3,255
04-071-004,745,297,0,297,0,2,295
04-071-005,719,272,0,272,0,1,271
04-071-006,592,192,0,192,0,2,190
04-072-001,84,35,0,35,0,0,35
04-073-001,929,324,0,324,0,2,322
04-073-002,119,54,0,54,0,0,54
04-074-001,701,190,0,190,0,1,189
04-074-002,654,219,0,219,0,0,219
04-074-003,719,272,0,272,0,2,270
04-074-004,685,298,0,298,0,2,296
04-074-005,959,251,0,251,0,1,250
04-074-006,866,198,0,198,0,4,194
04-074-007,841,156,0,156,0,0,156
04-075-001,641,231,0,231,0,2,229
04-075-002,608,208,0,208,0,2,206
05-001-001,62,25,0,25,0,0,25
05-002-001,408,141,0,140,-1,0,140
05-002-002,78,25,0,25,0,0,25
05-003-001,85,38,0,38,0,0,38
05-004-001,827,228,0,228,0,1,227
05-004-002,832,272,0,272,0,0,272
05-004-003,761,293,0,293,0,0,293
05-005-001,110,38,0,38,0,0,38
05-006-001,139,52,0,52,0,0,52
05-007-001,144,64,0,64,0,0,64
05-008-001,454,226,0,226,0,1,225
05-009-001,624,163,0,163,0,0,163
05-010-001,612,208,0,208,0,0,208
05-011-001,254,117,0,117,0,1,116
05-012-001,71,43,0,43,0,0,43
05-013-001,159,86,0,86,0,1,85
05-014-001,348,153,0,153,0,2,151
05-015-001,110,61,0,61,0,0,61
05-016-001,1108,299,0,299,0,1,298
05-017-001,727,344,0,344,0,0,344
05-017-002,744,292,0,292,0,3,289
05-017-003,1000,225,0,224,-1,3,221
05-017-004,839,330,0,330,0,1,329
05-017-005,986,295,0,295,0,4,291
05-018-001,70,48,0,48,0,0,48
05-019-001,877,101,0,101,0,0,101
05-019-002,889,186,0,186,0,1,185
05-019-003,874,160,0,160,0,1,159
05-020-001,861,388,0,388,0,1,387
05-020-002,1083,508,0,508,0,2,506
05-021-001,704,281,0,281,0,2,279
05-021-002,691,218,0,218,0,0,218
05-022-001,829,311,0,311,0,2,309
05-023-001,551,170,1,169,-1,1,168
05-024-001,339,102,0,102,0,4,98
05-025-001,147,86,0,86,0,0,86
05-026-001,568,224,0,224,0,1,223
05-026-002,570,215,0,215,0,0,215
05-027-001,992,348,0,348,0,2,346
05-028-001,32,27,0,27,0,0,27
05-029-001,969,365,0,365,0,0,365
05-029-002,1035,428,0,428,0,2,426
05-030-001,942,282,0,282,0,1,281
05-031-001,205,49,0,49,0,0,49
05-032-001,764,215,1,214,-1,3,211
05-033-001,1037,240,0,240,0,0,240
05-034-001,911,406,0,406,0,4,402
05-035-001,724,261,0,261,0,1,260
05-036-001,717,227,0,227,0,1,226
05-037-001,784,342,0,342,0,2,340
05-037-002,865,343,0,343,0,3,340
05-038-001,379,78,0,78,0,2,76
05-039-001,768,294,0,294,0,1,293
05-040-001,973,223,0,223,0,1,222
05-040-002,822,300,0,300,0,1,299
05-041-001,634,158,0,158,0,3,155
05-042-001,243,116,0,116,0,1,115
05-043-001,435,217,0,217,0,0,217
05-044-001,595,164,0,164,0,1,163
05-044-002,577,172,0,172,0,0,172
05-044-003,589,195,0,195,0,3,192
05-044-004,673,269,0,269,0,2,267
05-045-001,981,309,0,309,0,2,307
05-046-001,921,226,0,226,0,1,225
05-047-001,147,62,0,62,0,0,62
05-048-001,77,41,0,41,0,1,40
05-049-001,842,411,0,411,0,1,410
05-050-001,162,86,0,86,0,1,85
05-051-001,816,268,0,268,0,0,268
05-051-002,624,234,0,234,0,2,232
05-051-003,698,307,0,307,0,2,305
05-052-001,1212,430,0,430,0,2,428
05-053-001,617,288,0,288,0,1,287
05-053-002,742,310,0,310,0,0,310
05-054-001,124,76,0,76,0,1,75
05-055-001,1018,460,0,460,0,1,459
05-056-001,841,362,0,362,0,2,360
05-057-001,162,68,0,68,0,1,67
05-058-001,842,194,0,194,0,3,191
05-058-002,729,180,0,180,0,0,180
05-058-003,751,176,0,176,0,1,175
05-059-001,260,58,0,58,0,1,57
05-060-001,833,403,0,403,0,1,402
05-061-001,358,182,0,182,0,4,178
05-062-001,551,173,0,173,0,1,172
05-063-001,464,206,0,206,0,5,201
05-064-001,552,165,0,165,0,1,164
05-065-001,542,217,0,217,0,6,211
05-066-001,632,226,0,226,0,1,225
05-067-001,194,87,0,87,0,0,87
05-068-001,268,84,0,84,0,1,83
05-069-001,19,11,0,11,0,0,11
05-070-001,214,71,0,71,0,0,71
05-071-001,1228,391,0,391,0,0,391
05-072-001,595,177,0,177,0,3,174
05-073-001,222,100,0,100,0,3,97
05-074-001,242,115,0,115,0,0,115
05-075-001,951,361,0,360,-1,3,357
05-075-002,1053,509,0,509,0,2,507
05-075-003,1094,412,0,412,0,2,410
05-075-004,891,387,0,387,0,0,387
05-075-005,874,443,0,443,0,3,440
05-075-006,796,364,0,364,0,1,363
05-075-007,1059,418,0,418,0,4,414
05-075-008,977,302,0,302,0,4,298
05-076-001,455,241,0,241,0,2,239
05-077-001,741,228,0,228,0,1,227
05-077-002,761,278,0,278,0,2,276
05-077-003,788,261,0,261,0,0,261
05-077-004,860,276,0,276,0,3,273
05-077-005,828,257,0,257,0,0,257
05-078-001,799,396,0,396,0,2,394
05-078-002,884,330,0,330,0,2,328
05-078-003,642,124,1,123,-1,1,122
05-078-004,782,284,0,284,0,2,282
05-078-005,739,372,0,372,0,1,371
05-078-006,608,191,0,191,0,0,191
05-078-007,453,82,0,82,0,0,82
05-079-001,943,348,0,348,0,2,346
05-080-001,479,201,0,201,0,3,198
05-081-001,54,40,0,40,0,1,39
05-082-001,277,111,0,111,0,0,111
05-083-001,699,205,0,205,0,0,205
05-083-002,521,91,0,91,0,2,89
05-084-001,267,124,0,124,0,0,124
05-085-001,222,71,0,71,0,0,71
05-086-001,706,189,0,189,0,3,186
05-087-001,136,39,0,39,0,0,39
05-088-001,289,90,0,90,0,1,89
05-089-001,793,296,0,296,0,3,293
05-090-001,201,59,0,59,0,4,55
05-091-001,567,170,0,170,0,1,169
05-092-001,361,85,0,85,0,0,85
05-093-001,720,351,0,349,-2,2,347
05-093-002,887,437,0,437,0,1,436
05-093-003,1107,480,0,480,0,6,474
05-093-004,646,327,0,327,0,1,326
05-093-005,909,372,0,372,0,2,370
05-093-006,974,393,0,393,0,2,391
05-094-001,87,42,0,42,0,1,41
05-095-001,265,90,0,90,0,1,89
05-096-001,1008,318,0,318,0,1,317
05-096-002,976,346,0,346,0,3,343
05-097-001,270,54,0,54,0,0,54
05-098-001,338,197,0,197,0,3,194
05-099-001,93,47,0,47,0,0,47
05-100-001,240,129,0,129,0,4,125
05-101-001,250,75,0,75,0,1,74
05-102-001,163,79,0,79,0,0,79
05-103-001,27,13,0,13,0,0,13
05-104-001,134,44,0,44,0,0,44
05-105-001,153,70,0,70,0,0,70
05-106-001,75,51,0,51,0,1,50
05-107-001,300,136,0,136,0,1,135
05-108-001,470,288,0,288,0,3,285
05-109-001,616,212,0,212,0,0,212
05-109-002,567,237,0,237,0,1,236
05-109-003,659,231,0,231,0,2,229
05-109-004,221,76,0,76,0,0,76
05-110-001,624,219,0,219,0,8,211
05-111-001,465,205,0,205,0,1,204
05-112-001,73,37,0,37,0,0,37
05-113-001,791,339,0,339,0,0,339
05-113-002,760,212,0,212,0,2,210
05-114-001,468,138,0,138,0,0,138
05-115-001,453,92,0,92,0,0,92
05-116-001,654,268,0,268,0,2,266
05-116-002,699,245,1,244,-1,5,239
05-117-001,462,199,0,199,0,0,199
05-118-001,650,197,0,197,0,1,196
05-118-002,597,183,0,183,0,0,183
05-119-001,790,318,0,318,0,1,317
05-119-002,831,344,0,344,0,1,343
05-120-001,126,82,0,82,0,1,81
05-121-001,90,66,0,66,0,0,66
05-122-001,179,102,0,102,0,0,102
05-123-001,603,230,0,230,0,2,228
05-123-002,616,232,0,232,0,3,229
05-124-001,829,336,0,336,0,2,334
05-125-001,238,103,0,103,0,2,101
05-126-001,845,311,0,311,0,2,309
05-127-001,557,299,0,299,0,1,298
05-128-001,551,294,0,294,0,3,291
05-129-001,105,57,0,57,0,1,56
05-130-001,159,54,0,54,0,0,54
05-131-001,124,54,0,54,0,0,54
05-131-002,1109,464,0,464,0,2,462
05-132-001,251,107,0,107,0,0,107
05-133-001,939,318,0,318,0,4,314
05-133-002,895,320,0,320,0,2,318
05-133-003,925,348,0,348,0,3,345
05-134-001,157,48,0,48,0,0,48
05-135-001,311,81,0,81,0,3,78
05-136-001,131,67,0,67,0,1,66
05-137-001,683,181,0,181,0,0,181
05-138-001,403,130,0,130,0,0,130
05-139-001,776,304,0,304,0,2,302
05-140-001,460,215,0,215,0,2,213
05-141-001,709,286,0,284,-2,2,282
05-142-001,704,212,0,212,0,0,212
05-143-001,889,336,0,336,0,4,332
05-144-001,95,54,0,54,0,1,53
05-145-001,936,319,0,319,0,2,317
05-146-001,69,51,0,51,0,0,51
05-147-001,671,213,0,213,0,3,210
05-147-002,630,202,0,202,0,1,201
05-148-001,384,131,0,131,0,1,130
05-149-001,742,213,0,212,-1,1,211
05-149-002,619,174,0,174,0,0,174
05-150-001,224,101,0,101,0,0,101
05-151-001,714,171,0,171,0,1,170
05-151-002,705,239,0,239,0,0,239
05-152-001,399,111,0,111,0,0,111
05-153-001,682,341,0,341,0,1,340
05-153-002,687,322,0,322,0,2,320
05-153-003,756,213,0,213,0,1,212
05-153-004,607,225,0,225,0,1,224
05-153-005,942,443,1,441,-2,1,440
05-153-006,778,302,0,302,0,1,301
05-153-007,722,199,0,199,0,0,199
05-153-008,554,137,0,137,0,1,136
05-153-009,754,166,0,166,0,2,164
05-153-010,1028,287,0,287,0,2,285
05-153-011,629,286,0,286,0,0,286
05-153-012,581,213,0,212,-1,0,212
05-153-013,793,321,0,321,0,1,320
05-153-014,566,261,0,261,0,3,258
05-153-015,787,322,0,322,0,0,322
05-153-016,979,346,0,346,0,2,344
05-153-017,750,240,0,240,0,4,236
05-153-018,934,302,0,303,1,10,293
05-153-019,851,308,0,308,0,1,307
05-153-020,783,265,0,265,0,0,265
05-153-021,629,212,0,212,0,1,211
05-153-022,559,187,0,187,0,0,187
05-153-023,979,313,0,313,0,0,313
05-153-024,944,307,3,304,-3,3,301
05-153-025,873,315,1,315,0,1,314
05-153-026,729,273,0,273,0,1,272
05-153-027,575,212,0,212,0,1,211
05-153-028,657,256,0,256,0,1,255
05-153-029,675,250,0,250,0,2,248
05-153-030,796,253,0,253,0,1,252
05-154-001,433,216,0,216,0,2,214
05-155-001,142,83,0,83,0,1,82
05-156-001,49,18,0,18,0,0,18
05-157-001,710,199,0,199,0,1,198
05-158-001,361,123,0,123,0,0,123
05-159-001,982,277,0,277,0,3,274
05-160-001,28,14,0,14,0,0,14
05-161-001,622,219,0,218,-1,0,218
05-161-002,655,212,0,212,0,3,209
05-162-001,131,56,0,56,0,1,55
05-163-001,143,54,0,54,0,0,54
05-163-002,513,161,0,161,0,0,161
05-164-001,138,74,0,74,0,0,74
05-165-001,648,261,1,261,0,3,258
05-165-002,630,223,0,223,0,2,221
05-166-001,272,121,0,121,0,3,118
05-167-001,268,137,0,137,0,2,135
05-168-001,156,66,0,66,0,3,63
05-169-001,249,132,0,132,0,2,130
05-170-001,848,336,0,336,0,0,336
05-170-002,885,345,0,344,-1,0,344
05-171-001,173,81,0,81,0,2,79
05-172-001,223,121,0,121,0,1,120
05-173-001,495,183,0,183,0,1,182
05-174-001,242,119,0,119,0,2,117
05-175-001,476,109,0,109,0,0,109
05-176-001,921,424,0,424,0,8,416
05-177-001,375,118,0,118,0,0,118
05-178-001,135,78,0,78,0,1,77
05-179-001,524,167,0,167,0,0,167
05-179-002,731,254,0,254,0,1,253
05-180-001,455,249,1,248,-1,0,248
05-181-001,201,43,0,43,0,1,42
05-182-001,212,94,0,94,0,0,94
05-183-001,1199,403,0,403,0,5,398
05-184-001,353,124,0,124,0,0,124
05-185-001,223,97,0,97,0,0,97
05-186-001,42,25,0,25,0,2,23
05-187-001,681,169,0,169,0,2,167
05-188-001,324,115,0,115,0,0,115
05-189-001,966,448,0,448,0,4,444
05-189-002,837,357,0,357,0,0,357
05-190-001,806,255,0,255,0,0,255
05-190-002,740,276,0,275,-1,0,275
05-190-003,665,287,0,287,0,0,287
05-190-004,646,298,0,298,0,2,296
05-190-005,628,268,0,269,1,9,260
05-191-001,406,164,0,164,0,2,162
05-192-001,649,164,0,164,0,2,162
05-192-002,630,210,0,210,0,1,209
05-192-003,660,229,0,229,0,1,228
05-193-001,143,78,0,78,0,0,78
05-194-001,987,327,0,327,0,2,325
05-194-002,912,355,0,355,0,3,352
05-194-003,986,351,0,351,0,1,350
05-194-004,842,289,1,288,-1,3,285
05-194-005,955,342,0,342,0,2,340
05-195-001,599,191,0,191,0,2,189
05-195-002,579,218,0,218,0,2,216
05-195-003,598,232,0,232,0,1,231
05-195-004,573,181,0,181,0,3,178
05-195-005,625,188,0,188,0,1,187
05-196-001,925,490,0,490,0,4,486
05-196-002,836,424,0,424,0,6,418
05-196-003,841,421,0,421,0,0,421
05-196-004,1009,452,0,451,-1,1,450
05-196-005,908,259,0,259,0,1,258
05-196-006,829,296,0,296,0,0,296
05-196-007,779,365,0,365,0,2,363
05-196-008,807,402,0,402,0,5,397
05-196-009,771,413,0,413,0,1,412
05-196-010,1024,466,0,466,0,2,464
05-196-011,921,356,0,356,0,1,355
05-196-012,723,343,0,343,0,1,342
05-196-013,827,373,0,373,0,1,372
05-196-014,657,297,0,297,0,0,297
05-196-015,790,407,0,407,0,3,404
05-196-016,771,369,0,369,0,4,365
05-197-001,843,351,0,351,0,5,346
05-198-001,686,276,0,276,0,1,275
05-198-002,632,237,1,236,-1,3,233
05-199-001,952,293,0,293,0,5,288
05-199-002,821,225,0,225,0,0,225
05-200-001,623,144,0,144,0,2,142
05-200-002,628,200,0,200,0,0,200
05-201-001,431,197,0,197,0,0,197
05-202-001,623,152,0,152,0,0,152
05-202-002,635,157,0,158,1,10,148
05-202-003,623,294,0,294,0,2,292
05-202-004,605,260,0,260,0,0,260
05-202-005,575,240,0,240,0,0,240
05-202-006,638,328,0,328,0,1,327
05-202-007,692,351,0,351,0,2,349
05-202-008,814,426,0,426,0,1,425
05-202-009,742,245,0,245,0,2,243
05-202-010,701,380,1,379,-1,1,378
05-202-011,915,415,0,415,0,1,414
05-202-012,704,338,0,338,0,2,336
05-202-013,797,308,0,308,0,1,307
05-202-014,927,440,0,440,0,3,437
05-202-015,933,522,0,522,0,0,522
05-202-016,1023,454,0,454,0,1,453
05-202-017,1089,569,0,566,-3,2,564
05-202-018,1127,503,0,503,0,2,501
05-202-019,683,244,0,244,0,3,241
05-202-020,908,409,0,408,-1,2,406
05-202-021,832,391,0,391,0,0,391
05-202-022,753,424,0,424,0,2,422
05-202-023,780,352,0,352,0,1,351
05-202-024,825,418,0,418,0,2,416
05-202-025,660,287,0,287,0,0,287
05-202-026,1034,570,0,570,0,1,569
05-202-027,1163,605,0,605,0,2,603
05-202-028,819,407,0,407,0,0,407
05-202-029,633,357,0,357,0,1,356
05-202-030,709,310,0,310,0,2,308
05-202-031,521,148,0,148,0,2,146
05-202-032,984,476,0,476,0,3,473
05-202-033,774,267,0,267,0,0,267
05-202-034,882,305,0,305,0,1,304
05-202-035,1008,304,0,304,0,2,302
05-202-036,983,382,0,382,0,2,380
05-202-037,901,341,0,341,0,1,340
05-202-038,773,276,0,276,0,0,276
05-202-039,951,328,0,328,0,4,324
05-202-040,915,332,0,332,0,0,332
05-202-041,774,214,0,214,0,0,214
05-202-042,891,308,0,308,0,0,308
05-202-043,792,286,0,286,0,0,286
05-202-044,949,289,0,289,0,2,287
05-202-045,875,282,0,282,0,4,278
05-202-046,1048,343,0,343,0,1,342
05-202-047,936,337,0,337,0,3,334
05-202-048,846,352,0,352,0,1,351
05-202-049,892,307,0,307,0,2,305
05-202-050,758,355,0,355,0,1,354
05-202-051,669,281,0,281,0,0,281
05-202-052,658,243,0,243,0,1,242
05-202-053,907,397,0,397,0,3,394
05-202-054,928,411,0,411,0,0,411
05-202-055,648,427,0,427,0,0,427
05-202-056,633,394,0,394,0,0,394
05-202-057,905,350,0,350,0,0,350
05-202-058,697,250,0,250,0,1,249
05-202-059,615,334,0,334,0,1,333
05-202-060,646,409,0,409,0,0,409
05-202-061,594,378,0,378,0,0,378
05-202-062,761,378,0,378,0,6,372
05-202-063,721,291,0,291,0,0,291
05-202-064,881,409,0,409,0,1,408
05-202-065,793,307,0,307,0,1,306
05-202-066,813,327,0,327,0,1,326
05-202-067,636,277,0,277,0,0,277
05-202-068,779,317,0,317,0,0,317
05-202-069,749,379,0,379,0,0,379
05-202-070,722,373,0,373,0,1,372
05-202-071,627,271,0,271,0,0,271
05-202-072,735,355,0,355,0,3,352
05-202-073,679,340,1,339,-1,2,337
05-202-074,876,324,0,324,0,5,319
05-202-075,752,281,0,281,0,0,281
05-202-076,822,451,0,451,0,0,451
05-202-077,704,300,0,300,0,1,299
05-202-078,618,358,0,358,0,3,355
05-202-079,562,257,0,257,0,0,257
05-202-080,665,256,0,256,0,1,255
05-202-081,918,402,0,402,0,2,400
05-202-082,941,468,0,468,0,1,467
05-202-083,624,366,1,365,-1,2,363
05-202-084,752,353,0,353,0,2,351
05-202-085,669,337,0,337,0,1,336
05-202-086,1099,546,0,547,1,11,536
05-202-087,613,281,0,281,0,2,279
05-202-088,697,354,0,354,0,1,353
05-202-089,844,436,1,435,-1,2,433
05-202-090,629,211,0,211,0,3,208
05-202-091,881,447,0,447,0,1,446
05-202-092,626,235,0,235,0,6,229
05-202-093,555,253,0,253,0,2,251
05-202-094,678,215,0,215,0,0,215
05-202-095,609,207,0,207,0,0,207
05-202-096,1897,1072,0,1073,1,13,1060
05-202-097,662,281,0,281,0,2,279
05-202-098,718,301,0,301,0,1,300
05-202-099,660,312,0,312,0,2,310
05-202-100,620,247,0,247,0,0,247
05-202-101,806,361,0,361,0,0,361
05-202-102,671,290,0,290,0,0,290
05-202-103,885,360,0,360,0,0,360
05-202-104,940,414,0,414,0,1,413
05-202-105,1134,546,0,546,0,3,543
05-202-106,1085,533,0,533,0,4,529
05-202-107,898,418,0,418,0,1,417
05-202-108,722,293,0,293,0,1,292
05-202-109,646,259,0,259,0,1,258
05-202-110,697,314,0,313,-1,4,309
05-202-111,725,361,0,361,0,2,359
05-202-112,723,369,0,369,0,1,368
05-202-113,620,336,0,336,0,0,336
05-202-114,619,309,0,309,0,1,308
05-202-115,709,339,0,339,0,1,338
05-202-116,620,292,0,292,0,0,292
05-202-117,960,366,1,361,-5,1,360
05-202-118,1305,421,0,420,-1,18,402
05-202-119,645,258,0,258,0,3,255
05-202-120,836,318,0,318,0,3,315
05-202-121,831,429,0,429,0,1,428
05-202-122,667,258,0,258,0,0,258
05-202-123,916,255,0,255,0,1,254
05-202-124,920,394,0,394,0,0,394
05-202-125,983,456,0,456,0,3,453
05-202-126,1013,501,0,501,0,1,500
05-202-127,1101,315,0,315,0,0,315
05-202-128,1068,365,1,365,0,13,352
05-202-129,455,223,0,223,0,1,222
05-202-130,703,269,0,269,0,3,266
05-202-131,646,342,1,340,-2,3,337
05-202-132,666,319,0,319,0,4,315
05-202-133,990,393,0,393,0,1,392
05-202-134,851,452,0,452,0,1,451
05-202-135,783,398,0,398,0,3,395
05-202-136,875,440,0,440,0,2,438
05-202-137,885,448,0,448,0,1,447
05-202-138,940,434,0,432,-2,3,429
05-202-139,637,248,0,248,0,3,245
05-202-140,638,253,0,253,0,3,250
05-202-141,754,288,0,288,0,2,286
05-202-142,741,265,0,265,0,0,265
05-202-143,663,260,0,260,0,0,260
05-202-144,633,253,0,253,0,4,249
05-202-145,712,354,0,354,0,3,351
05-202-146,1177,486,0,486,0,2,484
05-202-147,1027,395,0,395,0,1,394
05-202-148,1097,437,0,436,-1,1,435
05-202-149,852,419,0,418,-1,3,415
05-202-150,897,423,0,423,0,1,422
05-202-151,766,348,0,348,0,2,346
05-202-152,880,377,0,377,0,0,377
05-202-153,982,465,0,464,-1,1,463
05-202-154,838,474,0,474,0,2,472
05-202-155,389,183,0,183,0,1,182
05-202-156,732,362,0,364,2,18,346
05-202-157,686,364,0,364,0,0,364
05-202-158,649,354,0,354,0,1,353
05-202-159,713,347,0,346,-1,1,345
05-202-160,135,74,0,74,0,1,73
05-203-001,69,41,0,41,0,0,41
05-204-001,191,55,0,55,0,0,55
05-205-001,610,246,0,246,0,0,246
05-205-002,585,270,0,270,0,4,266
05-206-001,405,183,0,183,0,0,183
05-207-001,831,311,0,311,0,0,311
05-207-002,759,223,0,223,0,2,221
05-207-003,809,227,0,227,0,2,225
05-208-001,690,210,0,210,0,4,206
05-209-001,608,279,0,279,0,1,278
05-210-001,60,35,0,35,0,0,35
05-211-001,256,99,0,99,0,0,99
05-212-001,560,150,0,150,0,2,148
05-213-001,585,210,0,210,0,1,209
05-214-001,725,287,0,287,0,4,283
05-215-001,243,112,0,112,0,1,111
05-216-001,1025,238,0,238,0,1,237
05-217-001,904,417,0,416,-1,3,413
05-217-002,768,326,0,326,0,1,325
05-217-003,795,303,0,303,0,1,302
05-217-004,781,331,0,331,0,2,329
05-217-005,932,341,0,341,0,4,337
05-218-001,26,16,0,16,0,0,16
05-219-001,302,137,0,137,0,0,137
05-220-001,244,89,1,88,-1,1,87
05-221-001,1256,381,0,381,0,1,380
05-222-001,727,220,0,220,0,2,218
05-222-002,870,228,0,228,0,4,224
05-222-003,912,382,0,382,0,0,382
05-222-004,906,408,0,408,0,1,407
05-222-005,169,60,0,60,0,0,60
05-222-006,104,31,0,31,0,0,31
05-223-001,616,147,0,147,0,0,147
05-223-002,581,203,0,203,0,0,203
05-224-001,305,119,0,119,0,0,119
05-225-001,903,239,0,239,0,1,238
05-225-002,933,258,0,258,0,2,256
05-226-001,697,279,0,279,0,1,278
05-226-002,869,280,0,280,0,1,279
05-226-003,931,284,0,284,0,0,284
05-226-004,1023,299,0,299,0,1,298
05-226-005,867,282,0,282,0,0,282
05-226-006,1275,432,0,432,0,1,431
05-226-007,866,300,0,300,0,2,298
05-226-008,769,218,0,218,0,2,216
05-226-009,636,216,0,216,0,0,216
05-226-010,745,173,0,173,0,0,173
05-226-011,905,315,0,315,0,0,315
05-226-012,943,389,0,389,0,2,387
05-226-013,825,300,0,300,0,1,299
05-226-014,792,271,0,271,0,3,268
05-226-015,774,306,0,306,0,1,305
05-226-016,683,338,0,338,0,0,338
05-226-017,677,260,0,260,0,0,260
05-226-018,322,113,0,113,0,2,111
05-226-019,649,189,0,189,0,0,189
05-226-020,693,207,0,207,0,0,207
05-226-021,409,162,0,162,0,0,162
05-226-022,204,99,0,99,0,0,99
05-226-023,792,177,0,177,0,1,176
05-226-024,840,200,0,200,0,0,200
05-226-025,870,88,0,88,0,3,85
05-226-026,750,159,0,159,0,3,156
05-226-027,658,133,0,133,0,0,133
05-226-028,740,173,0,173,0,2,171
05-226-029,223,80,0,80,0,4,76
05-226-030,196,69,0,69,0,0,69
05-226-031,895,219,0,219,0,1,218
05-226-032,937,285,0,285,0,4,281
05-226-033,948,379,1,378,-1,3,375
05-226-034,785,215,0,215,0,1,214
05-226-035,955,209,0,209,0,1,208
05-226-036,480,99,0,99,0,1,98
05-226-037,278,51,0,51,0,1,50
05-227-001,38,19,0,19,0,0,19
05-228-001,957,321,0,321,0,1,320
05-229-001,1136,271,0,271,0,1,270
05-230-001,902,343,0,343,0,6,337
05-231-001,51,27,0,27,0,0,27
05-232-001,237,65,0,65,0,0,65
05-233-001,23,14,0,14,0,0,14
05-234-001,655,227,1,226,-1,1,225
05-235-001,915,320,0,320,0,2,318
05-235-002,947,415,0,415,0,7,408
05-236-001,189,101,0,101,0,1,100
05-237-001,146,42,0,42,0,1,41
05-238-001,797,347,0,347,0,5,342
05-238-002,642,171,0,171,0,5,166
05-238-003,506,244,0,244,0,1,243
05-238-004,687,301,0,301,0,2,299
05-238-005,656,189,0,189,0,4,185
05-238-006,790,369,0,369,0,5,364
05-238-007,576,286,0,286,0,5,281
05-238-008,302,126,0,126,0,3,123
05-239-001,477,163,0,163,0,0,163
05-240-001,498,141,0,141,0,0,141
05-241-001,581,158,0,155,-3,11,144
05-242-001,258,126,0,126,0,1,125
05-243-001,413,140,0,140,0,0,140
05-244-001,775,348,0,348,0,2,346
05-245-001,76,49,0,49,0,0,49
05-246-001,399,216,0,216,0,0,216
05-247-001,385,122,0,122,0,1,121
05-248-001,649,154,0,154,0,2,152
05-248-002,632,143,0,143,0,1,142
05-249-001,738,221,0,221,0,2,219
05-249-002,647,165,0,165,0,0,165
05-249-003,591,178,0,178,0,0,178
05-250-001,580,118,0,118,0,1,117
05-251-001,740,265,0,265,0,0,265
05-251-002,667,231,0,231,0,4,227
05-251-003,732,234,0,234,0,1,233
05-252-001,863,346,0,346,0,1,345
05-253-001,288,115,0,115,0,1,114
05-254-001,772,252,0,252,0,3,249
05-255-001,525,218,0,218,0,4,214
05-256-001,772,187,0,187,0,2,185
05-256-002,550,156,0,156,0,1,155
05-256-003,853,251,0,251,0,7,244
05-257-001,338,146,0,146,0,3,143
05-258-001,1254,556,0,556,0,6,550
05-259-001,1114,408,0,408,0,2,406
05-259-002,1180,247,0,247,0,0,247
05-260-001,349,124,0,124,0,1,123
05-261-001,171,62,0,62,0,2,60
05-262-001,359,114,0,114,0,0,114
05-263-001,1152,505,0,505,0,1,504
05-264-001,607,252,0,252,0,3,249
05-265-001,1160,363,0,363,0,3,360
05-266-001,418,133,0,133,0,0,133
05-267-001,295,141,0,141,0,2,139
05-268-001,1133,433,0,433,0,6,427
05-268-002,647,175,0,175,0,0,175
05-268-003,696,246,1,245,-1,3,242
05-268-004,1154,408,0,408,0,1,407
05-268-005,1059,81,0,81,0,1,80
05-268-006,285,112,0,112,0,1,111
05-268-007,1053,359,0,359,0,2,357
05-268-008,1069,361,0,361,0,0,361
05-268-009,1296,394,0,394,0,2,392
05-268-010,1332,408,0,408,0,3,405
05-269-001,905,359,0,359,0,1,358
05-269-002,968,396,0,396,0,1,395
05-270-001,876,346,1,345,-1,1,344
05-270-002,846,273,0,273,0,1,272
05-271-001,619,210,0,210,0,1,209
05-272-001,1253,452,0,452,0,4,448
05-273-001,197,92,0,92,0,0,92
05-274-001,755,347,0,347,0,0,347
05-274-002,650,269,0,269,0,1,268
05-274-003,669,297,0,297,0,1,296
05-274-004,627,261,0,261,0,1,260
05-274-005,716,282,0,282,0,2,280
05-274-006,744,331,0,331,0,1,330
05-274-007,780,302,0,302,0,1,301
05-274-008,696,228,0,228,0,4,224
05-274-009,611,244,0,244,0,2,242
05-274-010,733,299,0,299,0,2,297
05-274-011,664,265,0,265,0,2,263
05-274-012,697,274,0,274,0,0,274
05-274-013,450,189,0,189,0,0,189
05-274-014,618,190,0,190,0,0,190
05-274-015,198,44,0,44,0,2,42
05-274-016,274,87,0,87,0,1,86
05-274-017,121,54,0,54,0,1,53
05-275-001,899,273,0,273,0,4,269
05-276-001,444,164,0,164,0,1,163
05-276-002,580,200,0,200,0,2,198
05-276-003,607,223,0,223,0,1,222
05-276-004,218,93,0,93,0,0,93
05-276-005,640,305,0,305,0,1,304
05-276-006,653,199,0,199,0,1,198
05-276-007,726,239,0,239,0,3,236
05-276-008,698,183,0,183,0,2,181
05-276-009,861,369,0,369,0,1,368
05-276-010,808,348,0,347,-1,3,344
05-276-011,659,286,0,286,0,1,285
05-276-012,795,321,0,321,0,1,320
05-276-013,711,318,0,318,0,1,317
05-276-014,734,285,0,285,0,3,282
05-276-015,751,330,0,330,0,1,329
05-276-016,699,306,0,306,0,6,300
05-276-017,637,279,0,279,0,1,278
05-276-018,560,226,0,226,0,0,226
05-276-019,258,128,0,128,0,0,128
05-277-001,340,128,0,128,0,3,125
05-278-001,379,68,0,68,0,5,63
05-279-001,810,244,0,244,0,1,243
05-280-001,30,19,0,19,0,0,19
05-281-001,179,97,0,97,0,0,97
05-282-001,98,59,0,59,0,0,59
05-283-001,377,190,0,190,0,0,190
05-284-001,762,145,0,145,0,1,144
05-285-001,733,234,0,234,0,2,232
05-286-001,92,26,0,26,0,0,26
05-287-001,256,100,0,100,0,0,100
05-288-001,199,87,0,87,0,1,86
05-289-001,270,54,0,54,0,0,54
05-290-001,653,145,0,145,0,0,145
05-290-002,803,190,0,190,0,2,188
05-290-003,725,257,0,257,0,0,257
05-290-004,780,259,0,259,0,1,258
05-291-001,1324,188,0,188,0,0,188
05-292-001,638,292,0,292,0,2,290
05-292-002,675,323,0,323,0,2,321
05-292-003,641,315,0,315,0,8,307
05-293-001,215,109,0,109,0,0,109
05-294-001,810,391,0,391,0,5,386
05-294-002,775,366,0,366,0,1,365
05-294-003,810,437,0,437,0,1,436
05-294-004,797,414,0,414,0,2,412
05-294-005,778,264,0,264,0,0,264
05-294-006,864,349,0,349,0,1,348
05-294-007,853,399,0,399,0,3,396
05-294-008,851,328,0,328,0,0,328
05-294-009,587,225,0,225,0,2,223
05-294-010,500,239,0,239,0,2,237
05-295-001,614,258,0,258,0,2,256
05-295-002,759,268,0,268,0,2,266
05-295-003,660,328,0,328,0,3,325
05-295-004,621,192,0,192,0,1,191
05-295-005,598,225,0,225,0,0,225
05-295-006,599,213,0,213,0,3,210
05-295-007,603,233,0,233,0,5,228
05-296-001,549,292,0,292,0,2,290
05-297-001,178,84,0,84,0,0,84
05-298-001,1031,484,0,484,0,2,482
05-298-002,847,411,0,411,0,1,410
05-298-003,826,335,0,335,0,1,334
05-298-004,853,336,0,336,0,0,336
05-299-001,1236,497,0,497,0,6,491
05-300-001,538,251,0,251,0,2,249
05-301-001,97,60,0,60,0,0,60
05-302-001,127,80,0,80,0,0,80
05-303-001,768,261,0,261,0,0,261
05-304-001,862,259,0,259,0,1,258
05-305-001,402,152,0,152,0,1,151
05-306-001,787,353,0,353,0,6,347
05-306-002,753,294,0,294,0,1,293
05-306-003,637,266,0,266,0,3,263
05-306-004,596,199,0,199,0,3,196
05-307-001,854,254,0,254,0,2,252
05-308-001,713,209,0,209,0,1,208
05-308-002,737,222,0,222,0,0,222
05-309-001,1117,381,0,381,0,3,378
05-309-002,1148,381,0,381,0,3,378
05-310-001,961,451,0,451,0,7,444
05-311-001,842,305,0,305,0,0,305
05-312-001,781,205,0,205,0,4,201
05-312-002,697,280,0,279,-1,5,274
05-313-001,489,197,0,197,0,3,194
05-314-001,23,15,0,15,0,0,15
05-315-001,1102,333,0,333,0,0,333
05-316-001,287,142,0,142,0,2,140
05-317-001,392,84,0,84,0,0,84
05-318-001,335,182,0,182,0,0,182
05-319-001,769,176,0,175,-1,1,174
05-319-002,848,127,0,127,0,0,127
05-319-003,210,29,0,29,0,0,29
05-320-001,707,252,0,252,0,1,251
05-320-002,624,178,0,178,0,3,175
05-320-003,699,240,0,240,0,1,239
05-321-001,513,232,0,232,0,0,232
05-322-001,766,148,0,148,0,2,146
05-322-002,886,278,0,278,0,1,277
05-322-003,760,187,0,187,0,1,186
05-322-004,750,139,0,139,0,1,138
05-322-005,768,174,0,174,0,1,173
05-323-001,1168,357,0,357,0,1,356
05-324-001,178,93,0,93,0,1,92
05-325-001,1047,379,0,379,0,5,374
05-326-001,702,273,0,273,0,0,273
05-326-002,707,186,0,186,0,1,185
05-326-003,229,119,0,119,0,0,119
05-326-004,808,309,0,308,-1,1,307
05-326-005,798,325,0,325,0,1,324
05-326-006,829,439,0,439,0,3,436
05-326-007,835,356,0,356,0,2,354
05-326-008,924,427,0,427,0,1,426
05-326-009,891,400,0,400,0,1,399
05-326-010,691,279,0,278,-1,1,277
05-326-011,832,342,0,342,0,2,340
05-326-012,830,308,0,308,0,0,308
05-326-013,850,358,0,358,0,0,358
05-326-014,882,333,0,333,0,1,332
05-326-015,861,328,0,328,0,1,327
05-326-016,778,338,0,338,0,3,335
05-326-017,1004,500,0,500,0,2,498
05-327-001,267,149,0,149,0,1,148
05-328-001,584,266,0,266,0,5,261
05-328-002,479,252,0,252,0,3,249
05-328-003,628,323,0,323,0,0,323
05-328-004,751,269,0,269,0,1,268
05-328-005,729,292,0,292,0,3,289
05-329-001,734,259,0,259,0,1,258
05-329-002,696,285,0,285,0,1,284
05-330-001,183,96,0,96,0,2,94
05-331-001,19,14,0,14,0,0,14
05-332-001,23,14,0,14,0,1,13
05-333-001,393,258,0,258,0,4,254
05-334-001,164,66,0,66,0,0,66
05-335-001,154,77,0,77,0,0,77
05-336-001,321,125,0,125,0,0,125
05-337-001,177,96,0,96,0,0,96
05-338-001,255,107,0,107,0,1,106
05-339-001,684,202,0,202,0,0,202
05-340-001,502,161,0,161,0,0,161
05-341-001,962,276,0,276,0,3,273
05-342-001,920,384,0,384,0,0,384
05-343-001,55,36,0,36,0,0,36
05-344-001,700,297,0,297,0,1,296
05-345-001,89,47,0,47,0,1,46
05-346-001,611,303,0,303,0,1,302
05-347-001,960,228,0,228,0,6,222
05-348-001,217,80,0,80,0,0,80
05-349-001,482,114,0,114,0,0,114
05-350-001,61,41,0,41,0,0,41
05-351-001,628,183,0,183,0,0,183
05-352-001,186,85,0,85,0,2,83
05-353-001,349,103,0,103,0,2,101
05-354-001,548,154,0,154,0,1,153
05-355-001,305,126,0,126,0,1,125
05-356-001,140,59,0,59,0,0,59
05-357-001,431,157,0,157,0,2,155
05-358-001,290,127,0,127,0,0,127
06-001-001,1056,484,0,484,0,4,480
06-001-002,1129,454,0,454,0,4,450
06-001-003,1100,431,0,431,0,3,428
06-001-004,1140,413,0,413,0,2,411
06-002-001,375,169,0,169,0,3,166
06-003-001,749,322,0,322,0,1,321
06-003-002,787,280,0,280,0,1,279
06-003-003,856,357,0,357,0,4,353
06-004-001,399,152,0,152,0,0,152
06-005-001,768,294,0,294,0,4,290
06-005-002,777,286,0,286,0,3,283
06-005-003,738,272,0,272,0,4,268
06-005-004,481,134,0,134,0,1,133
06-005-005,473,156,0,156,0,1,155
06-006-001,819,233,0,233,0,2,231
06-006-002,757,165,0,165,0,3,162
06-007-001,751,310,0,310,0,1,309
06-007-002,740,297,0,297,0,0,297
06-007-003,712,207,0,207,0,1,206
06-007-004,517,150,0,150,0,1,149
06-008-001,891,367,0,367,0,2,365
06-008-002,874,354,0,354,0,2,352
06-008-003,870,253,0,253,0,2,251
06-009-001,353,180,0,180,0,1,179
06-010-001,761,303,0,303,0,2,301
06-010-002,797,323,0,323,0,1,322
06-010-003,728,295,0,295,0,2,293
06-011-001,686,219,0,219,0,2,217
06-011-002,719,228,0,228,0,0,228
06-011-003,724,204,0,204,0,1,203
06-012-001,795,425,0,425,0,6,419
06-012-002,718,250,0,249,-1,2,247
06-013-001,993,334,0,334,0,3,331
06-013-002,821,304,0,304,0,0,304
06-013-003,776,339,0,339,0,5,334
06-013-004,940,318,0,318,0,3,315
06-013-005,815,281,0,281,0,0,281
06-013-006,912,266,0,266,0,2,264
06-013-007,824,368,0,368,0,1,367
06-013-008,1076,514,0,514,0,9,505
06-013-009,811,380,0,380,0,4,376
06-013-010,920,381,0,381,0,3,378
06-013-011,737,302,0,302,0,1,301
06-013-012,799,350,0,350,0,1,349
06-013-013,913,440,0,440,0,2,438
06-013-014,822,370,0,370,0,1,369
06-013-015,492,148,0,148,0,0,148
06-013-016,773,310,0,310,0,5,305
06-014-001,437,169,0,169,0,0,169
06-014-002,584,220,0,220,0,2,218
06-014-003,169,66,0,66,0,0,66
06-015-001,974,469,0,469,0,2,467
06-015-002,608,260,0,260,0,2,258
06-015-003,741,286,0,286,0,1,285
06-015-004,742,305,0,305,0,1,304
06-016-001,921,375,0,375,0,0,375
06-016-002,1090,471,0,471,0,4,467
06-016-003,875,361,0,361,0,1,360
06-016-004,1146,431,0,431,0,3,428
06-017-001,438,173,0,173,0,3,170
06-017-002,151,51,0,51,0,0,51
06-018-001,409,148,0,148,0,2,146
06-019-001,561,210,0,210,0,1,209
06-019-002,532,203,0,203,0,0,203
06-019-003,531,187,0,187,0,2,185
06-020-001,555,223,0,223,0,2,221
06-020-002,456,171,0,171,0,4,167
06-021-001,524,215,0,215,0,2,213
06-022-001,821,381,0,381,0,2,379
06-022-002,870,336,0,336,0,3,333
06-023-001,903,418,0,418,0,7,411
06-023-002,842,372,0,372,0,1,371
06-023-003,764,334,0,334,0,2,332
06-024-001,749,405,0,405,0,1,404
06-024-002,682,286,0,286,0,2,284
06-024-003,833,427,0,427,0,0,427
06-024-004,787,409,0,408,-1,1,407
06-024-005,703,380,0,380,0,2,378
06-024-006,734,452,0,452,0,1,451
06-024-007,595,348,0,348,0,0,348
06-024-008,630,383,0,383,0,3,380
06-024-009,647,436,0,435,-1,5,430
06-024-010,750,438,1,437,-1,3,434
06-024-011,784,386,0,386,0,1,385
06-024-012,665,328,0,328,0,3,325
06-024-013,597,295,0,295,0,1,294
06-024-014,962,434,0,434,0,4,430
06-024-015,792,388,0,388,0,0,388
06-024-016,845,329,0,329,0,6,323
06-024-017,994,529,0,529,0,6,523
06-024-018,952,513,0,513,0,1,512
06-024-019,834,493,0,493,0,0,493
06-024-020,901,497,0,497,0,4,493
06-024-021,804,409,0,409,0,3,406
06-024-022,801,388,0,388,0,1,387
06-024-023,1031,574,0,573,-1,5,568
06-024-024,580,291,0,291,0,2,289
06-024-025,665,343,0,343,0,1,342
06-024-026,795,347,0,347,0,0,347
06-024-027,735,354,0,354,0,0,354
06-024-028,731,361,0,361,0,1,360
06-024-029,584,265,0,265,0,2,263
06-024-030,639,353,0,353,0,7,346
06-024-031,577,257,0,257,0,1,256
06-024-032,724,358,0,358,0,1,357
06-024-033,876,415,0,415,0,3,412
06-024-034,919,449,0,449,0,4,445
06-024-035,914,403,0,403,0,1,402
06-024-036,856,449,0,449,0,4,445
06-024-037,879,483,0,483,0,2,481
06-024-038,861,508,1,507,-1,1,506
06-024-039,892,475,0,474,-1,2,472
06-024-040,829,432,0,432,0,4,428
06-024-041,914,562,0,562,0,5,557
06-024-042,233,107,0,107,0,1,106
06-024-043,449,248,0,248,0,0,248
06-024-044,250,127,0,127,0,1,126
06-024-045,461,256,0,256,0,1,255
06-024-046,299,126,0,126,0,0,126
06-024-047,279,145,0,145,0,1,144
06-024-048,485,214,0,214,0,1,213
06-024-049,192,80,0,80,0,0,80
06-024-050,1190,685,0,685,0,0,685
06-025-001,447,223,0,223,0,2,221
06-025-002,31,17,0,17,0,0,17
06-026-001,991,422,0,422,0,3,419
06-026-002,947,318,0,318,0,2,316
06-026-003,1033,351,0,351,0,6,345
06-026-004,991,364,0,364,0,3,361
06-026-005,1005,381,0,381,0,3,378
06-026-006,1035,341,0,341,0,3,338
06-027-001,816,287,0,287,0,1,286
06-027-002,788,268,0,268,0,0,268
06-027-003,777,314,0,314,0,3,311
06-027-004,786,323,0,323,0,1,322
06-028-001,426,142,0,142,0,0,142
06-029-001,334,191,0,191,0,0,191
06-030-001,1217,408,0,408,0,3,405
06-031-001,577,224,0,224,0,1,223
06-031-002,516,207,1,206,-1,0,206
06-032-001,720,408,0,407,-1,4,403
06-032-002,793,372,0,372,0,2,370
06-032-003,914,415,0,415,0,8,407
06-032-004,845,363,0,363,0,1,362
06-032-005,710,337,0,337,0,3,334
06-032-006,725,315,0,315,0,1,314
06-032-007,644,296,0,296,0,1,295
06-032-008,759,368,0,368,0,6,362
06-032-009,948,209,0,209,0,1,208
06-032-010,1014,518,0,517,-1,1,516
06-032-011,1021,381,0,381,0,2,379
06-032-012,768,382,0,382,0,2,380
06-032-013,908,480,1,480,0,0,480
06-032-014,831,404,0,404,0,2,402
06-032-015,915,460,0,460,0,10,450
06-032-016,700,349,0,349,0,0,349
06-032-017,763,382,0,382,0,6,376
06-032-018,1014,491,0,491,0,3,488
06-032-019,668,342,0,342,0,1,341
06-032-020,700,337,0,336,-1,2,334
06-032-021,870,404,0,404,0,3,401
06-032-022,725,343,0,343,0,2,341
06-032-023,912,385,0,385,0,1,384
06-033-001,523,239,0,239,0,0,239
06-033-002,549,227,0,227,0,1,226
06-033-003,596,211,0,211,0,2,209
06-034-001,699,379,0,379,0,3,376
06-034-002,342,205,0,205,0,2,203
06-035-001,1184,435,0,435,0,0,435
06-035-002,1134,425,0,424,-1,1,423
06-035-003,1127,434,0,434,0,1,433
06-035-004,978,353,0,353,0,2,351
06-035-005,1028,372,0,372,0,2,370
06-036-001,648,352,0,352,0,1,351
06-036-002,758,400,0,400,0,3,397
06-036-003,931,497,0,497,0,9,488
06-036-004,918,553,0,553,0,1,552
06-036-005,850,432,0,432,0,4,428
06-036-006,312,114,0,114,0,0,114
06-036-007,259,113,0,113,0,1,112
06-036-008,309,141,0,141,0,0,141
06-036-009,165,76,0,76,0,0,76
06-037-001,404,160,0,160,0,2,158
06-038-001,390,184,0,184,0,1,183
06-039-001,550,169,0,169,0,0,169
06-039-002,661,213,0,213,0,0,213
06-039-003,524,207,0,207,0,3,204
06-039-004,494,230,0,230,0,5,225
06-039-005,137,56,0,56,0,1,55
06-040-001,354,96,0,96,0,0,96
06-041-001,406,205,0,205,0,2,203
06-042-001,590,198,0,198,0,2,196
06-042-002,484,151,0,151,0,6,145
06-042-003,355,100,0,100,0,3,97
06-042-004,150,49,0,49,0,1,48
06-043-001,422,211,0,211,0,3,208
06-043-002,141,44,0,44,0,1,43
06-044-001,617,300,0,300,0,5,295
06-044-002,514,265,0,265,0,2,263
06-045-001,873,348,0,348,0,2,346
06-046-001,742,336,0,336,0,1,335
06-046-002,429,112,0,112,0,1,111
06-047-001,1088,405,0,405,0,5,400
06-047-002,1299,502,0,502,0,3,499
06-047-003,581,166,0,166,0,6,160
06-048-001,1078,407,0,407,0,3,404
06-048-002,987,363,0,363,0,2,361
06-049-001,840,271,0,271,0,2,269
06-049-002,844,286,0,286,0,3,283
06-049-003,650,242,0,242,0,2,240
06-049-004,733,245,0,245,0,2,243
06-049-005,815,345,0,345,0,4,341
06-049-006,842,336,1,336,0,4,332
06-049-007,801,320,0,320,0,1,319
06-049-008,727,270,0,270,0,1,269
06-049-009,466,113,0,113,0,0,113
06-050-001,944,300,0,300,0,6,294
06-050-002,936,365,0,365,0,0,365
06-050-003,1014,327,0,327,0,1,326
06-050-004,1146,399,0,399,0,1,398
06-051-001,1414,528,2,526,-2,0,526
06-051-002,1039,451,0,451,0,1,450
06-051-003,1174,502,0,502,0,2,500
06-051-004,1282,503,0,503,0,3,500
06-051-005,1079,441,0,441,0,1,440
06-051-006,1291,694,0,695,1,11,684
06-051-007,1394,663,0,663,0,4,659
06-051-008,1152,430,0,430,0,0,430
06-051-009,1338,496,0,496,0,2,494
06-051-010,1067,459,0,459,0,2,457
06-051-011,1138,515,1,515,0,2,513
06-051-012,1402,707,0,707,0,5,702
06-051-013,1189,525,0,525,0,1,524
06-051-014,1363,643,1,643,0,2,641
06-051-015,1201,454,0,453,-1,7,446
06-051-016,1275,478,0,478,0,0,478
06-051-017,1312,575,0,575,0,2,573
06-051-018,1225,548,0,548,0,0,548
06-051-019,1365,738,0,737,-1,1,736
06-051-020,1037,478,0,478,0,2,476
06-051-101,1447,653,0,653,0,0,653
06-051-102,1350,557,0,557,0,1,556
06-051-103,1056,467,0,467,0,3,464
06-051-104,1284,465,1,464,-1,1,463
06-051-105,1084,446,0,446,0,0,446
06-051-106,1249,617,0,616,-1,3,613
06-051-107,1302,627,0,627,0,3,624
06-051-108,1277,506,0,506,0,2,504
06-051-109,1295,576,0,576,0,1,575
06-051-110,1246,514,0,514,0,0,514
06-051-111,1130,554,0,554,0,2,552
06-051-112,1390,655,0,655,0,0,655
06-051-113,1296,542,0,542,0,2,540
06-051-114,1273,494,0,494,0,0,494
06-051-115,1177,531,0,531,0,1,530
06-051-116,1356,648,0,648,0,5,643
06-051-117,1241,571,0,571,0,1,570
06-051-118,1251,567,0,567,0,2,565
06-051-119,1387,723,0,724,1,9,715
06-051-120,1350,695,0,695,0,4,691
06-051-201,1434,562,0,562,0,2,560
06-051-202,1231,524,0,524,0,3,521
06-051-203,1108,547,0,546,-1,2,544
06-051-204,1309,466,0,466,0,2,464
06-051-205,1095,468,0,467,-1,2,465
06-051-206,1147,663,0,663,0,2,661
06-051-207,662,300,0,300,0,0,300
06-051-208,1311,529,0,529,0,7,522
06-051-209,1251,555,0,555,0,3,552
06-051-210,993,454,0,452,-2,2,450
06-051-211,701,332,0,331,-1,0,331
06-051-212,1060,474,0,474,0,11,463
06-051-213,1222,543,0,543,0,0,543
06-051-214,1224,523,0,521,-2,5,516
06-051-215,1268,504,0,504,0,2,502
06-051-216,1262,534,0,534,0,9,525
06-051-217,1175,547,0,547,0,2,545
06-051-218,1230,569,0,569,0,7,562
06-051-219,1219,675,0,675,0,0,675
06-051-220,1303,694,0,694,0,2,692
06-051-301,1454,519,0,519,0,2,517
06-051-302,1011,427,0,427,0,4,423
06-051-303,925,475,0,475,0,3,472
06-051-304,1300,538,0,536,-2,2,534
06-051-305,1359,605,0,605,0,1,604
06-051-306,1121,616,0,616,0,2,614
06-051-307,1379,674,0,673,-1,1,672
06-051-308,1199,435,0,434,-1,3,431
06-051-309,1211,527,0,526,-1,6,520
06-051-310,1019,515,0,515,0,2,513
06-051-311,3629,2584,0,2582,-2,4,2578
06-051-312,1212,608,0,608,0,4,604
06-051-313,1142,470,0,470,0,0,470
06-051-314,1350,665,0,665,0,3,662
06-051-315,1225,495,0,495,0,7,488
06-051-316,1280,495,0,495,0,0,495
06-051-317,1292,511,0,511,0,1,510
06-051-318,1204,659,0,659,0,5,654
06-051-319,1222,572,0,572,0,3,569
06-051-320,1128,555,0,555,0,1,554
06-051-401,1417,578,0,578,0,2,576
06-051-402,1053,413,0,413,0,0,413
06-051-403,901,459,0,459,0,0,459
06-051-404,1210,479,0,479,0,1,478
06-051-405,937,400,0,400,0,4,396
06-051-406,948,501,0,501,0,1,500
06-051-407,1124,481,0,481,0,2,479
06-051-408,1139,462,0,462,0,2,460
06-051-409,1380,585,0,585,0,0,585
06-051-410,1066,493,0,492,-1,5,487
06-051-411,925,416,0,416,0,1,415
06-051-412,1359,575,0,574,-1,1,573
06-051-413,1274,514,0,514,0,3,511
06-051-414,1308,559,2,557,-2,1,556
06-051-415,1315,490,0,490,0,2,488
06-051-416,1309,643,0,643,0,3,640
06-051-417,1235,493,0,493,0,2,491
06-051-418,1273,644,0,643,-1,2,641
06-051-419,1290,734,3,731,-3,4,727
06-051-420,1070,534,0,534,0,1,533
06-051-502,1053,503,0,501,-2,1,500
06-051-503,1128,579,0,579,0,2,577
06-051-505,1158,468,0,468,0,0,468
06-051-507,1059,421,0,421,0,0,421
06-051-511,662,315,0,315,0,2,313
06-051-520,1120,502,0,502,0,0,502
06-051-603,936,512,0,512,0,1,511
06-051-611,756,347,0,347,0,3,344
06-052-001,613,288,0,288,0,5,283
06-052-002,660,299,0,299,0,3,296
06-052-003,575,249,0,249,0,4,245
06-052-004,581,226,0,226,0,0,226
06-052-005,575,227,0,227,0,1,226
06-052-006,572,226,0,226,0,1,225
06-052-007,72,32,0,32,0,0,32
06-053-001,731,401,0,401,0,4,397
06-053-002,660,278,0,278,0,0,278
06-053-003,704,300,0,300,0,0,300
06-053-004,59,25,0,25,0,0,25
06-053-005,196,98,0,98,0,0,98
06-053-006,877,329,0,329,0,2,327
06-053-007,1000,425,0,425,0,1,424
06-053-008,674,245,0,245,0,0,245
06-053-009,674,278,0,278,0,1,277
06-053-010,736,266,0,266,0,6,260
06-053-011,137,51,0,51,0,0,51
06-053-012,167,43,0,43,0,0,43
06-053-013,98,48,0,48,0,0,48
06-053-014,905,444,0,444,0,1,443
06-053-015,926,425,0,424,-1,1,423
06-053-016,681,317,0,317,0,0,317
06-053-017,919,376,0,376,0,0,376
06-053-018,670,337,0,337,0,1,336
06-053-019,710,369,0,369,0,1,368
06-053-020,656,284,0,284,0,1,283
06-053-021,864,414,0,414,0,2,412
06-053-022,872,409,0,409,0,6,403
06-053-023,773,350,0,350,0,1,349
06-053-024,596,253,0,253,0,4,249
06-053-025,932,433,0,433,0,1,432
06-053-026,856,379,0,379,0,0,379
06-053-027,614,279,0,279,0,3,276
06-053-028,823,334,0,334,0,0,334
06-053-029,840,348,0,348,0,0,348
06-053-030,625,295,0,295,0,2,293
06-053-031,146,56,0,56,0,0,56
06-053-032,1103,356,0,356,0,1,355
06-053-033,689,227,0,227,0,0,227
06-053-034,85,29,0,29,0,0,29
06-053-035,172,74,0,74,0,1,73
06-054-001,922,482,0,482,0,4,478
06-054-002,878,454,0,454,0,3,451
06-055-001,719,334,0,334,0,4,330
06-055-002,775,313,0,313,0,2,311
06-056-001,732,281,0,281,0,2,279
06-056-002,688,200,0,200,0,2,198
06-057-001,809,351,0,351,0,2,349
06-057-002,761,351,0,351,0,4,347
06-058-001,845,297,0,297,0,1,296
06-058-002,886,369,1,368,-1,3,365
06-058-003,829,323,0,323,0,3,320
06-059-001,1153,501,0,501,0,3,498
06-059-002,1136,494,0,494,0,3,491
06-060-001,904,340,0,340,0,1,339
06-060-002,914,358,0,358,0,0,358
06-060-003,1041,476,0,476,0,1,475
07-001-001,1102,285,0,284,-1,2,282
07-001-002,1033,318,0,318,0,0,318
07-001-003,200,71,0,71,0,1,70
07-001-004,192,72,0,72,0,1,71
07-001-005,1185,403,0,403,0,3,400
07-002-001,1022,373,0,373,0,2,371
07-002-002,1129,397,2,395,-2,2,393
07-002-003,1039,400,0,400,0,2,398
07-003-001,847,272,0,272,0,0,272
07-003-002,656,201,0,201,0,0,201
07-004-001,486,261,0,260,-1,3,257
07-004-002,680,339,0,339,0,3,336
07-005-001,483,169,0,169,0,0,169
07-006-001,806,309,0,309,0,4,305
07-006-002,885,389,0,389,0,0,389
07-006-003,865,388,0,388,0,5,383
07-007-001,129,74,0,74,0,0,74
07-008-001,380,148,0,148,0,1,147
07-008-002,387,177,0,177,0,0,177
07-009-001,729,285,0,285,0,2,283
07-009-002,659,263,0,263,0,2,261
07-009-003,817,376,0,376,0,1,375
07-009-004,696,253,0,253,0,2,251
07-010-001,1167,482,0,482,0,2,480
07-010-002,963,396,0,396,0,1,395
07-010-003,131,59,0,59,0,1,58
07-011-001,908,335,0,335,0,6,329
07-012-001,692,233,0,233,0,2,231
07-012-002,764,247,0,247,0,4,243
07-013-001,1152,605,0,605,0,2,603
07-013-002,1198,404,0,404,0,1,403
07-013-003,1168,552,0,552,0,4,548
07-013-004,1208,591,0,591,0,2,589
07-013-005,1034,569,0,569,0,7,562
07-013-006,1126,565,0,565,0,4,561
07-013-007,1148,572,0,572,0,1,571
07-013-008,1093,436,0,436,0,0,436
07-014-001,800,382,0,382,0,1,381
07-014-002,771,344,0,344,0,1,343
07-014-003,742,353,0,353,0,4,349
07-014-004,954,448,0,448,0,3,445
07-015-001,203,130,0,130,0,1,129
07-016-001,740,306,0,306,0,1,305
07-016-002,663,250,0,250,0,2,248
07-016-003,688,219,0,219,0,0,219
07-017-001,857,431,0,431,0,3,428
07-017-002,165,68,0,68,0,0,68
07-018-001,963,474,0,474,0,3,471
07-019-001,924,413,0,413,0,2,411
07-019-002,791,401,0,401,0,1,400
07-019-003,935,472,0,472,0,2,470
07-019-004,927,357,0,357,0,5,352
07-019-005,765,348,0,348,0,2,346
07-020-001,1195,669,0,669,0,5,664
07-021-001,834,325,0,325,0,3,322
07-021-002,676,279,0,279,0,5,274
07-022-001,815,244,0,244,0,1,243
07-023-001,869,260,1,259,-1,0,259
07-023-002,921,285,0,285,0,7,278
07-024-001,1007,502,0,502,0,5,497
07-024-002,878,418,1,417,-1,0,417
07-024-003,493,234,0,234,0,1,233
07-024-004,740,360,0,360,0,1,359
07-024-005,1213,553,0,554,1,18,536
07-024-006,560,293,0,294,1,11,283
07-024-007,630,328,0,327,-1,0,327
07-024-008,551,236,0,236,0,4,232
07-024-009,706,328,0,328,0,0,328
07-024-010,922,370,0,369,-1,4,365
07-024-011,685,268,0,268,0,0,268
07-024-012,795,338,0,338,0,1,337
07-024-013,800,340,0,340,0,0,340
07-024-014,845,340,0,340,0,0,340
07-024-015,790,329,0,329,0,1,328
07-024-016,713,317,0,317,0,0,317
07-024-017,490,223,0,223,0,1,222
07-024-018,792,322,0,322,0,0,322
07-024-019,694,335,0,335,0,3,332
07-024-020,696,334,0,334,0,1,333
07-024-021,441,209,0,209,0,0,209
07-024-022,827,411,0,411,0,0,411
07-024-023,785,368,0,367,-1,4,363
07-024-024,810,358,0,358,0,1,357
07-024-025,748,312,0,312,0,1,311
07-024-026,733,312,0,312,0,0,312
07-024-027,639,279,0,279,0,0,279
07-024-028,628,261,0,261,0,0,261
07-024-029,609,285,0,285,0,1,284
07-024-030,821,346,0,346,0,2,344
07-024-031,576,261,0,261,0,1,260
07-024-032,792,317,0,317,0,0,317
07-024-033,780,299,0,296,-3,0,296
07-024-034,597,255,0,255,0,1,254
07-024-035,799,279,0,279,0,4,275
07-024-036,949,429,0,429,0,1,428
07-024-037,988,402,0,402,0,0,402
07-024-038,1086,449,0,449,0,2,447
07-024-039,989,360,0,360,0,2,358
07-024-040,985,383,0,383,0,1,382
07-024-041,1049,411,0,411,0,1,410
07-024-042,994,446,0,446,0,1,445
07-024-043,1010,560,0,559,-1,0,559
07-024-044,1058,595,0,595,0,2,593
07-024-045,1136,502,0,502,0,1,501
07-024-046,1223,579,0,579,0,2,577
07-024-047,423,129,0,129,0,0,129
07-025-001,831,265,0,265,0,2,263
07-025-002,489,160,0,160,0,0,160
07-025-003,563,224,0,224,0,1,223
07-026-001,841,296,0,296,0,1,295
07-026-002,834,280,0,280,0,1,279
07-026-003,888,285,0,285,0,6,279
07-026-004,977,297,0,297,0,0,297
07-026-005,838,213,0,213,0,2,211
07-026-006,566,168,0,168,0,0,168
07-026-007,307,87,0,87,0,0,87
07-026-008,145,55,0,55,0,0,55
07-027-001,1071,365,0,365,0,6,359
07-027-002,1030,422,0,422,0,1,421
07-027-003,1151,526,0,526,0,5,521
07-027-004,784,273,0,273,0,1,272
07-027-005,905,374,0,374,0,2,372
07-027-006,1086,252,0,252,0,4,248
07-027-007,222,99,0,99,0,0,99
07-027-008,283,119,0,119,0,1,118
07-028-001,1127,526,0,526,0,2,524
07-028-002,923,398,0,398,0,1,397
07-028-003,1197,562,0,562,0,3,559
07-028-004,117,33,0,33,0,0,33
07-029-001,916,391,0,391,0,2,389
07-029-002,746,312,0,312,0,2,310
07-030-001,702,374,0,374,0,2,372
07-030-002,803,486,0,486,0,4,482
07-031-001,734,307,0,307,0,0,307
07-032-001,508,266,0,266,0,2,264
07-033-001,1647,989,0,988,-1,0,988
07-033-002,1004,440,0,440,0,4,436
07-033-003,1305,632,0,631,-1,1,630
07-033-004,1194,578,0,578,0,1,577
07-033-005,1074,490,0,490,0,1,489
07-033-006,1171,603,0,603,0,3,600
07-033-007,1357,653,0,653,0,5,648
07-033-008,893,339,2,338,-1,0,338
07-034-001,1022,480,0,480,0,2,478
07-035-001,772,251,0,251,0,3,248
07-036-001,318,119,0,119,0,0,119
07-036-002,212,49,0,49,0,0,49
07-036-003,247,60,0,60,0,3,57
07-037-001,982,443,0,443,0,6,437
07-037-002,728,287,0,286,-1,1,285
07-038-001,670,295,0,295,0,4,291
07-038-002,71,38,0,38,0,0,38
07-039-001,1206,400,0,400,0,3,397
07-039-002,1066,355,0,355,0,4,351
07-040-001,1070,397,2,395,-2,4,391
07-041-001,906,403,0,403,0,1,402
07-042-001,982,292,0,292,0,1,291
07-042-002,930,291,0,291,0,1,290
07-043-001,1076,543,0,543,0,3,540
07-043-002,836,385,0,385,0,1,384
07-043-003,330,169,0,169,0,0,169
07-043-004,878,403,0,403,0,1,402
07-044-001,540,204,0,204,0,1,203
07-044-002,713,308,0,308,0,1,307
07-045-001,588,274,0,274,0,1,273
07-045-002,631,288,0,288,0,0,288
07-046-001,915,160,0,160,0,2,158
07-046-002,1082,277,0,277,0,0,277
07-047-001,615,271,0,271,0,0,271
07-047-002,664,281,0,281,0,0,281
07-048-001,1416,527,0,527,0,2,525
07-048-002,1221,539,0,539,0,1,538
07-049-001,376,100,0,100,0,1,99
07-049-002,38,22,0,22,0,0,22
07-049-003,693,269,0,269,0,1,268
07-049-004,688,255,0,255,0,0,255
07-050-001,895,329,0,329,0,2,327
07-050-002,866,280,0,280,0,0,280
07-050-003,765,291,0,291,0,1,290
07-051-001,727,298,0,298,0,3,295
07-051-002,716,314,0,314,0,0,314
07-051-003,767,304,0,304,0,0,304
07-052-001,1311,641,0,641,0,5,636
07-053-001,1168,532,0,532,0,1,531
07-053-002,1129,561,0,561,0,2,559
07-053-003,1082,553,0,553,0,2,551
07-053-004,1156,542,0,542,0,2,540
07-054-001,1060,515,0,515,0,1,514
07-054-002,853,318,0,318,0,2,316
07-055-001,584,159,0,159,0,1,158
07-056-001,1007,347,0,347,0,1,346
07-056-002,971,310,0,310,0,1,309
07-056-003,951,356,0,355,-1,1,354
07-056-004,843,199,0,199,0,2,197
07-057-001,762,281,0,281,0,1,280
07-058-001,473,154,0,154,0,0,154
07-058-002,549,107,0,107,0,2,105
07-059-001,727,195,0,194,-1,2,192
07-059-002,963,305,0,305,0,1,304
07-060-001,455,231,0,231,0,1,230
07-061-001,722,352,0,352,0,3,349
07-061-002,852,385,0,385,0,0,385
07-061-003,757,313,0,313,0,3,310
07-061-004,763,431,0,431,0,2,429
07-061-005,708,311,0,311,0,0,311
07-061-006,648,358,0,358,0,1,357
07-061-007,935,447,0,447,0,1,446
07-061-008,545,263,0,263,0,1,262
07-061-009,821,439,0,439,0,0,439
07-061-010,582,340,0,340,0,0,340
07-061-011,1106,527,0,527,0,1,526
07-061-012,1219,636,0,636,0,1,635
07-061-013,715,374,0,374,0,0,374
07-061-014,700,393,0,393,0,5,388
07-061-015,167,69,0,69,0,0,69
07-062-001,488,277,0,277,0,0,277
07-063-001,490,162,1,161,-1,1,160
07-063-002,510,182,3,179,-3,1,178
07-063-003,135,46,0,46,0,1,45
07-064-001,878,271,0,271,0,2,269
07-065-001,513,226,0,226,0,0,226
07-066-001,776,344,0,344,0,0,344
07-066-002,859,440,0,440,0,1,439
07-066-003,857,435,0,435,0,4,431
07-066-004,783,400,0,400,0,1,399
07-066-005,107,40,0,40,0,0,40
07-067-001,435,155,0,155,0,0,155
07-067-002,533,199,0,199,0,0,199
07-067-003,471,171,0,170,-1,0,170
07-068-001,450,222,0,222,0,4,218
07-068-002,207,72,0,72,0,0,72
07-069-001,975,481,0,481,0,2,479
07-069-002,941,460,0,460,0,4,456
07-069-003,769,362,0,362,0,3,359
07-070-001,726,344,0,341,-3,2,339
07-070-002,683,258,0,258,0,2,256
07-071-001,919,463,2,462,-1,2,460
07-071-002,828,438,0,438,0,1,437
07-072-001,759,221,0,221,0,2,219
07-072-002,714,232,0,232,0,2,230
07-072-003,796,241,0,241,0,4,237
07-072-004,868,226,0,226,0,2,224
07-073-001,318,117,0,117,0,2,115
07-073-002,935,327,0,327,0,1,326
07-073-003,1024,391,0,391,0,2,389
07-073-004,961,293,0,293,0,1,292
07-073-005,808,229,0,229,0,3,226
07-073-006,1093,375,0,375,0,3,372
07-073-007,216,69,0,69,0,2,67
07-074-001,983,288,0,288,0,2,286
07-074-002,751,315,0,315,0,2,313
07-074-003,991,320,0,320,0,0,320
07-074-004,972,296,0,296,0,0,296
07-074-005,1164,380,0,380,0,1,379
07-075-001,754,361,0,361,0,0,361
07-075-002,625,265,0,265,0,4,261
07-075-003,571,291,0,291,0,3,288
07-076-001,946,422,0,422,0,0,422
07-076-002,983,366,0,366,0,3,363
07-076-003,946,450,0,450,0,1,449
07-076-004,970,482,0,482,0,0,482
07-077-001,876,314,0,314,0,2,312
07-077-002,909,291,0,291,0,2,289
07-077-003,994,342,0,342,0,4,338
07-078-001,720,218,0,218,0,2,216
07-078-002,644,262,0,262,0,2,260
07-078-003,514,219,0,219,0,0,219
07-078-004,666,221,0,221,0,0,221
07-078-005,618,224,0,224,0,2,222
07-078-006,519,227,0,227,0,3,224
07-078-007,566,215,1,215,0,1,214
07-078-008,584,233,0,233,0,0,233
07-078-009,605,264,0,264,0,1,263
07-078-010,666,296,0,296,0,0,296
07-078-011,683,251,0,250,-1,0,250
07-078-012,712,242,0,242,0,1,241
07-078-013,469,199,0,199,0,1,198
07-078-014,648,230,0,230,0,1,229
07-078-015,220,100,0,100,0,0,100
07-078-016,162,72,0,72,0,0,72
07-078-017,508,152,0,152,0,0,152
07-078-018,196,76,0,76,0,3,73
07-078-019,75,32,0,32,0,2,30
07-079-001,567,227,0,227,0,1,226
07-080-001,1265,656,0,656,0,5,651
07-081-001,646,130,1,129,-1,1,128
07-081-002,1053,178,0,178,0,0,178
07-082-001,483,161,0,161,0,3,158
07-083-001,1076,287,0,287,0,3,284
07-083-002,796,258,0,258,0,1,257
07-083-003,751,206,0,206,0,5,201
07-084-001,969,355,0,355,0,2,353
07-084-002,151,62,0,62,0,0,62
07-085-001,849,344,0,344,0,5,339
07-085-002,922,424,0,424,0,1,423
07-085-003,755,230,0,230,0,4,226
07-086-001,1014,415,0,415,0,3,412
07-086-002,1082,352,0,351,-1,0,351
07-086-003,860,271,0,271,0,0,271
07-086-004,704,175,0,175,0,1,174
07-087-001,751,224,0,224,0,3,221
07-087-002,767,245,0,245,0,1,244
07-088-001,415,229,0,229,0,2,227
07-089-001,1428,913,0,913,0,6,907
07-090-001,943,351,0,351,0,4,347
07-090-002,946,421,0,421,0,2,419
07-090-003,1031,345,0,345,0,1,344
07-090-004,995,389,0,389,0,0,389
07-091-001,1280,388,0,388,0,3,385
07-091-002,474,138,0,138,0,2,136
07-092-001,597,207,0,207,0,3,204
07-092-002,63,18,0,18,0,0,18
07-093-001,641,364,0,365,1,10,355
07-093-002,689,320,0,320,0,1,319
07-094-001,714,340,0,340,0,1,339
07-094-002,859,401,0,401,0,0,401
07-094-003,641,276,0,276,0,1,275
07-094-004,558,293,0,293,0,0,293
07-094-005,695,302,0,302,0,0,302
07-094-006,494,247,0,246,-1,1,245
07-094-007,960,509,0,509,0,0,509
07-094-008,780,435,0,435,0,2,433
07-094-009,890,368,1,368,0,2,366
07-094-010,810,363,0,363,0,1,362
07-094-011,784,385,0,385,0,2,383
07-094-012,805,406,0,406,0,3,403
07-094-013,947,442,0,442,0,0,442
07-094-014,775,377,0,377,0,3,374
07-094-015,656,307,0,307,0,2,305
07-094-016,705,342,0,342,0,1,341
07-094-017,699,272,0,272,0,1,271
07-094-018,830,402,0,402,0,1,401
07-094-019,805,397,0,397,0,1,396
07-094-020,832,322,0,321,-1,1,320
07-094-021,936,465,0,464,-1,0,464
07-094-022,860,397,0,395,-2,1,394
07-094-023,947,455,0,455,0,2,453
07-094-024,584,313,0,313,0,0,313
07-094-025,577,260,0,260,0,0,260
07-094-026,652,299,0,299,0,0,299
07-094-027,809,452,0,452,0,3,449
07-094-028,2299,1350,0,1349,-1,11,1338
07-094-029,861,354,0,354,0,1,353
07-094-030,1081,446,0,446,0,1,445
07-094-031,817,392,0,392,0,1,391
07-094-032,881,420,0,420,0,3,417
07-094-033,552,262,0,262,0,0,262
07-094-034,1111,529,0,529,0,1,528
07-094-035,918,424,0,423,-1,1,422
07-094-036,848,391,0,391,0,1,390
07-094-037,816,397,0,397,0,1,396
07-094-038,905,398,0,398,0,4,394
07-094-039,922,460,0,460,0,0,460
07-094-040,1102,486,0,485,-1,0,485
07-094-041,1056,492,0,492,0,0,492
07-094-042,1012,365,0,365,0,3,362
07-094-043,1036,553,0,553,0,0,553
07-094-044,982,445,0,445,0,2,443
07-094-045,678,327,0,327,0,1,326
07-094-046,857,398,0,398,0,0,398
07-094-047,833,404,0,404,0,1,403
07-094-048,1158,623,1,621,-2,1,620
07-094-049,1212,624,0,624,0,2,622
07-094-050,776,394,0,394,0,1,393
07-094-051,1235,573,0,573,0,0,573
07-094-052,648,360,0,360,0,2,358
07-094-053,852,459,0,459,0,2,457
07-094-054,1062,543,0,543,0,3,540
07-094-055,754,418,0,418,0,0,418
07-094-056,498,265,0,265,0,2,263
07-094-057,583,313,0,313,0,0,313
07-094-058,967,519,0,519,0,2,517
07-094-059,636,361,0,359,-2,2,357
07-094-060,562,350,0,350,0,2,348
07-094-061,624,348,0,348,0,1,347
07-094-062,723,384,0,384,0,4,380
07-094-063,853,501,0,499,-2,1,498
07-094-064,963,554,0,554,0,0,554
07-094-065,714,410,0,410,0,2,408
07-094-066,1069,607,0,606,-1,1,605
07-094-067,1103,586,0,585,-1,5,580
07-094-068,905,487,0,487,0,0,487
07-094-069,844,542,0,542,0,2,540
07-094-070,951,545,0,545,0,2,543
07-094-071,794,495,0,495,0,2,493
07-094-072,904,595,0,595,0,1,594
07-094-073,1184,665,0,665,0,0,665
07-094-074,660,340,0,340,0,2,338
07-094-075,378,201,0,201,0,1,200
07-094-076,1127,503,0,503,0,1,502
07-094-077,1018,599,0,599,0,5,594
07-094-078,1044,524,0,524,0,2,522
07-094-079,867,453,0,453,0,3,450
07-094-080,1043,559,0,559,0,2,557
07-094-081,838,377,0,377,0,1,376
07-094-082,553,283,0,283,0,1,282
07-094-083,851,460,0,460,0,2,458
07-094-084,637,290,0,290,0,0,290
07-094-085,955,525,2,521,-4,0,521
07-094-086,799,352,0,352,0,2,350
07-094-087,1025,480,0,480,0,1,479
07-094-088,789,407,0,407,0,0,407
07-094-089,1263,532,0,532,0,3,529
07-094-090,1299,600,0,599,-1,2,597
07-094-091,465,160,0,160,0,1,159
07-094-092,205,110,0,110,0,0,110
07-095-001,756,354,1,354,0,3,351
07-096-001,713,281,0,281,0,2,279
07-096-002,639,249,0,249,0,1,248
07-097-001,1478,768,0,768,0,9,759
07-098-001,356,176,0,176,0,0,176
07-099-001,926,390,0,390,0,2,388
07-099-002,1010,404,1,403,-1,0,403
07-100-001,665,221,0,221,0,0,221
07-101-001,775,361,0,361,0,1,360
07-101-002,703,298,0,298,0,3,295
07-101-003,574,278,0,278,0,2,276
07-102-001,1131,559,2,557,-2,4,553
07-102-002,782,391,0,391,0,5,386
07-102-003,1213,707,0,707,0,1,706
07-102-004,1030,550,0,550,0,3,547
07-102-005,1156,609,0,609,0,5,604
07-103-001,635,261,0,260,-1,1,259
07-104-001,724,265,0,265,0,1,264
07-104-002,710,306,0,306,0,1,305
07-105-001,735,415,0,415,0,2,413
07-106-001,931,317,0,317,0,0,317
07-106-002,933,361,0,360,-1,1,359
07-107-001,765,312,0,312,0,0,312
07-108-001,581,211,0,211,0,5,206
07-108-002,424,129,3,126,-3,0,126
08-001-001,624,307,0,307,0,0,307
08-001-002,670,253,0,253,0,2,251
08-001-003,747,320,0,320,0,2,318
08-001-004,585,259,0,259,0,1,258
08-002-001,391,251,0,251,0,0,251
08-003-001,751,393,0,392,-1,1,391
08-004-001,860,376,0,376,0,2,374
08-004-002,893,442,0,442,0,2,440
08-005-001,211,123,0,123,0,0,123
08-006-001,895,338,0,338,0,4,334
08-006-002,754,322,0,322,0,1,321
08-007-001,938,467,0,467,0,2,465
08-008-001,132,77,0,77,0,1,76
08-009-001,231,109,0,109,0,0,109
08-010-001,861,339,0,339,0,3,336
08-010-002,616,230,0,230,0,1,229
08-011-001,606,235,0,235,0,4,231
08-012-001,571,299,0,299,0,1,298
08-012-002,529,234,0,234,0,0,234
08-013-001,954,436,0,436,0,3,433
08-013-002,936,456,0,456,0,4,452
08-013-003,266,125,0,125,0,0,125
08-014-001,422,209,0,209,0,0,209
08-014-002,387,202,0,202,0,1,201
08-014-003,151,72,0,72,0,1,71
08-015-001,408,169,0,169,0,1,168
08-016-001,264,140,0,140,0,0,140
08-017-001,528,256,0,256,0,1,255
08-018-001,1023,397,0,397,0,4,393
08-019-001,792,284,0,284,0,1,283
08-019-002,807,260,0,260,0,2,258
08-019-003,192,85,0,85,0,0,85
08-020-001,877,371,0,371,0,1,370
08-020-002,865,354,0,354,0,1,353
08-021-001,43,32,0,32,0,4,28
08-022-001,436,176,0,176,0,3,173
08-023-001,433,187,0,186,-1,3,183
08-024-001,179,98,0,98,0,2,96
08-025-001,29,20,0,20,0,0,20
08-026-001,409,204,0,204,0,0,204
08-027-001,1082,563,0,563,0,2,561
08-027-002,1062,564,0,564,0,2,562
08-027-003,1033,498,0,498,0,4,494
08-027-004,1033,579,0,579,0,2,577
08-027-005,1004,510,0,510,0,3,507
08-027-006,978,512,0,512,0,2,510
08-027-007,971,474,0,474,0,2,472
08-027-008,1066,508,0,508,0,1,507
08-028-001,631,254,0,254,0,2,252
08-028-002,660,311,0,311,0,0,311
08-029-001,322,157,0,157,0,0,157
08-030-001,501,275,0,275,0,0,275
08-031-001,676,276,0,276,0,0,276
08-031-002,763,326,0,326,0,4,322
08-032-001,209,99,0,99,0,1,98
08-033-001,860,341,0,341,0,1,340
08-033-002,838,303,0,303,0,1,302
08-034-001,589,211,0,211,0,0,211
08-035-001,193,83,0,83,0,0,83
08-035-002,447,205,0,205,0,1,204
08-035-003,584,277,0,276,-1,2,274
08-036-001,135,72,0,72,0,1,71
08-037-001,102,72,0,72,0,0,72
08-038-001,433,224,0,224,0,1,223
08-039-001,715,361,0,361,0,3,358
08-040-001,1419,583,0,583,0,1,582
08-041-001,883,371,0,371,0,0,371
08-041-002,759,379,0,379,0,0,379
08-042-001,771,411,0,411,0,10,401
08-042-002,798,373,0,373,0,0,373
08-043-001,378,164,0,164,0,1,163
08-044-001,430,202,0,202,0,1,201
08-045-001,758,306,0,306,0,1,305
08-046-001,97,48,0,48,0,3,45
08-047-001,248,134,0,134,0,0,134
08-048-001,1105,560,0,560,0,4,556
08-048-002,653,365,0,365,0,2,363
08-048-003,807,347,0,347,0,2,345
08-048-004,99,36,0,36,0,0,36
08-049-001,500,260,0,260,0,1,259
08-050-001,623,331,0,331,0,2,329
08-051-001,940,392,0,392,0,1,391
08-051-002,870,414,0,414,0,5,409
08-052-001,908,452,0,452,0,0,452
08-052-002,824,448,0,448,0,1,447
08-052-003,700,393,0,393,0,2,391
08-052-004,667,333,0,333,0,1,332
08-053-001,1016,488,0,488,0,3,485
08-054-001,851,303,0,303,0,2,301
08-054-002,852,325,0,325,0,2,323
08-054-003,844,326,0,326,0,1,325
08-055-001,55,32,0,32,0,0,32
08-056-001,1097,521,0,521,0,5,516
08-057-001,324,167,0,167,0,0,167
08-058-001,973,364,0,364,0,1,363
08-059-001,1082,511,0,511,0,0,511
08-059-002,1120,429,0,429,0,1,428
08-059-003,1016,493,0,493,0,1,492
08-059-004,1040,392,0,392,0,1,391
08-059-005,996,388,0,387,-1,0,387
08-059-006,1048,565,0,565,0,4,561
08-059-007,883,412,1,410,-2,4,406
08-059-008,2163,1618,0,1618,0,0,1618
08-059-009,720,359,0,358,-1,1,357
08-059-010,822,406,0,406,0,2,404
08-059-011,1099,418,0,418,0,0,418
08-059-012,1057,333,0,333,0,0,333
08-059-013,748,435,0,435,0,5,430
08-059-014,896,399,0,399,0,1,398
08-059-015,973,527,0,527,0,0,527
08-059-016,917,492,0,492,0,1,491
08-059-017,930,466,0,466,0,0,466
08-059-018,828,498,0,496,-2,1,495
08-059-019,842,429,0,429,0,0,429
08-059-020,719,396,0,396,0,1,395
08-059-021,1176,582,0,582,0,0,582
08-059-022,1228,644,0,644,0,3,641
08-059-023,1183,621,0,621,0,2,619
08-059-024,1233,590,0,590,0,0,590
08-059-025,1068,589,0,589,0,1,588
08-059-026,1203,660,0,660,0,0,660
08-059-027,1244,605,0,605,0,0,605
08-059-028,1123,584,0,584,0,0,584
08-059-029,1099,552,0,554,2,18,536
08-059-030,930,539,0,539,0,1,538
08-059-031,846,402,0,402,0,1,401
08-059-032,874,390,0,390,0,0,390
08-059-033,973,453,0,453,0,2,451
08-059-034,1037,468,0,468,0,2,466
08-059-035,1005,383,0,383,0,0,383
08-059-036,1042,438,1,437,-1,0,437
08-059-037,1094,393,0,393,0,1,392
08-059-038,1037,389,0,389,0,1,388
08-059-039,1079,473,0,473,0,0,473
08-059-040,1200,482,0,482,0,0,482
08-059-041,868,364,0,364,0,1,363
08-059-042,1034,407,0,407,0,2,405
08-059-043,1004,365,0,364,-1,1,363
08-059-044,919,401,0,401,0,3,398
08-059-045,950,452,0,452,0,1,451
08-059-046,910,380,0,380,0,0,380
08-059-047,963,396,0,396,0,0,396
08-059-048,907,405,0,405,0,2,403
08-059-049,906,328,0,328,0,1,327
08-059-050,866,379,0,379,0,1,378
08-059-051,892,393,0,393,0,3,390
08-059-052,1055,598,0,597,-1,3,594
08-059-053,839,407,0,407,0,4,403
08-059-054,1098,538,0,538,0,6,532
08-059-055,1083,325,0,325,0,2,323
08-059-056,1018,399,0,398,-1,0,398
08-059-057,947,394,0,394,0,0,394
08-059-058,1110,522,0,522,0,2,520
08-059-059,1046,526,0,526,0,1,525
08-059-060,1014,420,1,417,-3,0,417
08-059-061,961,503,0,503,0,2,501
08-059-062,1131,506,0,506,0,3,503
08-059-063,1043,473,0,473,0,0,473
08-059-064,1101,502,0,502,0,4,498
08-059-065,991,420,0,420,0,0,420
08-059-066,957,421,0,420,-1,0,420
08-059-067,1022,446,0,445,-1,1,444
08-059-068,891,437,0,437,0,0,437
08-059-069,992,570,0,570,0,4,566
08-059-070,883,483,0,483,0,1,482
08-059-071,963,349,0,349,0,0,349
08-059-072,1162,490,0,490,0,1,489
08-059-073,1075,400,0,400,0,2,398
08-059-074,1063,485,0,485,0,3,482
08-059-075,882,517,0,517,0,1,516
08-059-076,946,462,0,462,0,1,461
08-059-077,1002,525,0,525,0,1,524
08-059-078,950,505,0,505,0,2,503
08-059-079,935,489,0,489,0,0,489
08-059-080,1131,621,0,620,-1,3,617
08-059-081,1074,596,0,596,0,2,594
08-059-082,1217,389,0,389,0,1,388
08-059-083,1139,462,0,462,0,0,462
08-059-084,1123,483,0,483,0,0,483
08-059-085,1143,468,0,468,0,1,467
08-059-086,1112,534,0,534,0,0,534
08-059-087,1086,462,0,462,0,3,459
08-059-088,1274,559,0,559,0,4,555
08-059-089,1217,575,0,575,0,1,574
08-059-090,1117,573,0,573,0,0,573
08-059-091,1133,576,0,576,0,0,576
08-059-092,1114,597,0,597,0,2,595
08-059-093,1188,563,0,563,0,4,559
08-059-094,1196,579,0,579,0,1,578
08-059-095,1090,569,0,569,0,5,564
08-059-096,1225,595,0,595,0,2,593
08-060-001,425,176,0,176,0,2,174
08-061-001,1347,604,0,604,0,0,604
08-062-001,1209,530,0,530,0,2,528
08-063-001,646,257,0,257,0,2,255
08-064-001,770,214,0,214,0,0,214
08-064-002,827,255,0,255,0,1,254
08-064-003,965,421,0,421,0,2,419
08-065-001,1099,557,0,557,0,1,556
08-065-002,1140,606,0,606,0,0,606
08-065-003,1096,579,0,579,0,1,578
08-065-004,1098,550,0,550,0,6,544
08-065-005,1023,478,0,478,0,2,476
08-066-001,1550,832,0,832,0,1,831
08-067-001,1206,535,0,535,0,4,531
08-067-002,1094,484,0,484,0,0,484
08-068-001,1175,481,0,481,0,2,479
08-068-002,1233,554,0,554,0,2,552
08-068-003,130,55,0,55,0,0,55
08-069-001,978,388,0,388,0,0,388
08-069-002,961,504,0,504,0,2,502
08-070-001,958,417,0,417,0,3,414
08-070-002,954,344,0,344,0,0,344
08-070-003,800,313,0,313,0,1,312
08-071-001,1232,682,0,682,0,2,680
08-072-001,980,397,0,397,0,1,396
08-073-001,332,197,0,197,0,0,197
08-074-001,531,263,0,263,0,2,261
08-075-001,253,155,0,155,0,0,155
08-076-001,797,355,0,355,0,1,354
08-076-002,680,315,0,315,0,1,314
08-077-001,996,374,0,374,0,2,372
08-078-001,841,342,0,342,0,2,340
08-078-002,841,318,0,318,0,3,315
08-078-003,721,275,0,275,0,1,274
08-078-004,819,367,0,367,0,4,363
08-078-005,807,313,0,313,0,2,311
08-078-006,632,248,0,248,0,1,247
08-078-007,206,50,0,50,0,2,48
08-079-001,468,198,0,198,0,1,197
08-080-001,1031,434,0,434,0,2,432
08-081-001,142,62,0,62,0,1,61
08-081-002,1164,608,0,608,0,3,605
08-081-003,991,494,0,494,0,6,488
08-081-004,953,527,3,523,-4,2,521
08-081-005,1016,523,0,523,0,2,521
08-081-006,1068,499,0,499,0,0,499
08-081-007,1008,490,0,490,0,1,489
08-081-008,1044,556,0,555,-1,5,550
08-081-009,876,439,0,439,0,3,436
08-082-001,681,270,0,270,0,1,269
08-082-002,956,362,0,361,-1,3,358
08-082-003,193,90,0,90,0,0,90
08-083-001,199,127,0,127,0,0,127
08-084-001,707,339,0,339,0,4,335
08-085-001,288,156,0,156,0,0,156
08-086-001,622,342,1,341,-1,1,340
08-087-001,846,329,0,329,0,2,327
08-087-002,939,346,0,346,0,1,345
08-088-001,1083,498,0,498,0,2,496
08-088-002,1109,503,0,503,0,1,502
08-089-001,871,433,0,433,0,4,429
08-089-002,800,420,0,420,0,3,417
08-090-001,998,482,0,482,0,2,480
08-091-001,446,175,0,175,0,1,174
08-092-001,714,270,0,270,0,2,268
08-092-002,779,279,1,278,-1,2,276
08-093-001,1093,482,0,482,0,4,478
08-093-002,659,269,0,269,0,5,264
08-093-003,793,342,0,341,-1,1,340
08-094-001,602,288,0,288,0,0,288
08-095-001,1175,582,0,582,0,3,579
08-096-001,83,57,0,57,0,1,56
08-097-001,388,147,0,147,0,1,146
08-098-001,390,162,0,162,0,0,162
08-099-001,705,303,0,303,0,1,302
08-099-002,804,300,0,300,0,1,299
08-100-001,504,229,0,229,0,2,227
08-101-001,776,349,0,349,0,0,349
08-102-001,84,47,0,47,0,0,47
08-103-001,897,498,0,497,-1,4,493
08-104-001,820,350,0,349,-1,1,348
08-104-002,762,267,0,267,0,2,265
08-104-003,1086,592,0,592,0,1,591
08-104-004,1045,458,0,456,-2,0,456
08-104-005,780,318,0,318,0,2,316
08-104-006,878,343,0,343,0,0,343
08-104-007,910,355,0,355,0,3,352
08-104-008,1218,580,0,580,0,0,580
08-104-009,787,350,0,350,0,0,350
08-104-010,913,346,0,346,0,0,346
08-104-011,870,316,0,316,0,2,314
08-104-012,775,377,0,377,0,3,374
08-104-013,927,389,0,389,0,5,384
08-104-014,923,400,0,400,0,1,399
08-104-015,718,330,0,330,0,3,327
08-104-016,722,333,0,333,0,0,333
08-104-017,818,336,0,336,0,0,336
08-104-018,857,373,0,373,0,1,372
08-104-019,869,332,0,332,0,1,331
08-104-020,811,325,0,325,0,1,324
08-104-021,761,270,0,270,0,2,268
08-104-022,917,394,0,394,0,4,390
08-104-023,701,241,0,241,0,2,239
08-104-024,682,306,0,306,0,5,301
08-104-025,773,244,0,243,-1,2,241
08-104-026,832,316,0,316,0,1,315
08-104-027,873,335,0,335,0,2,333
08-104-028,877,321,0,321,0,1,320
08-104-029,785,324,0,324,0,2,322
08-104-030,809,375,0,375,0,2,373
08-105-001,974,391,0,391,0,2,389
08-105-002,1055,394,0,394,0,0,394
08-106-001,702,241,0,241,0,0,241
08-106-002,683,258,0,258,0,0,258
08-107-001,681,318,0,318,0,1,317
08-108-001,791,391,0,391,0,2,389
08-109-001,854,394,0,394,0,1,393
08-109-002,876,421,0,421,0,1,420
08-110-001,825,407,0,407,0,1,406
08-111-001,635,225,0,225,0,1,224
08-111-002,842,299,0,299,0,3,296
08-112-001,172,101,0,101,0,0,101
08-113-001,364,186,0,186,0,0,186
08-114-001,931,490,0,490,0,1,489
08-114-002,973,437,1,436,-1,1,435
08-114-003,1115,496,0,496,0,1,495
08-114-004,492,252,0,252,0,0,252
08-115-001,717,333,0,333,0,2,331
08-116-001,875,376,0,374,-2,1,373
08-116-002,780,341,0,340,-1,3,337
08-116-003,782,285,0,285,0,1,284
08-117-001,1101,454,0,454,0,6,448
08-117-002,724,314,0,314,0,3,311
08-117-003,800,325,0,325,0,1,324
08-117-004,190,118,0,118,0,0,118
08-118-001,325,142,0,142,0,0,142
08-119-001,247,141,0,141,0,1,140
08-120-001,825,344,0,344,0,2,342
08-121-001,1180,528,0,528,0,1,527
08-122-001,885,473,0,473,0,2,471
08-123-001,867,347,0,347,0,1,346
08-123-002,910,348,0,348,0,2,346
08-123-003,263,109,0,109,0,0,109
08-124-001,296,166,0,166,0,0,166
08-125-001,92,55,0,55,0,2,53
08-126-001,226,149,0,149,0,5,144
08-127-001,514,244,0,244,0,0,244
08-128-001,449,218,0,218,0,0,218
08-128-002,611,315,0,315,0,1,314
08-128-003,420,174,0,174,0,1,173
08-129-001,1034,417,0,417,0,3,414
08-130-001,430,194,0,194,0,1,193
08-131-001,478,214,0,214,0,1,213
08-132-001,603,278,0,278,0,1,277
08-133-001,1069,400,0,400,0,4,396
08-133-002,1037,424,1,423,-1,5,418
08-134-001,821,397,0,397,0,3,394
08-135-001,71,49,0,49,0,0,49
08-136-001,372,213,0,213,0,2,211
08-137-001,423,208,0,208,0,1,207
08-138-001,123,84,0,84,0,1,83
08-139-001,822,431,0,431,0,2,429
08-140-001,140,68,0,68,0,0,68
08-141-001,226,116,0,116,0,1,115
08-142-001,284,199,0,199,0,0,199
08-143-001,460,157,0,157,0,1,156
08-144-001,258,103,0,103,0,0,103
08-145-001,360,179,1,179,0,1,178
08-146-001,514,287,0,287,0,1,286
08-146-002,179,103,0,103,0,1,102
08-146-003,82,39,0,39,0,0,39
08-147-001,259,119,0,119,0,3,116
08-148-001,218,103,0,103,0,0,103
08-149-001,944,402,0,402,0,1,401
08-150-001,2111,1445,0,1444,-1,1,1443
08-150-002,1013,425,0,425,0,0,425
08-150-003,1081,462,0,462,0,1,461
08-150-004,939,530,0,530,0,4,526
08-150-005,785,431,0,431,0,5,426
08-150-006,941,468,0,468,0,1,467
08-150-007,1026,570,0,570,0,1,569
08-150-008,831,421,0,421,0,0,421
08-150-009,1080,543,0,543,0,2,541
08-150-010,780,386,0,386,0,2,384
08-150-011,827,378,0,378,0,2,376
08-150-012,843,389,0,389,0,2,387
08-150-013,790,352,0,352,0,2,350
08-150-014,780,373,0,373,0,1,372
08-150-015,773,382,0,382,0,2,380
08-150-016,958,470,0,470,0,1,469
08-150-017,641,354,0,354,0,1,353
08-150-018,815,416,0,416,0,1,415
08-150-019,1033,564,0,564,0,4,560
08-150-020,820,380,0,380,0,5,375
08-150-021,850,427,0,427,0,0,427
08-150-022,901,461,0,461,0,2,459
08-150-023,1109,565,0,565,0,3,562
08-150-024,855,335,0,335,0,2,333
08-150-025,687,301,0,301,0,0,301
08-150-026,647,308,0,308,0,1,307
08-150-027,766,366,0,366,0,1,365
08-150-028,1003,395,0,395,0,1,394
08-150-029,1266,586,0,586,0,10,576
08-150-030,760,315,0,315,0,1,314
08-150-031,1074,513,0,513,0,3,510
08-150-032,971,464,0,463,-1,0,463
08-150-033,1032,574,0,574,0,0,574
08-150-034,939,461,0,461,0,3,458
08-150-035,964,487,0,487,0,0,487
08-150-036,1012,496,0,496,0,1,495
08-150-037,975,502,0,502,0,0,502
08-150-038,932,532,0,532,0,1,531
08-150-039,1030,620,0,620,0,2,618
08-150-040,1165,669,0,669,0,6,663
08-150-041,987,650,0,650,0,2,648
08-150-042,840,527,0,527,0,4,523
08-150-043,986,531,0,531,0,0,531
08-150-044,936,438,0,438,0,1,437
08-150-045,720,420,0,420,0,1,419
08-150-046,758,345,0,345,0,2,343
08-150-047,983,520,0,520,0,2,518
08-150-048,1265,617,0,617,0,0,617
08-150-049,1202,640,0,640,0,1,639
08-150-050,762,314,0,313,-1,2,311
08-151-001,671,416,0,416,0,3,413
08-152-001,1013,513,0,513,0,3,510
08-153-001,254,138,0,138,0,2,136
08-154-001,342,165,0,165,0,1,164
08-155-001,1070,532,0,532,0,1,531
08-155-002,687,340,0,340,0,5,335
08-156-001,792,390,0,390,0,4,386
08-157-001,666,255,0,255,0,0,255
08-158-001,1082,451,0,451,0,3,448
08-159-001,558,288,0,288,0,0,288
08-160-001,333,154,0,154,0,3,151
08-161-001,605,272,0,272,0,2,270
08-162-001,740,320,0,320,0,3,317
08-163-001,163,92,0,92,0,0,92
08-164-001,1286,549,0,549,0,3,546
08-165-001,1177,377,0,377,0,2,375
08-165-002,989,384,0,384,0,0,384
08-165-003,1094,442,0,442,0,1,441
08-166-001,867,363,0,363,0,1,362
08-166-002,817,335,0,335,0,0,335
08-167-001,267,146,0,146,0,0,146
08-168-001,819,377,0,377,0,2,375
08-169-001,647,251,0,251,0,3,248
08-170-001,80,48,0,48,0,0,48
08-171-001,432,215,0,215,0,2,213
08-172-001,1621,735,0,734,-1,3,731
08-173-001,298,153,0,153,0,0,153
08-174-001,131,80,0,80,0,2,78
08-175-001,761,436,0,436,0,1,435
08-176-001,836,369,0,369,0,3,366
08-177-001,150,90,0,90,0,0,90
08-178-001,1107,553,0,553,0,2,551
08-179-001,307,196,0,196,0,0,196
08-180-001,118,70,0,70,0,0,70
08-181-001,541,277,0,277,0,1,276
08-182-001,446,153,0,153,0,0,153
08-183-001,367,112,0,112,0,0,112
09-001-001,733,181,0,181,0,2,179
09-001-002,700,192,0,192,0,0,192
09-002-001,538,206,0,206,0,3,203
09-003-001,929,288,0,288,0,1,287
09-003-002,945,182,0,182,0,5,177
09-004-001,983,352,0,352,0,3,349
09-005-001,1025,404,0,404,0,4,400
09-005-002,770,302,0,302,0,0,302
09-005-003,889,351,0,351,0,1,350
09-005-004,846,331,0,331,0,1,330
09-005-005,750,251,0,251,0,0,251
09-005-006,851,178,0,178,0,6,172
09-005-007,762,333,0,333,0,0,333
09-005-008,921,308,0,308,0,2,306
09-005-009,1016,263,0,263,0,0,263
09-005-010,783,217,0,217,0,0,217
09-005-011,1015,193,0,193,0,0,193
09-005-012,886,213,0,213,0,0,213
09-005-013,883,257,0,256,-1,11,245
09-005-014,824,260,0,260,0,2,258
09-005-015,812,298,0,298,0,2,296
09-005-016,897,287,0,287,0,2,285
09-005-017,86,33,0,33,0,0,33
09-006-001,625,234,0,234,0,1,233
09-006-002,696,211,0,211,0,0,211
09-006-003,717,216,0,216,0,2,214
09-007-001,286,117,0,117,0,4,113
09-008-001,719,199,0,199,0,0,199
09-008-002,789,254,0,254,0,3,251
09-009-001,833,380,0,380,0,0,380
09-009-002,672,327,0,327,0,4,323
09-009-003,683,266,0,266,0,0,266
09-009-004,996,381,0,381,0,1,380
09-009-005,629,179,1,179,0,1,178
09-009-006,820,203,0,203,0,1,202
09-009-007,724,338,0,338,0,2,336
09-009-008,686,210,0,210,0,2,208
09-009-009,811,386,0,386,0,0,386
09-009-010,691,268,0,267,-1,2,265
09-009-011,791,353,0,353,0,1,352
09-009-012,680,349,0,349,0,2,347
09-009-013,911,326,0,325,-1,5,320
09-009-014,611,274,0,274,0,1,273
09-009-015,754,250,0,250,0,5,245
09-009-016,762,251,0,251,0,2,249
09-010-001,156,85,0,85,0,4,81
09-011-001,719,293,0,293,0,1,292
09-011-002,719,294,0,294,0,6,288
09-011-003,574,167,0,167,0,1,166
09-011-004,876,285,0,285,0,2,283
09-011-005,722,210,0,210,0,2,208
09-012-001,647,191,0,191,0,1,190
09-012-002,675,169,0,169,0,1,168
09-012-003,721,172,0,172,0,2,170
09-013-001,759,262,0,262,0,3,259
09-014-001,1379,538,0,538,0,1,537
09-014-002,1423,560,0,560,0,1,559
09-015-001,416,139,0,139,0,1,138
09-016-001,771,253,0,253,0,2,251
09-016-002,737,195,0,195,0,0,195
09-016-003,45,20,0,20,0,0,20
09-017-001,480,140,0,140,0,0,140
09-018-011,707,156,0,156,0,0,156
09-018-012,1362,547,0,547,0,0,547
09-018-013,1304,296,0,296,0,0,296
09-018-014,1293,525,0,525,0,1,524
09-018-015,1269,382,0,382,0,2,380
09-018-016,676,332,0,332,0,1,331
09-018-021,1405,582,0,582,0,3,579
09-018-022,1386,558,0,558,0,2,556
09-018-023,1383,639,0,638,-1,1,637
09-018-024,1312,561,0,561,0,0,561
09-018-025,1263,626,0,626,0,2,624
09-018-031,1288,522,0,522,0,3,519
09-018-032,1290,649,0,647,-2,2,645
09-018-033,1096,536,0,533,-3,0,533
09-018-034,1041,521,0,521,0,2,519
09-018-035,1310,654,0,654,0,0,654
09-018-041,1347,552,0,552,0,1,551
09-018-042,1225,514,0,514,0,2,512
09-018-043,1016,425,0,425,0,2,423
09-018-044,873,315,0,315,0,2,313
09-018-045,1058,452,0,452,0,1,451
09-018-046,1024,449,0,449,0,0,449
09-018-051,1335,600,0,599,-1,3,596
09-018-052,1357,612,0,612,0,0,612
09-018-053,1394,687,0,686,-1,2,684
09-018-054,1355,589,0,588,-1,2,586
09-018-055,1286,408,0,408,0,2,406
09-018-061,853,204,0,204,0,3,201
09-018-062,1416,360,0,360,0,3,357
09-018-063,1424,630,0,630,0,2,628
09-018-064,564,130,0,130,0,1,129
09-018-065,1223,599,0,598,-1,1,597
09-018-066,932,465,0,465,0,1,464
09-018-067,850,404,0,404,0,2,402
09-018-071,894,219,0,219,0,1,218
09-018-072,1465,443,0,443,0,2,441
09-018-073,1371,525,0,524,-1,0,524
09-018-074,1445,567,0,568,1,13,555
09-018-075,1021,420,0,420,0,1,419
09-018-076,1129,495,0,495,0,3,492
09-018-081,1135,312,0,312,0,1,311
09-018-082,1444,617,0,617,0,3,614
09-018-083,1219,462,0,462,0,1,461
09-018-084,1302,640,0,640,0,0,640
09-018-085,931,447,0,447,0,4,443
09-018-086,899,345,0,345,0,2,343
09-018-091,1295,365,0,365,0,4,361
09-018-092,1472,413,0,412,-1,1,411
09-018-093,1395,505,0,505,0,2,503
09-018-094,1393,358,0,357,-1,2,355
09-018-095,1418,619,0,620,1,12,608
09-018-101,1292,613,0,612,-1,2,610
09-018-102,1449,461,0,461,0,0,461
09-018-103,1315,574,0,574,0,3,571
09-018-104,1049,412,0,412,0,0,412
09-018-105,1397,582,0,575,-7,10,565
09-018-106,1446,685,0,685,0,1,684
09-018-111,3177,1816,2,1810,-6,6,1804
09-018-112,1287,583,0,583,0,2,581
09-018-113,1239,524,0,524,0,4,520
09-018-114,1078,551,0,551,0,6,545
09-018-115,1157,602,0,602,0,8,594
09-018-116,760,300,0,300,0,0,300
09-018-117,924,361,0,361,0,1,360
09-018-121,1091,404,0,404,0,4,400
09-018-122,948,324,0,324,0,3,321
09-018-123,1208,521,0,521,0,1,520
09-018-124,1172,466,0,466,0,0,466
09-018-125,1231,464,0,464,0,2,462
09-018-126,1089,424,0,424,0,2,422
09-018-127,1147,444,0,444,0,3,441
09-018-131,1235,454,0,454,0,6,448
09-018-132,1199,410,0,410,0,2,408
09-018-133,1307,470,0,470,0,0,470
09-018-134,1194,417,0,417,0,1,416
09-018-135,1182,473,0,473,0,0,473
09-018-136,1024,307,0,307,0,3,304
09-018-141,1328,499,0,500,1,11,489
09-018-142,1424,481,0,481,0,0,481
09-018-143,1401,534,0,532,-2,3,529
09-018-144,1145,350,0,350,0,1,349
09-018-145,1451,717,0,717,0,5,712
09-018-151,834,475,0,475,0,1,474
09-018-152,1116,403,0,402,-1,4,398
09-018-153,846,435,0,435,0,1,434
09-018-154,1240,440,0,440,0,2,438
09-018-155,1245,496,0,495,-1,3,492
09-018-156,1063,400,1,399,-1,4,395
09-018-161,1178,525,0,523,-2,2,521
09-018-162,1179,476,0,476,0,0,476
09-018-163,1333,509,0,508,-1,1,507
09-018-164,1247,593,1,593,0,3,590
09-018-165,1270,577,0,577,0,3,574
09-018-171,1255,648,0,648,0,0,648
09-018-172,1396,546,0,546,0,1,545
09-018-173,1342,608,0,608,0,1,607
09-018-174,777,367,0,367,0,2,365
09-018-175,1131,588,0,588,0,3,585
09-018-176,788,308,0,308,0,4,304
09-018-181,544,230,0,230,0,2,228
09-018-182,1281,630,0,630,0,3,627
09-018-183,1205,752,0,751,-1,6,745
09-018-184,500,254,0,253,-1,1,252
09-018-185,705,357,0,356,-1,1,355
09-018-186,1126,475,0,475,0,0,475
09-018-187,939,402,0,402,0,1,401
09-018-188,743,293,0,293,0,0,293
09-018-191,928,373,0,373,0,3,370
09-018-192,1174,466,0,466,0,4,462
09-018-193,1288,575,0,574,-1,6,568
09-018-194,1264,572,0,572,0,0,572
09-018-195,818,427,0,427,0,1,426
09-018-196,1292,664,0,664,0,7,657
09-018-201,1288,521,0,521,0,5,516
09-018-202,1234,506,0,505,-1,5,500
09-018-203,1257,570,0,570,0,5,565
09-018-204,1248,498,0,498,0,2,496
09-018-205,1142,541,0,541,0,2,539
09-018-211,555,227,0,227,0,1,226
09-018-212,796,283,0,283,0,3,280
09-018-213,404,191,0,191,0,1,190
09-018-214,1260,551,0,551,0,5,546
09-018-215,847,536,0,535,-1,0,535
09-018-216,1177,673,0,673,0,2,671
09-018-217,1354,723,0,723,0,0,723
09-018-218,1281,643,0,643,0,1,642
09-018-221,1227,454,0,454,0,2,452
09-018-222,1173,480,0,480,0,1,479
09-018-223,1245,486,0,486,0,0,486
09-018-224,1117,535,0,531,-4,2,529
09-018-225,1085,546,0,546,0,0,546
09-018-231,1301,566,0,565,-1,2,563
09-018-232,1431,594,0,594,0,1,593
09-018-233,1395,591,0,591,0,1,590
09-018-234,1185,554,0,553,-1,3,550
09-018-235,1349,594,0,594,0,2,592
09-018-236,1118,490,0,490,0,0,490
09-019-001,966,273,0,273,0,2,271
09-019-002,916,217,0,217,0,0,217
09-019-003,881,337,0,337,0,0,337
09-019-004,917,333,0,333,0,3,330
09-019-005,874,342,0,342,0,0,342
09-019-006,997,355,0,355,0,1,354
09-019-007,873,362,0,362,0,2,360
09-019-008,393,77,0,77,0,0,77
09-020-001,1015,371,0,371,0,3,368
09-020-002,894,277,0,277,0,2,275
09-020-003,1037,359,0,359,0,1,358
09-020-004,855,323,0,323,0,0,323
09-021-001,649,156,0,156,0,2,154
09-021-002,617,179,0,179,0,0,179
09-021-003,722,222,0,222,0,0,222
09-021-004,678,200,0,200,0,2,198
09-021-005,744,229,0,229,0,1,228
09-021-006,462,105,0,105,0,1,104
09-021-007,147,53,0,53,0,0,53
09-022-001,1116,335,0,335,0,2,333
09-023-001,246,85,0,83,-2,0,83
09-024-001,841,292,0,292,0,3,289
09-024-002,862,317,0,317,0,2,315
09-024-003,776,269,0,269,0,2,267
09-024-004,828,310,0,310,0,1,309
09-025-001,925,357,0,357,0,2,355
09-026-001,416,148,0,148,0,1,147
09-026-002,376,136,0,136,0,2,134
09-026-003,393,118,0,118,0,1,117
09-026-004,175,74,0,74,0,0,74
09-027-001,648,218,0,218,0,1,217
09-028-001,924,291,0,291,0,2,289
09-028-002,987,310,0,310,0,1,309
09-028-003,56,23,0,23,0,0,23
09-029-001,900,326,0,326,0,3,323
09-029-002,772,261,0,261,0,5,256
09-030-001,1069,442,0,442,0,0,442
09-030-002,932,394,0,394,0,6,388
09-030-003,665,193,0,193,0,0,193
09-030-004,1112,408,0,408,0,1,407
09-030-005,1023,463,0,463,0,2,461
09-030-006,1228,339,0,339,0,1,338
09-030-007,793,162,0,162,0,1,161
09-030-008,189,94,0,94,0,2,92
09-030-009,1180,307,0,307,0,0,307
09-030-010,1163,385,0,385,0,3,382
09-030-011,796,307,0,307,0,0,307
09-030-012,1089,548,0,545,-3,3,542
09-030-013,717,230,0,230,0,0,230
09-030-014,850,362,0,362,0,0,362
09-030-015,691,329,0,329,0,1,328
09-030-016,717,295,0,295,0,2,293
09-030-017,877,405,0,405,0,0,405
09-030-018,779,321,1,320,-1,3,317
09-030-019,1214,409,0,409,0,1,408
09-030-020,670,267,0,267,0,2,265
09-030-021,1280,477,0,477,0,2,475
09-030-022,936,381,0,381,0,2,379
09-030-023,1016,258,0,258,0,8,250
09-030-024,1037,212,0,212,0,0,212
09-030-025,1148,366,0,366,0,0,366
09-030-026,772,158,0,158,0,0,158
09-030-027,694,178,0,178,0,0,178
09-031-001,859,354,0,354,0,1,353
09-031-002,1022,356,0,356,0,2,354
09-031-003,976,416,0,416,0,1,415
09-031-004,1002,330,0,330,0,2,328
09-031-005,865,269,0,269,0,2,267
09-031-006,764,263,0,263,0,1,262
09-031-007,790,168,0,168,0,1,167
09-031-008,665,223,0,223,0,1,222
09-032-001,1124,268,0,268,0,0,268
09-032-002,968,175,0,175,0,2,173
09-032-003,1260,305,0,305,0,1,304
09-032-004,1224,345,0,345,0,2,343
09-032-005,1058,299,0,299,0,2,297
09-032-006,1251,319,0,319,0,3,316
09-032-007,1306,456,0,456,0,2,454
09-032-008,1227,409,0,409,0,5,404
09-032-009,116,37,0,37,0,1,36
09-033-001,990,349,0,349,0,3,346
09-033-002,787,250,0,250,0,1,249
09-033-003,860,265,0,265,0,1,264
09-033-004,899,250,0,250,0,2,248
09-033-005,914,249,0,249,0,2,247
09-033-006,903,336,0,336,0,1,335
09-033-007,570,183,0,183,0,1,182
09-033-008,602,160,0,160,0,1,159
09-033-009,573,202,1,201,-1,4,197
09-033-010,756,247,0,247,0,1,246
09-033-011,844,273,0,273,0,2,271
09-033-012,849,291,0,291,0,3,288
09-033-013,872,253,0,253,0,2,251
09-033-014,797,288,0,288,0,7,281
09-033-015,820,275,0,275,0,1,274
09-033-016,802,215,0,215,0,1,214
09-033-017,575,194,0,194,0,2,192
09-033-018,325,123,0,123,0,0,123
09-034-001,1415,496,0,496,0,3,493
09-034-002,1458,529,0,529,0,2,527
09-034-003,1381,320,0,320,0,2,318
09-034-004,1281,446,0,446,0,2,444
09-034-005,1234,339,0,339,0,0,339
09-034-006,552,126,0,126,0,1,125
09-034-007,888,317,0,317,0,1,316
09-034-008,1371,357,0,357,0,0,357
09-034-009,1285,312,0,312,0,1,311
09-035-001,1397,784,0,784,0,10,774
09-035-002,1092,474,0,474,0,1,473
09-035-003,941,361,0,361,0,13,348
09-035-004,882,361,0,361,0,2,359
09-035-005,763,288,0,288,0,0,288
09-035-006,903,368,0,368,0,2,366
09-035-007,749,275,0,275,0,2,273
09-035-008,1163,383,0,383,0,1,382
09-035-009,771,258,0,258,0,3,255
09-035-010,940,363,0,363,0,1,362
09-035-011,856,333,0,333,0,1,332
09-035-012,712,229,0,229,0,1,228
09-035-013,973,228,0,228,0,0,228
09-035-014,882,300,0,300,0,3,297
09-035-015,1008,446,0,446,0,7,439
09-035-016,1163,476,0,476,0,2,474
09-035-017,1015,305,0,305,0,4,301
09-035-018,1240,269,0,269,0,0,269
09-035-019,1193,574,3,572,-2,1,571
09-035-020,1214,501,0,501,0,3,498
09-036-001,787,241,0,241,0,3,238
09-036-002,799,262,0,262,0,3,259
09-036-003,788,187,0,187,0,4,183
09-037-001,810,194,0,194,0,2,192
09-038-001,1032,414,0,414,0,5,409
09-038-002,179,52,0,52,0,1,51
09-039-001,1102,386,0,385,-1,0,385
09-039-002,1165,224,0,224,0,6,218
09-039-003,1054,232,0,232,0,0,232
09-039-004,1156,333,0,333,0,2,331
09-040-001,943,326,0,325,-1,2,323
09-040-002,976,414,0,414,0,0,414
09-040-003,922,270,0,270,0,2,268
09-040-004,963,341,0,341,0,2,339
09-040-005,977,372,1,371,-1,2,369
09-041-001,988,328,1,327,-1,0,327
09-042-001,493,142,0,142,0,7,135
09-043-001,653,216,0,216,0,2,214
09-043-002,597,215,0,215,0,0,215
09-043-003,598,168,1,168,0,0,168
09-043-004,608,161,0,161,0,0,161
09-043-005,602,160,0,160,0,2,158
09-043-006,627,129,0,129,0,1,128
09-043-007,473,124,0,124,0,1,123
09-043-008,84,32,0,32,0,0,32
09-044-001,734,200,1,199,-1,0,199
09-044-002,913,281,0,281,0,0,281
09-045-001,628,177,0,177,0,0,177
09-046-001,754,305,0,305,0,3,302
09-046-002,70,42,0,42,0,3,39
09-047-001,1034,332,0,332,0,2,330
09-047-002,883,229,0,229,0,0,229
09-047-003,1154,282,0,282,0,1,281
09-047-004,1027,178,0,178,0,1,177
09-047-005,779,155,0,155,0,1,154
09-047-006,856,207,0,207,0,0,207
09-048-001,719,240,0,240,0,0,240
09-049-001,536,169,0,169,0,2,167
09-050-001,503,166,0,166,0,4,162
09-051-001,840,356,0,356,0,2,354
09-051-002,1117,349,1,348,-1,3,345
09-051-003,914,355,0,355,0,2,353
09-051-004,890,349,0,349,0,3,346
09-052-001,823,243,0,243,0,0,243
09-052-002,929,270,0,270,0,4,266
09-053-001,1213,382,0,382,0,0,382
09-053-002,1119,420,0,420,0,0,420
09-054-001,1025,298,0,298,0,1,297
09-055-001,885,294,0,294,0,0,294
09-055-002,878,248,0,248,0,6,242
09-056-001,1076,333,0,333,0,2,331
09-056-002,967,307,0,307,0,4,303
09-056-003,1065,375,0,375,0,4,371
09-056-004,1009,255,0,255,0,3,252
09-056-005,995,328,0,328,0,4,324
09-056-006,953,259,0,259,0,1,258
09-056-007,930,250,0,250,0,2,248
09-057-001,454,151,0,151,0,0,151
09-057-002,822,276,0,276,0,5,271
09-057-003,602,195,0,195,0,2,193
09-057-004,934,336,0,336,0,11,325
09-057-005,92,32,0,32,0,0,32
09-057-006,176,60,0,60,0,0,60
09-058-001,777,355,0,355,0,0,355
09-058-002,762,328,0,328,0,5,323
09-058-003,712,261,0,261,0,7,254
09-058-004,612,321,0,321,0,2,319
09-058-005,862,401,0,401,0,4,397
09-058-006,1125,395,0,395,0,7,388
09-058-007,763,276,0,276,0,2,274
09-058-008,416,191,0,191,0,0,191
09-059-001,818,285,0,285,0,4,281
09-059-002,834,271,0,271,0,6,265
09-059-003,587,208,0,208,0,4,204
09-059-004,741,243,0,243,0,3,240
09-059-005,84,49,0,49,0,0,49
09-060-001,820,264,0,264,0,2,262
09-060-002,803,301,0,301,0,1,300
09-061-001,924,271,0,271,0,0,271
09-061-002,1052,342,0,342,0,0,342
09-062-001,775,270,0,270,0,1,269
09-062-002,911,296,0,296,0,2,294
09-062-003,872,363,0,362,-1,3,359
09-062-004,715,197,0,197,0,1,196
09-062-005,1066,355,0,355,0,1,354
09-062-006,1102,254,0,254,0,2,252
09-062-007,972,161,0,161,0,0,161
09-063-001,839,314,0,314,0,2,312
09-063-002,648,311,0,311,0,2,309
09-063-003,663,275,0,275,0,3,272
09-063-004,757,283,0,282,-1,2,280
09-063-005,755,268,1,267,-1,1,266
09-063-006,713,248,1,248,0,3,245
09-063-007,777,290,0,290,0,0,290
09-063-008,743,291,0,291,0,2,289
09-063-009,823,340,0,340,0,3,337
09-063-010,642,273,0,273,0,2,271
09-063-011,675,247,0,247,0,1,246
09-063-012,761,248,0,248,0,2,246
09-063-013,803,303,0,303,0,0,303
09-063-014,587,202,0,202,0,1,201
09-063-015,717,179,0,179,0,1,178
09-063-016,830,224,0,224,0,1,223
09-064-001,704,211,0,211,0,3,208
09-065-001,893,331,0,331,0,2,329
09-065-002,996,287,0,287,0,1,286
09-066-001,791,260,0,260,0,0,260
09-066-002,741,257,0,257,0,0,257
09-066-003,769,276,0,276,0,0,276
09-067-001,893,293,0,293,0,1,292
09-068-001,973,307,0,307,0,4,303
09-068-002,66,28,0,28,0,0,28
09-069-001,502,139,0,139,0,2,137
09-069-002,574,180,0,180,0,1,179
09-070-001,1179,344,0,344,0,1,343
09-070-002,1043,247,0,247,0,2,245
09-070-003,983,324,0,324,0,2,322
09-070-004,1003,329,0,329,0,1,328
09-070-005,915,265,0,265,0,1,264
09-071-001,818,269,0,269,0,0,269
09-072-001,687,182,0,182,0,3,179
09-072-002,683,177,0,177,0,0,177
09-072-003,860,223,0,223,0,0,223
09-072-004,800,183,0,183,0,1,182
09-072-005,633,167,0,167,0,1,166
09-072-006,77,29,0,29,0,0,29
09-073-001,581,191,0,191,0,0,191
09-074-001,266,55,0,55,0,2,53
09-075-001,429,201,0,201,0,1,200
09-076-001,809,312,0,312,0,3,309
09-077-001,1160,308,0,308,0,2,306
09-078-001,710,214,0,214,0,2,212
09-079-001,1103,374,0,374,0,5,369
09-079-002,910,338,0,338,0,6,332
09-079-003,841,310,0,310,0,3,307
09-079-004,701,344,0,343,-1,2,341
09-079-005,839,413,0,413,0,5,408
09-080-001,935,285,0,285,0,3,282
09-081-001,108,60,0,60,0,5,55
09-082-001,1251,376,0,375,-1,5,370
10-001-001,1041,429,0,429,0,1,428
10-001-002,1034,416,0,416,0,3,413
10-002-001,701,216,0,216,0,0,216
10-002-002,718,281,0,281,0,0,281
10-002-003,687,258,0,258,0,2,256
10-003-001,605,294,0,294,0,2,292
10-004-001,1111,528,0,528,0,2,526
10-004-002,1087,449,0,449,0,1,448
10-005-001,770,276,0,276,0,3,273
10-005-002,600,222,0,222,0,2,220
10-005-003,625,227,0,227,0,0,227
10-006-001,734,332,0,332,0,1,331
10-006-002,749,263,0,263,0,1,262
10-007-001,1039,319,0,319,0,2,317
10-008-001,502,200,0,200,0,2,198
10-008-002,352,123,0,123,0,2,121
10-009-001,293,133,0,133,0,1,132
10-010-001,540,176,0,176,0,0,176
10-011-001,689,213,0,213,0,0,213
10-011-002,640,207,0,207,0,1,206
10-011-003,786,220,0,220,0,2,218
10-012-001,775,309,0,309,0,1,308
10-012-002,859,285,0,285,0,0,285
10-012-003,664,265,0,265,0,1,264
10-013-001,1067,378,0,378,0,0,378
10-014-001,596,261,0,261,0,1,260
10-015-001,826,309,0,309,0,0,309
10-015-002,800,303,0,303,0,1,302
10-015-003,781,305,0,305,0,3,302
10-016-001,796,299,0,299,0,0,299
10-017-001,220,81,0,81,0,0,81
10-018-001,587,296,0,296,0,1,295
10-019-001,583,181,0,181,0,5,176
10-019-002,552,125,0,125,0,1,124
10-019-003,581,178,0,178,0,0,178
10-020-001,537,256,0,256,0,3,253
10-021-001,931,320,0,320,0,2,318
10-022-001,753,284,0,284,0,1,283
10-022-002,887,377,0,377,0,1,376
10-023-001,756,205,0,205,0,4,201
10-024-001,895,356,0,356,0,1,355
10-024-002,888,319,0,319,0,2,317
10-024-003,845,329,2,327,-2,3,324
10-025-001,697,379,0,379,0,1,378
10-025-002,638,327,0,327,0,1,326
10-025-003,1032,497,0,496,-1,4,492
10-025-004,1045,572,0,572,0,2,570
10-025-005,992,458,0,458,0,1,457
10-025-006,1003,536,0,536,0,3,533
10-025-007,979,508,0,508,0,0,508
10-025-008,826,482,0,482,0,3,479
10-025-009,822,397,0,397,0,3,394
10-025-010,945,511,0,511,0,0,511
10-025-011,1064,580,0,581,1,10,571
10-025-012,967,520,0,520,0,3,517
10-025-013,1003,487,0,487,0,5,482
10-025-014,962,502,0,502,0,2,500
10-025-015,1137,533,5,528,-5,2,526
10-025-016,637,359,0,359,0,1,358
10-025-017,597,287,0,287,0,1,286
10-025-018,648,345,0,345,0,1,344
10-025-019,909,419,0,419,0,2,417
10-025-020,644,261,0,261,0,3,258
10-025-021,1102,613,1,613,0,4,609
10-025-022,1085,562,0,562,0,0,562
10-025-023,1448,966,1,966,0,3,963
10-025-024,901,461,0,461,0,0,461
10-025-025,940,479,0,479,0,0,479
10-025-026,842,433,0,433,0,0,433
10-025-027,838,431,0,430,-1,1,429
10-025-028,1063,399,0,399,0,1,398
10-025-029,846,428,0,428,0,2,426
10-025-030,966,515,0,515,0,1,514
10-025-031,714,379,0,378,-1,1,377
10-025-032,817,333,0,333,0,0,333
10-025-033,802,367,0,366,-1,1,365
10-025-034,918,418,0,418,0,3,415
10-025-035,735,334,0,334,0,1,333
10-025-036,839,369,0,369,0,2,367
10-025-037,991,440,0,440,0,0,440
10-025-038,939,423,0,423,0,1,422
10-025-039,883,387,0,387,0,2,385
10-025-040,917,319,2,318,-1,2,316
10-025-041,1014,462,0,461,-1,0,461
10-025-042,1133,469,0,469,0,1,468
10-025-043,772,269,1,267,-2,1,266
10-025-044,1090,416,0,416,0,0,416
10-025-045,1215,582,0,582,0,3,579
10-025-046,818,375,0,375,0,1,374
10-025-047,793,347,0,347,0,0,347
10-026-001,1181,452,0,452,0,4,448
10-027-001,444,184,0,184,0,1,183
10-028-001,217,63,0,63,0,2,61
10-028-002,418,131,0,131,0,0,131
10-028-003,403,115,0,115,0,3,112
10-029-001,539,219,0,219,0,1,218
10-030-001,855,456,0,456,0,1,455
10-030-002,719,318,1,317,-1,0,317
10-031-001,932,422,0,422,0,1,421
10-032-001,491,258,0,258,0,2,256
10-033-001,815,230,0,230,0,3,227
10-033-002,888,244,0,244,0,1,243
10-033-003,887,241,0,241,0,2,239
10-034-001,608,191,0,191,0,3,188
10-035-001,272,160,0,160,0,1,159
10-036-001,808,331,0,331,0,1,330
10-037-001,946,466,0,466,0,2,464
10-037-002,926,316,0,316,0,3,313
10-037-003,937,514,0,514,0,4,510
10-038-001,638,274,0,274,0,4,270
10-038-002,650,215,0,214,-1,2,212
10-038-003,807,387,0,387,0,1,386
10-038-004,966,376,0,376,0,1,375
10-038-005,620,207,0,207,0,0,207
10-038-006,617,208,0,208,0,1,207
10-038-007,892,309,0,309,0,2,307
10-038-008,971,352,0,352,0,1,351
10-039-001,620,352,0,352,0,1,351
10-039-002,1045,576,0,576,0,5,571
10-039-003,668,298,0,297,-1,0,297
10-039-004,848,410,0,410,0,1,409
10-039-005,1024,346,0,346,0,7,339
10-039-006,990,520,0,520,0,2,518
10-039-007,885,525,0,525,0,2,523
10-039-008,703,386,0,386,0,1,385
10-039-009,929,499,0,499,0,2,497
10-039-010,774,412,0,411,-1,0,411
10-039-011,1029,526,0,526,0,2,524
10-039-012,707,381,0,381,0,1,380
10-039-013,799,373,0,373,0,2,371
10-039-014,708,382,0,382,0,1,381
10-039-015,706,336,0,336,0,1,335
10-039-016,843,334,0,333,-1,0,333
10-039-017,743,320,0,320,0,0,320
10-039-018,672,297,0,297,0,0,297
10-039-019,809,334,0,334,0,0,334
10-039-020,890,386,0,386,0,2,384
10-039-021,752,289,0,289,0,0,289
10-039-022,888,380,0,379,-1,2,377
10-039-023,986,382,0,382,0,3,379
10-039-024,544,281,0,281,0,0,281
10-039-025,794,326,0,326,0,3,323
10-039-026,613,258,0,258,0,2,256
10-039-027,800,336,0,336,0,0,336
10-039-028,818,363,0,363,0,0,363
10-039-029,748,324,0,324,0,1,323
10-039-030,444,134,0,134,0,0,134
10-040-001,1087,456,0,456,0,2,454
10-040-002,1031,454,0,454,0,2,452
10-041-001,1105,271,0,271,0,5,266
10-042-001,730,261,0,261,0,2,259
10-042-002,1270,532,0,532,0,0,532
10-043-001,766,311,0,311,0,0,311
10-043-002,863,411,0,411,0,0,411
10-043-003,843,396,0,396,0,0,396
10-044-001,899,397,0,397,0,2,395
10-044-002,994,391,1,390,-1,1,389
10-045-001,313,76,0,76,0,1,75
10-045-002,643,150,0,150,0,1,149
10-046-001,921,526,0,526,0,2,524
10-046-002,1156,590,0,590,0,3,587
10-046-003,1115,419,0,419,0,2,417
10-046-004,897,396,0,396,0,3,393
10-046-005,980,354,0,354,0,1,353
10-046-006,955,447,0,447,0,2,445
10-046-007,1070,455,0,455,0,1,454
10-046-008,931,429,0,429,0,2,427
10-046-009,857,382,0,382,0,0,382
10-046-010,859,388,0,388,0,2,386
10-046-011,1116,533,0,533,0,2,531
10-046-012,1254,568,0,568,0,0,568
10-046-013,709,333,0,333,0,0,333
10-046-014,1114,521,0,519,-2,1,518
10-046-015,1295,499,0,499,0,3,496
10-046-016,596,261,0,261,0,2,259
10-046-017,1057,404,0,404,0,1,403
10-047-001,805,370,0,370,0,4,366
10-047-002,756,273,0,273,0,1,272
10-048-001,1053,440,0,439,-1,4,435
10-048-002,1002,475,0,475,0,3,472
10-048-003,1122,413,0,413,0,1,412
10-048-004,220,88,0,88,0,0,88
10-048-005,1081,424,0,424,0,2,422
10-048-006,986,295,0,295,0,0,295
10-048-007,1098,378,0,378,0,0,378
10-048-008,1105,427,0,425,-2,3,422
10-048-009,697,152,0,152,0,0,152
10-049-001,485,175,0,175,0,1,174
10-050-001,559,213,0,213,0,4,209
10-051-001,741,231,0,231,0,0,231
10-051-002,734,285,0,285,0,2,283
10-051-003,780,263,0,263,0,3,260
10-051-004,759,275,0,275,0,1,274
10-052-001,564,195,0,195,0,3,192
10-052-002,538,166,0,166,0,0,166
10-052-003,152,76,0,76,0,1,75
10-053-001,302,147,0,147,0,0,147
10-054-001,835,334,0,334,0,2,332
10-054-002,797,234,0,234,0,1,233
10-054-003,757,298,0,298,0,1,297
10-055-001,757,213,0,213,0,1,212
10-055-002,806,193,0,193,0,2,191
10-055-003,696,235,0,235,0,2,233
10-055-004,422,164,0,164,0,0,164
10-056-001,660,182,0,182,0,0,182
10-056-002,502,190,0,190,0,4,186
10-057-001,879,350,0,350,0,0,350
10-057-002,789,214,0,214,0,0,214
10-058-001,113,76,0,76,0,0,76
10-059-001,848,309,0,309,0,0,309
10-059-002,595,173,0,173,0,1,172
10-059-003,770,216,0,216,0,3,213
10-060-001,854,310,0,309,-1,2,307
10-061-001,729,177,0,177,0,2,175
10-061-002,796,332,0,332,0,0,332
10-062-001,680,169,0,169,0,0,169
10-062-002,676,183,0,183,0,1,182
10-063-001,671,266,1,265,-1,2,263
10-063-002,816,247,0,247,0,0,247
10-063-003,853,298,0,298,0,4,294
10-063-004,765,269,0,269,0,0,269
10-063-005,772,288,0,288,0,5,283
10-063-006,631,277,0,277,0,1,276
10-064-001,610,305,0,305,0,4,301
10-065-001,640,258,0,258,0,0,258
10-065-002,678,282,0,282,0,0,282
10-065-003,668,219,0,219,0,0,219
10-066-001,682,295,0,295,0,2,293
10-066-002,795,382,0,382,0,3,379
10-067-001,645,342,0,342,0,6,336
10-068-001,800,329,0,329,0,0,329
10-068-002,765,350,0,350,0,0,350
10-069-001,453,247,0,247,0,0,247
10-070-001,860,285,0,285,0,0,285
10-071-001,1207,439,0,439,0,1,438
10-072-001,571,212,0,212,0,0,212
10-073-001,271,120,0,120,0,0,120
10-074-001,1256,345,0,345,0,8,337
10-075-001,482,244,0,244,0,3,241
10-076-001,1020,395,1,394,-1,3,391
10-076-002,945,404,0,404,0,2,402
10-076-003,738,292,0,292,0,0,292
10-077-001,711,341,0,341,0,0,341
10-078-001,562,227,0,227,0,1,226
10-079-001,792,337,0,337,0,4,333
10-080-001,791,363,0,363,0,1,362
10-080-002,817,416,0,416,0,0,416
10-081-001,519,224,0,224,0,2,222
10-081-002,633,290,0,290,0,4,286
10-082-001,599,271,0,271,0,1,270
10-082-002,760,323,0,323,0,0,323
10-082-003,799,385,0,385,0,3,382
10-083-001,608,291,0,291,0,2,289
10-083-002,576,200,0,200,0,2,198
10-083-003,359,224,1,223,-1,1,222
10-083-004,164,86,0,86,0,0,86
10-084-001,388,236,0,236,0,0,236
10-085-001,1082,503,0,503,0,0,503
10-085-002,1113,363,0,363,0,1,362
10-086-001,1103,284,0,284,0,4,280
10-087-001,608,234,0,234,0,1,233
10-087-002,582,229,0,229,0,3,226
10-087-003,570,241,0,241,0,0,241
10-088-001,753,285,0,285,0,3,282
10-088-002,793,275,0,275,0,3,272
10-088-003,746,211,0,211,0,1,210
10-089-001,775,295,0,295,0,3,292
10-089-002,811,254,0,254,0,0,254
10-089-003,667,292,0,292,0,2,290
10-090-001,836,319,0,319,0,1,318
10-090-002,804,368,0,368,0,0,368
10-091-001,870,330,0,327,-3,2,325
10-092-001,714,319,0,318,-1,1,317
10-092-002,602,306,0,306,0,2,304
10-092-003,187,93,0,93,0,2,91
10-093-001,175,54,0,54,0,1,53
10-093-002,282,134,0,134,0,1,133
10-094-001,387,138,0,138,0,0,138
10-095-001,828,308,0,308,0,3,305
10-095-002,830,306,0,306,0,1,305
10-096-001,685,328,0,328,0,0,328
10-096-002,691,279,0,279,0,2,277
10-097-001,193,69,0,69,0,0,69
10-097-002,100,32,0,32,0,1,31
10-098-001,764,295,0,295,0,0,295
10-098-002,515,204,0,204,0,2,202
10-099-001,434,113,0,113,0,0,113
10-100-001,601,253,0,253,0,5,248
10-100-002,653,280,0,280,0,2,278
10-101-001,694,287,0,287,0,0,287
10-101-002,693,247,0,247,0,1,246
10-102-001,1280,251,0,251,0,3,248
10-103-001,211,105,0,105,0,0,105
10-104-001,627,186,0,185,-1,6,179
10-105-001,371,113,0,113,0,3,110
10-105-002,507,158,0,158,0,1,157
10-106-001,981,320,0,318,-2,5,313
10-107-001,153,75,0,75,0,1,74
10-108-001,917,343,0,343,0,0,343
10-108-002,908,376,0,376,0,0,376
10-109-001,456,181,0,181,0,0,181
10-110-001,174,91,0,91,0,0,91
10-111-001,832,365,0,365,0,3,362
10-111-002,804,355,0,355,0,2,353
10-112-001,397,205,0,205,0,1,204
10-113-001,602,232,0,232,0,0,232
10-113-002,834,178,0,178,0,2,176
10-113-003,673,231,0,230,-1,1,229
10-113-004,855,347,0,347,0,0,347
10-114-001,499,189,0,188,-1,0,188
10-115-001,973,394,0,394,0,4,390
10-116-001,887,332,0,332,0,2,330
10-117-001,897,374,0,374,0,3,371
10-117-002,627,242,0,242,0,2,240
10-118-001,385,154,0,154,0,0,154
10-119-001,312,159,0,159,0,0,159
10-120-001,529,262,0,262,0,0,262
10-121-001,810,375,0,375,0,1,374
11-001-001,615,177,0,177,0,0,177
11-001-002,707,196,0,196,0,5,191
11-001-003,691,188,0,188,0,1,187
11-001-004,708,155,0,155,0,1,154
11-001-005,636,219,0,219,0,1,218
11-002-001,606,227,0,227,0,0,227
11-002-002,953,279,0,279,0,2,277
11-003-001,1104,521,0,521,0,3,518
11-004-001,1046,360,1,359,-1,1,358
11-004-002,823,337,0,337,0,2,335
11-004-003,861,265,0,265,0,2,263
11-005-001,989,300,0,300,0,5,295
11-005-002,1054,261,0,261,0,1,260
11-005-003,855,271,0,271,0,0,271
11-005-004,227,27,0,27,0,0,27
11-006-001,233,113,0,113,0,0,113
11-007-001,1004,478,0,478,0,2,476
11-007-002,594,191,0,191,0,2,189
11-007-003,313,84,0,84,0,0,84
11-008-001,568,191,0,191,0,0,191
11-008-002,698,245,0,245,0,3,242
11-009-001,1119,389,0,389,0,7,382
11-009-002,1119,345,0,345,0,4,341
11-009-003,1060,288,1,287,-1,6,281
11-009-004,1134,305,0,305,0,5,300
11-009-005,782,222,0,222,0,0,222
11-010-001,142,57,0,57,0,1,56
11-011-001,602,200,0,200,0,0,200
11-011-002,823,284,0,284,0,3,281
11-011-003,601,242,1,241,-1,0,241
11-012-001,700,262,0,262,0,1,261
11-012-002,685,246,0,246,0,5,241
11-012-003,725,273,0,273,0,0,273
11-012-004,708,269,0,269,0,2,267
11-013-001,915,373,0,373,0,6,367
11-013-002,959,340,0,340,0,5,335
11-013-003,942,384,0,384,0,5,379
11-013-004,998,377,0,377,0,1,376
11-013-005,877,355,0,355,0,4,351
11-013-006,1042,373,0,373,0,5,368
11-013-007,1014,352,1,351,-1,3,348
11-014-001,563,212,0,212,0,5,207
11-015-001,1041,391,0,390,-1,1,389
11-015-002,1279,454,0,454,0,1,453
11-015-003,1317,444,0,444,0,5,439
11-015-004,1197,406,0,404,-2,2,402
11-015-005,1346,360,0,360,0,3,357
11-016-001,1102,529,0,529,0,2,527
11-016-002,1023,514,0,514,0,1,513
11-016-003,1104,478,0,478,0,4,474
11-016-004,1204,490,0,490,0,2,488
11-016-005,949,447,0,445,-2,4,441
11-016-006,1020,342,0,342,0,0,342
11-016-007,1009,460,0,460,0,1,459
11-016-008,1048,463,0,461,-2,2,459
11-016-009,1022,446,0,446,0,2,444
11-016-010,1046,467,1,464,-3,2,462
11-016-011,1072,443,0,443,0,2,441
11-016-012,1129,449,0,449,0,4,445
11-016-013,1100,468,0,468,0,4,464
11-016-014,1054,421,0,421,0,2,419
11-016-015,1216,540,0,540,0,0,540
11-016-016,1009,397,0,397,0,2,395
11-016-017,960,393,0,393,0,0,393
11-016-018,967,388,1,387,-1,1,386
11-016-019,784,309,0,309,0,2,307
11-016-020,722,235,0,235,0,4,231
11-016-021,712,163,0,163,0,0,163
11-017-001,730,346,0,346,0,0,346
11-017-002,687,325,0,325,0,5,320
11-018-001,566,208,0,208,0,0,208
11-018-002,601,204,0,204,0,0,204
11-018-003,567,204,0,204,0,0,204
11-019-001,735,208,0,208,0,2,206
11-019-002,682,247,0,247,0,2,245
11-020-001,867,248,0,248,0,3,245
11-020-002,935,283,0,283,0,2,281
11-020-003,1006,281,0,281,0,1,280
11-020-004,925,237,0,237,0,1,236
11-020-005,897,319,0,319,0,3,316
11-021-001,330,177,0,177,0,0,177
11-022-001,769,310,0,310,0,2,308
11-022-002,807,253,0,253,0,4,249
11-022-003,722,273,0,272,-1,1,271
11-023-001,832,286,0,286,0,2,284
11-023-002,836,272,0,272,0,4,268
11-023-003,882,170,0,170,0,1,169
11-023-004,777,223,0,223,0,3,220
11-023-005,811,329,0,329,0,1,328
11-024-001,722,166,0,166,0,1,165
11-024-002,808,196,0,196,0,3,193
11-024-003,610,201,0,201,0,1,200
11-024-004,623,211,0,211,0,2,209
11-024-005,687,218,0,218,0,0,218
11-024-006,697,277,0,277,0,2,275
11-025-001,969,462,0,462,0,0,462
11-025-002,1060,483,0,483,0,2,481
11-026-001,610,192,0,192,0,1,191
11-026-002,576,186,0,186,0,3,183
11-027-001,954,485,0,485,0,2,483
11-027-002,765,329,0,329,0,1,328
11-027-003,1053,545,0,545,0,2,543
11-027-004,972,393,0,393,0,0,393
11-027-005,901,405,0,405,0,1,404
11-027-006,991,337,0,337,0,2,335
11-027-007,948,437,0,437,0,3,434
11-027-008,887,369,0,369,0,0,369
11-027-009,974,517,0,517,0,2,515
11-027-010,1049,443,0,443,0,3,440
11-027-011,1102,460,0,460,0,3,457
11-027-012,1042,369,0,369,0,8,361
11-027-013,1083,377,0,377,0,4,373
11-027-014,1035,333,0,333,0,4,329
11-027-015,1031,353,0,353,0,0,353
11-027-016,1033,452,0,452,0,4,448
11-028-001,843,317,0,317,0,1,316
11-028-002,774,256,0,256,0,3,253
11-028-003,747,227,0,227,0,4,223
11-028-004,759,199,0,199,0,5,194
11-028-005,400,156,0,156,0,1,155
11-029-001,719,263,0,263,0,3,260
11-029-002,604,202,0,202,0,0,202
11-029-003,667,142,0,141,-1,3,138
11-029-004,653,164,0,164,0,1,163
11-029-005,221,80,0,80,0,0,80
11-030-001,522,267,0,267,0,1,266
11-031-001,1199,535,0,535,0,1,534
11-031-002,1158,359,0,359,0,2,357
11-031-003,1208,402,0,401,-1,1,400
11-031-004,1082,373,0,373,0,3,370
11-031-005,1116,380,0,380,0,1,379
11-031-006,1009,405,0,405,0,4,401
11-031-007,1085,433,0,433,0,4,429
11-031-008,1115,396,0,395,-1,6,389
11-032-001,633,266,0,266,0,1,265
11-032-002,570,228,0,228,0,2,226
11-033-001,481,204,0,204,0,2,202
11-034-001,880,268,0,268,0,1,267
11-034-002,716,255,0,255,0,0,255
11-034-003,701,206,0,206,0,0,206
11-034-004,1073,423,0,423,0,1,422
11-034-005,973,225,0,225,0,1,224
11-034-006,908,247,0,247,0,2,245
11-034-007,1105,335,0,335,0,5,330
11-035-001,565,163,0,163,0,1,162
11-035-002,574,144,0,144,0,1,143
11-035-003,582,208,0,208,0,0,208
11-035-004,603,169,0,168,-1,0,168
11-035-005,581,141,0,141,0,0,141
11-035-006,557,128,0,128,0,1,127
11-035-007,592,147,0,147,0,7,140
11-036-001,626,230,0,230,0,4,226
11-036-002,755,220,0,220,0,3,217
11-036-003,680,236,0,236,0,1,235
11-036-004,669,235,0,235,0,3,232
11-036-005,667,249,0,249,0,1,248
11-036-006,770,313,0,313,0,2,311
11-036-007,795,283,0,283,0,2,281
11-036-008,1000,315,0,315,0,1,314
11-036-009,246,96,0,96,0,0,96
11-036-010,548,172,0,172,0,1,171
11-037-001,694,245,0,245,0,2,243
11-037-002,961,361,0,361,0,0,361
11-037-003,1006,449,0,449,0,0,449
11-037-004,899,389,1,389,0,3,386
11-037-005,814,318,0,317,-1,5,312
11-037-006,1003,427,0,427,0,2,425
11-038-001,575,271,0,271,0,1,270
11-039-001,270,78,0,78,0,1,77
11-040-001,782,280,0,280,0,4,276
11-040-002,885,335,0,335,0,0,335
11-040-003,948,413,0,413,0,2,411
11-040-004,927,387,0,387,0,0,387
11-040-005,868,336,0,336,0,2,334
11-040-006,900,261,0,261,0,2,259
11-040-007,820,303,0,303,0,2,301
11-040-008,878,398,0,398,0,2,396
11-040-009,830,300,0,300,0,1,299
11-040-010,865,296,0,296,0,1,295
11-040-011,868,350,0,350,0,0,350
11-040-012,812,303,0,302,-1,6,296
11-040-013,823,301,0,301,0,1,300
11-040-014,829,376,0,376,0,2,374
11-040-015,828,343,0,343,0,0,343
11-040-016,807,397,0,397,0,1,396
11-041-001,857,377,0,377,0,2,375
11-042-001,624,186,1,184,-2,0,184
11-042-002,687,265,0,265,0,1,264
11-043-001,543,199,0,199,0,1,198
11-044-001,624,181,0,181,0,0,181
11-044-002,617,161,0,161,0,1,160
11-044-003,694,182,0,182,0,5,177
11-044-004,636,176,0,173,-3,3,170
11-045-001,394,124,0,124,0,0,124
11-045-002,429,176,0,176,0,0,176
11-046-001,1299,453,0,453,0,2,451
11-047-001,915,349,0,349,0,0,349
11-047-002,941,339,0,339,0,6,333
11-047-003,864,351,0,351,0,3,348
11-047-004,837,387,0,387,0,1,386
11-047-005,889,284,0,284,0,1,283
11-048-001,849,254,0,254,0,2,252
11-048-002,777,268,0,268,0,1,267
11-049-001,817,302,0,302,0,2,300
11-049-002,596,207,0,207,0,2,205
11-049-003,721,248,0,248,0,1,247
11-049-004,1013,415,0,415,0,2,413
11-050-001,815,347,0,347,0,1,346
11-051-001,638,251,0,251,0,1,250
11-051-002,184,62,0,62,0,0,62
11-052-001,832,442,0,442,0,1,441
11-052-002,867,474,0,474,0,3,471
11-052-003,1061,514,0,514,0,0,514
11-052-004,852,424,0,424,0,3,421
11-052-005,858,444,0,444,0,0,444
11-052-006,952,441,0,441,0,2,439
11-052-007,842,415,0,415,0,1,414
11-052-008,728,315,0,315,0,1,314
11-052-009,762,324,0,324,0,2,322
11-052-010,728,350,1,349,-1,1,348
11-052-011,635,318,0,318,0,1,317
11-052-012,863,473,0,473,0,1,472
11-052-013,756,325,0,325,0,1,324
11-052-014,730,318,0,318,0,0,318
11-052-015,969,364,0,364,0,1,363
11-052-016,932,443,0,443,0,1,442
11-052-017,753,332,0,332,0,1,331
11-052-018,593,304,0,304,0,2,302
11-052-019,847,418,0,418,0,0,418
11-052-020,1385,806,0,806,0,3,803
11-052-021,792,329,0,329,0,2,327
11-052-022,651,256,0,256,0,0,256
11-052-023,622,326,0,326,0,2,324
11-052-024,833,384,0,384,0,2,382
11-052-025,484,256,1,256,0,1,255
11-052-026,739,350,0,350,0,3,347
11-052-027,673,312,0,312,0,0,312
11-052-028,787,355,0,355,0,2,353
11-052-029,656,285,0,285,0,1,284
11-052-030,971,338,0,338,0,3,335
11-052-031,683,319,0,319,0,0,319
11-052-032,607,193,1,192,-1,1,191
11-052-033,849,357,0,357,0,3,354
11-052-034,749,272,0,272,0,1,271
11-052-035,761,287,0,287,0,1,286
11-052-036,812,293,0,293,0,0,293
11-052-037,774,328,0,328,0,0,328
11-052-038,741,276,0,276,0,2,274
11-052-039,739,314,0,314,0,1,313
11-052-040,851,321,0,321,0,0,321
11-052-041,857,317,0,317,0,3,314
11-052-042,728,232,0,232,0,0,232
11-052-043,838,296,0,296,0,1,295
11-052-044,1150,589,0,589,0,0,589
11-052-045,768,356,0,356,0,1,355
11-052-046,789,319,0,319,0,0,319
11-052-047,827,330,0,330,0,1,329
11-052-048,747,188,0,188,0,1,187
11-052-049,710,168,0,168,0,0,168
11-052-050,844,325,0,325,0,1,324
11-052-051,1193,388,0,388,0,0,388
11-052-052,699,216,0,216,0,0,216
11-052-053,792,292,0,292,0,2,290
11-052-054,1000,420,0,420,0,3,417
11-052-055,832,380,0,380,0,1,379
11-052-056,1002,491,0,491,0,7,484
11-052-057,869,297,0,297,0,0,297
11-052-058,805,350,0,350,0,0,350
11-052-059,902,455,0,455,0,2,453
11-052-060,947,498,0,498,0,0,498
11-052-061,897,454,0,453,-1,1,452
11-052-062,888,382,0,382,0,3,379
11-052-063,763,341,0,341,0,2,339
11-052-064,900,450,1,449,-1,3,446
11-052-065,791,380,0,380,0,2,378
11-052-066,835,357,0,357,0,1,356
11-052-067,882,416,0,416,0,1,415
11-052-068,822,362,0,362,0,1,361
11-052-069,737,332,1,332,0,1,331
11-052-070,757,343,1,342,-1,0,342
11-053-001,598,260,0,260,0,1,259
11-053-002,660,344,0,344,0,4,340
11-054-001,831,314,0,314,0,4,310
11-054-002,885,344,0,344,0,3,341
11-054-003,194,51,0,51,0,1,50
11-055-001,891,355,0,355,0,2,353
11-056-001,1084,329,0,329,0,2,327
11-056-002,1096,262,0,262,0,0,262
11-056-003,1117,415,0,415,0,1,414
11-056-004,1094,367,0,367,0,0,367
11-056-005,1152,311,0,311,0,3,308
11-056-006,1074,313,0,312,-1,3,309
11-056-007,1038,354,0,354,0,3,351
11-056-008,1051,269,0,269,0,3,266
11-057-001,966,394,0,394,0,1,393
11-057-002,1190,469,0,469,0,0,469
11-057-003,1234,435,0,435,0,5,430
11-057-004,1162,331,0,331,0,2,329
11-057-005,1142,404,0,404,0,0,404
11-057-006,1206,581,0,580,-1,4,576
11-057-007,1046,417,0,414,-3,1,413
11-057-008,1113,344,0,344,0,1,343
11-057-009,141,50,0,50,0,0,50
11-058-001,835,228,0,228,0,0,228
11-059-001,608,189,0,189,0,7,182
11-060-001,310,119,0,119,0,3,116
11-061-001,841,306,0,306,0,2,304
11-061-002,412,148,0,148,0,1,147
11-062-001,953,291,0,291,0,3,288
11-062-002,152,64,0,64,0,2,62
11-063-001,1049,372,0,372,0,2,370
11-064-001,758,234,0,234,0,2,232
11-064-002,821,260,0,260,0,1,259
11-065-001,629,197,1,196,-1,5,191
11-065-002,711,217,0,217,0,1,216
11-066-001,870,282,0,282,0,4,278
11-067-001,637,223,0,223,0,0,223
11-067-002,588,166,0,166,0,3,163
11-068-001,759,248,0,248,0,3,245
11-068-002,659,211,0,211,0,3,208
11-068-003,222,62,0,62,0,0,62
11-069-001,688,196,0,196,0,2,194
11-069-002,651,172,0,172,0,1,171
11-070-001,1040,361,0,361,0,2,359
11-070-002,207,71,0,71,0,0,71
11-071-001,561,259,0,259,0,4,255
11-072-001,958,306,0,306,0,0,306
11-072-002,1077,413,1,412,-1,3,409
11-072-003,837,308,0,308,0,1,307
11-072-004,855,313,0,313,0,1,312
11-073-001,1055,399,0,399,0,3,396
11-073-002,987,449,1,448,-1,0,448
11-073-003,1123,495,0,495,0,2,493
11-073-004,1017,331,0,331,0,1,330
11-073-005,1143,374,0,373,-1,1,372
11-073-006,1153,400,0,400,0,1,399
11-073-007,774,380,0,380,0,2,378
11-073-008,718,339,0,339,0,1,338
11-073-009,670,310,0,310,0,0,310
11-073-010,818,338,0,338,0,0,338
11-073-011,990,420,0,420,0,1,419
11-073-012,690,248,0,248,0,0,248
11-073-013,548,167,0,167,0,4,163
11-073-014,781,189,0,189,0,1,188
11-073-015,1034,315,0,315,0,3,312
11-073-016,1078,365,0,365,0,2,363
11-073-017,1028,462,0,462,0,2,460
11-073-018,1094,362,0,362,0,0,362
11-074-001,711,160,0,160,0,1,159
11-074-002,769,215,0,215,0,0,215
11-074-003,653,192,0,192,0,0,192
11-074-004,687,207,0,207,0,2,205
11-074-005,665,239,0,239,0,1,238
11-074-006,681,261,0,261,0,2,259
11-074-007,695,200,0,200,0,2,198
11-074-008,738,177,0,177,0,2,175
11-074-009,732,233,0,233,0,2,231
11-074-010,747,177,0,177,0,3,174
11-075-001,913,298,0,298,0,1,297
11-075-002,844,283,0,283,0,6,277
11-075-003,721,298,0,298,0,0,298
11-075-004,772,331,0,331,0,4,327
11-075-005,815,291,0,291,0,1,290
11-075-006,856,267,0,267,0,1,266
11-076-001,513,173,0,173,0,3,170
11-077-001,597,154,0,154,0,2,152
11-077-002,608,149,0,149,0,0,149
11-077-003,594,198,0,198,0,1,197
11-077-004,575,214,0,214,0,2,212
11-077-005,436,153,0,153,0,0,153
11-078-001,712,259,0,259,0,2,257
11-078-002,508,170,0,170,0,0,170
12-001-001,205,101,0,101,0,0,101
12-002-001,588,325,0,325,0,2,323
12-002-002,598,301,0,301,0,2,299
12-002-003,603,250,1,249,-1,3,246
12-003-001,744,249,0,249,0,3,246
12-004-001,786,228,0,228,0,1,227
12-004-002,743,290,0,290,0,4,286
12-004-003,746,261,0,261,0,0,261
12-004-004,648,157,0,157,0,1,156
12-004-005,654,189,0,189,0,0,189
12-004-006,668,243,0,243,0,1,242
12-004-007,749,249,0,249,0,0,249
12-004-008,697,216,0,216,0,4,212
12-005-001,532,216,0,216,0,3,213
12-006-001,763,330,0,329,-1,1,328
12-006-002,681,324,0,324,0,3,321
12-006-003,876,413,0,413,0,4,409
12-007-001,810,348,0,348,0,2,346
12-007-002,763,314,0,314,0,2,312
12-008-001,1267,469,0,469,0,2,467
12-009-001,339,131,0,131,0,2,129
12-010-001,759,296,0,296,0,0,296
12-011-001,553,171,0,171,0,0,171
12-011-002,576,212,0,212,0,1,211
12-012-001,689,241,0,241,0,1,240
12-012-002,632,211,0,209,-2,1,208
12-013-001,791,334,0,334,0,1,333
12-013-002,627,237,0,237,0,0,237
12-013-003,734,253,0,253,0,1,252
12-013-004,751,355,0,355,0,1,354
12-014-001,635,225,0,225,0,0,225
12-015-001,874,377,0,377,0,0,377
12-015-002,866,312,0,312,0,1,311
12-016-001,197,95,0,95,0,0,95
12-017-001,664,281,0,281,0,0,281
12-017-002,861,302,0,302,0,1,301
12-018-001,349,136,0,136,0,1,135
12-019-001,292,96,0,96,0,0,96
12-020-001,997,417,0,417,0,1,416
12-020-002,772,286,0,286,0,1,285
12-020-003,870,334,0,334,0,2,332
12-021-001,823,372,0,372,0,0,372
12-022-001,750,351,0,351,0,3,348
12-023-001,1046,412,0,412,0,1,411
12-023-002,1176,488,0,488,0,1,487
12-023-003,1053,497,0,497,0,11,486
12-023-004,671,222,0,222,0,0,222
12-023-005,741,289,1,288,-1,1,287
12-023-006,605,207,0,207,0,0,207
12-023-007,745,260,0,260,0,0,260
12-023-008,1389,452,0,452,0,0,452
12-023-009,1043,362,0,362,0,0,362
12-023-010,1255,447,0,447,0,0,447
12-024-001,973,405,0,405,0,0,405
12-025-001,806,370,0,370,0,1,369
12-025-002,461,225,0,225,0,0,225
12-026-001,372,180,0,180,0,1,179
12-027-001,502,285,0,285,0,1,284
12-028-001,800,396,0,396,0,2,394
12-028-002,813,450,0,450,0,1,449
12-028-003,742,366,0,366,0,2,364
12-028-004,1226,505,0,505,0,4,501
12-028-005,985,575,0,575,0,2,573
12-028-006,948,428,0,428,0,0,428
12-028-007,948,514,0,513,-1,3,510
12-028-008,661,336,0,336,0,0,336
12-028-009,583,338,0,338,0,2,336
12-028-010,706,372,0,372,0,1,371
12-028-011,710,391,0,391,0,1,390
12-028-012,1187,520,1,519,-1,5,514
12-028-013,726,333,0,332,-1,0,332
12-028-014,875,354,0,354,0,4,350
12-028-015,927,438,0,438,0,1,437
12-028-016,637,320,0,319,-1,0,319
12-028-017,1224,464,0,464,0,3,461
12-028-018,1176,603,0,603,0,2,601
12-028-019,790,429,0,429,0,3,426
12-028-020,955,475,0,475,0,0,475
12-028-021,245,98,0,98,0,0,98
12-028-022,755,194,0,194,0,0,194
12-028-023,985,374,0,374,0,3,371
12-028-024,774,339,0,339,0,1,338
12-028-025,831,301,0,301,0,2,299
12-028-026,887,273,0,273,0,4,269
12-028-027,785,175,0,175,0,0,175
12-029-001,479,238,0,238,0,1,237
12-030-001,1176,551,0,551,0,3,548
12-031-001,841,315,0,315,0,2,313
12-032-001,885,327,0,327,0,2,325
12-032-002,777,350,0,350,0,1,349
12-033-001,548,169,0,169,0,0,169
12-034-001,686,293,0,293,0,0,293
12-034-002,765,319,0,319,0,4,315
12-034-003,736,250,0,250,0,2,248
12-035-001,872,385,0,385,0,3,382
12-035-002,873,400,0,400,0,5,395
12-035-003,774,324,0,325,1,10,315
12-035-004,776,317,0,317,0,3,314
12-035-005,818,318,3,315,-3,1,314
12-035-006,365,137,0,137,0,0,137
12-036-001,437,143,0,143,0,0,143
12-037-001,1068,457,0,457,0,2,455
12-037-002,1025,408,0,408,0,5,403
12-038-001,435,196,0,196,0,1,195
12-038-002,974,422,0,422,0,0,422
12-038-003,614,304,0,304,0,0,304
12-038-004,889,384,0,384,0,1,383
12-038-005,1009,436,0,436,0,1,435
12-038-006,880,374,0,374,0,2,372
12-038-007,967,469,0,469,0,0,469
12-038-008,1108,615,0,615,0,0,615
12-038-009,906,482,0,482,0,1,481
12-038-010,1425,681,0,681,0,5,676
12-038-011,577,216,0,216,0,1,215
12-038-012,867,433,0,433,0,2,431
12-038-013,733,316,0,316,0,6,310
12-038-014,773,292,0,292,0,2,290
12-038-015,1097,386,0,386,0,8,378
12-038-016,1194,541,0,541,0,2,539
12-038-017,820,384,0,384,0,7,377
12-039-001,857,313,0,313,0,5,308
12-040-001,950,481,1,480,-1,2,478
12-040-002,889,428,0,428,0,0,428
12-040-003,925,314,0,314,0,2,312
12-040-004,999,308,0,308,0,0,308
12-041-001,694,227,0,227,0,2,225
12-041-002,800,274,0,274,0,3,271
12-041-003,743,216,0,216,0,1,215
12-041-004,961,381,0,381,0,2,379
12-041-005,835,363,0,363,0,1,362
12-042-001,1425,591,0,591,0,4,587
12-043-001,545,182,0,182,0,3,179
12-044-001,855,358,0,358,0,3,355
12-044-002,888,361,0,361,0,2,359
12-045-001,704,288,0,288,0,2,286
12-046-001,697,300,0,300,0,4,296
12-046-002,669,275,0,275,0,3,272
12-046-003,830,328,0,328,0,2,326
12-046-004,130,33,0,33,0,1,32
12-047-001,1150,361,0,361,0,0,361
12-048-001,1073,409,0,409,0,4,405
12-048-002,842,315,0,315,0,4,311
12-049-001,578,264,0,264,0,0,264
12-049-002,520,218,0,218,0,1,217
12-050-001,787,241,0,241,0,1,240
12-050-002,1187,529,1,528,-1,1,527
12-050-003,972,476,0,476,0,2,474
12-050-004,826,416,0,416,0,0,416
12-050-005,737,299,0,299,0,0,299
12-050-006,778,283,0,283,0,3,280
12-050-007,706,289,0,289,0,3,286
12-051-001,919,355,0,355,0,2,353
12-051-002,890,385,0,385,0,2,383
12-051-003,968,363,0,363,0,3,360
12-051-004,1227,464,0,464,0,0,464
12-051-005,992,301,0,301,0,3,298
12-051-006,763,248,0,248,0,2,246
12-051-007,972,280,0,280,0,4,276
12-051-008,906,242,0,242,0,2,240
12-051-009,817,312,0,312,0,1,311
12-051-010,874,316,0,316,0,2,314
12-051-011,909,354,0,354,0,5,349
12-051-012,830,283,0,283,0,2,281
12-051-013,951,343,0,343,0,1,342
12-051-014,961,423,0,423,0,0,423
12-051-015,943,427,0,427,0,2,425
12-051-016,1048,338,0,338,0,0,338
12-052-001,1071,415,2,411,-4,1,410
12-052-002,978,474,0,474,0,6,468
12-053-001,843,383,0,383,0,2,381
12-053-002,842,355,0,355,0,1,354
12-054-001,1063,369,0,369,0,3,366
12-055-001,703,245,0,245,0,0,245
12-055-002,779,271,0,271,0,1,270
12-055-003,798,266,0,266,0,0,266
12-056-001,991,347,0,347,0,3,344
12-057-001,809,317,0,317,0,1,316
12-057-002,847,368,0,368,0,3,365
12-058-001,1195,412,0,412,0,3,409
12-059-001,967,467,0,467,0,1,466
12-059-002,978,407,0,407,0,3,404
12-060-001,895,430,0,430,0,4,426
12-061-001,830,347,0,347,0,3,344
12-061-002,921,395,0,395,0,2,393
12-062-001,1367,518,0,518,0,2,516
12-063-001,932,430,0,430,0,1,429
12-063-002,1105,496,0,496,0,4,492
12-063-003,100,28,0,28,0,0,28
12-064-001,1100,601,0,599,-2,3,596
12-064-002,823,418,0,418,0,0,418
12-064-003,772,312,0,312,0,2,310
12-064-004,846,355,0,355,0,0,355
12-064-005,762,379,0,379,0,0,379
12-064-006,778,338,0,338,0,2,336
12-064-007,772,358,0,358,0,1,357
12-064-008,641,367,0,367,0,0,367
12-064-009,680,309,0,309,0,4,305
12-064-010,634,301,0,301,0,4,297
12-064-011,564,289,0,289,0,1,288
12-064-012,1021,483,0,483,0,2,481
12-064-013,608,362,0,362,0,1,361
12-064-014,756,410,0,410,0,4,406
12-064-015,790,470,0,470,0,2,468
12-064-016,710,434,1,433,-1,2,431
12-064-017,774,398,0,398,0,2,396
12-064-018,730,316,0,316,0,1,315
12-064-019,736,348,0,348,0,1,347
12-064-020,824,477,0,477,0,1,476
12-064-021,858,465,0,465,0,1,464
12-064-022,1016,399,0,399,0,1,398
12-064-023,970,502,0,502,0,4,498
12-064-024,496,253,0,253,0,1,252
12-065-001,1017,415,0,415,0,1,414
12-065-002,1055,456,0,456,0,2,454
12-065-003,581,152,0,152,0,2,150
12-065-004,548,65,0,65,0,1,64
12-065-005,757,118,0,118,0,0,118
12-065-006,858,302,0,302,0,2,300
12-065-007,884,350,0,350,0,0,350
12-065-008,788,296,1,295,-1,2,293
12-065-009,869,320,0,320,0,1,319
12-065-010,972,465,0,465,0,10,455
12-065-011,914,490,0,490,0,1,489
12-065-012,1047,452,0,452,0,3,449
12-065-013,983,454,1,453,-1,2,451
12-065-014,868,317,0,317,0,1,316
12-065-015,755,273,0,273,0,2,271
12-065-016,668,315,0,315,0,1,314
12-065-017,1115,511,0,511,0,9,502
12-065-018,1116,579,0,579,0,4,575
12-065-019,1067,582,0,582,0,1,581
12-065-020,967,438,0,438,0,0,438
12-065-021,817,416,0,416,0,1,415
12-065-022,923,395,0,395,0,0,395
12-065-023,867,370,0,369,-1,4,365
12-065-024,860,387,0,387,0,1,386
12-065-025,616,308,0,308,0,3,305
12-065-026,710,300,0,300,0,1,299
12-065-027,855,384,0,384,0,3,381
12-065-028,1024,364,0,364,0,3,361
12-065-029,859,342,0,342,0,2,340
12-065-030,839,332,0,332,0,2,330
12-065-031,858,341,0,341,0,5,336
12-065-032,824,375,0,375,0,1,374
12-065-033,850,382,0,382,0,3,379
12-065-034,1011,361,0,361,0,1,360
12-065-035,923,365,0,365,0,0,365
12-065-036,910,355,0,355,0,0,355
12-065-037,1949,646,1,645,-1,1,644
12-065-038,958,385,0,385,0,4,381
12-065-039,1117,373,0,373,0,2,371
12-065-040,872,320,0,320,0,0,320
12-065-041,895,335,1,335,0,2,333
12-065-042,774,302,0,303,1,9,294
12-065-043,821,349,0,349,0,0,349
12-065-044,905,426,0,425,-1,2,423
12-065-045,844,349,0,348,-1,0,348
12-065-046,825,379,0,379,0,0,379
12-065-047,971,437,0,437,0,5,432
12-065-048,860,383,0,383,0,1,382
12-065-049,943,385,1,384,-1,2,382
12-065-050,767,333,0,333,0,0,333
12-065-051,730,304,0,304,0,0,304
12-065-052,770,311,0,311,0,0,311
12-065-053,1331,516,0,516,0,1,515
12-065-054,966,261,0,261,0,0,261
12-065-055,959,263,0,263,0,4,259
12-065-056,847,212,0,212,0,2,210
12-065-057,943,425,0,425,0,3,422
12-065-058,1080,516,0,516,0,0,516
12-065-059,1112,529,0,529,0,0,529
12-065-060,867,291,0,291,0,1,290
12-066-001,969,301,0,301,0,1,300
12-066-002,184,45,0,45,0,2,43
12-067-001,557,277,0,277,0,4,273
12-067-002,1103,478,0,478,0,1,477
12-067-003,753,306,0,306,0,1,305
12-067-004,761,299,0,297,-2,1,296
12-067-005,768,287,0,287,0,1,286
12-067-006,598,280,1,279,-1,1,278
12-068-001,207,65,0,65,0,0,65
12-068-002,687,268,0,268,0,3,265
12-068-003,747,306,0,306,0,2,304
12-068-004,679,248,0,248,0,1,247
12-068-005,1055,417,0,417,0,2,415
12-069-001,789,240,0,240,0,3,237
12-069-002,809,275,0,275,0,1,274
12-069-003,696,254,0,254,0,0,254
12-070-001,600,253,0,253,0,1,252
12-071-001,493,244,0,244,0,1,243
12-072-001,479,210,0,210,0,3,207
12-073-001,1103,505,1,503,-2,4,499
12-074-001,854,416,0,416,0,1,415
12-074-002,965,292,0,292,0,2,290
12-074-003,896,445,0,445,0,0,445
12-075-001,449,196,0,196,0,2,194
12-076-001,756,255,0,255,0,4,251
12-076-002,652,240,0,240,0,0,240
13-001-001,480,210,0,210,0,0,210
13-002-001,201,109,0,109,0,1,108
13-003-001,774,317,0,317,0,0,317
13-003-002,1029,479,0,479,0,2,477
13-003-003,823,344,0,344,0,0,344
13-003-004,648,276,0,276,0,2,274
13-003-005,772,370,0,370,0,2,368
13-003-006,824,364,0,364,0,1,363
13-003-007,765,332,0,332,0,2,330
13-003-008,818,277,0,277,0,1,276
13-003-009,726,354,0,354,0,1,353
13-003-010,874,327,0,327,0,1,326
13-003-011,644,297,0,297,0,3,294
13-003-012,819,377,0,377,0,0,377
13-003-013,727,353,0,353,0,1,352
13-003-014,738,347,0,347,0,0,347
13-003-015,725,367,0,367,0,1,366
13-003-016,756,331,0,331,0,3,328
13-004-001,612,338,0,338,0,2,336
13-005-001,796,296,0,296,0,2,294
13-006-001,565,192,0,192,0,0,192
13-006-002,616,206,0,206,0,0,206
13-006-003,772,287,0,287,0,1,286
13-006-004,523,168,0,168,0,0,168
13-006-005,667,214,0,214,0,1,213
13-006-006,595,227,0,227,0,0,227
13-006-007,1187,407,0,407,0,2,405
13-006-008,613,254,0,253,-1,1,252
13-006-009,520,275,0,275,0,1,274
13-006-010,689,286,0,286,0,2,284
13-006-011,675,271,0,271,0,1,270
13-006-012,633,241,0,241,0,0,241
13-006-013,559,182,0,182,0,0,182
13-006-014,573,172,0,172,0,2,170
13-006-015,768,270,0,270,0,0,270
13-007-001,445,161,0,161,0,0,161
13-008-001,623,288,0,288,0,1,287
13-008-002,764,349,0,349,0,2,347
13-009-001,531,263,0,263,0,1,262
13-010-001,300,129,0,129,0,1,128
13-011-001,92,56,0,56,0,0,56
13-012-001,763,254,0,254,0,0,254
13-013-001,850,290,0,290,0,0,290
13-013-002,810,276,0,276,0,2,274
13-014-001,885,279,0,279,0,0,279
13-015-001,293,156,0,156,0,0,156
13-016-001,661,245,0,245,0,0,245
13-017-001,96,64,0,64,0,0,64
13-018-001,259,109,2,107,-2,2,105
13-019-001,740,244,0,244,0,2,242
13-020-001,328,126,0,126,0,0,126
13-021-001,73,45,0,45,0,2,43
13-022-001,1138,414,0,414,0,5,409
13-023-001,742,283,0,283,0,2,281
13-023-002,784,310,0,310,0,0,310
13-023-003,740,353,0,353,0,4,349
13-024-001,520,245,1,244,-1,1,243
13-024-002,325,135,0,135,0,0,135
13-025-001,1131,415,0,415,0,1,414
13-026-001,896,283,0,283,0,5,278
13-027-001,374,152,0,152,0,0,152
13-028-001,532,199,0,199,0,1,198
13-029-001,882,164,0,164,0,0,164
13-030-001,440,231,0,231,0,0,231
13-031-001,428,156,0,156,0,1,155
13-032-001,718,279,0,279,0,0,279
13-032-002,123,25,0,25,0,0,25
13-032-003,243,56,0,56,0,0,56
13-033-001,710,296,0,296,0,5,291
13-033-002,835,311,0,311,0,1,310
13-033-003,632,284,0,284,0,3,281
13-033-004,714,288,0,288,0,0,288
13-034-001,480,262,0,262,0,1,261
13-035-001,107,53,0,53,0,2,51
13-036-001,515,209,0,209,0,1,208
13-037-001,43,28,0,28,0,0,28
13-038-001,468,177,0,177,0,1,176
13-039-001,826,291,0,291,0,2,289
13-040-001,298,198,0,198,0,3,195
13-041-001,422,199,0,199,0,0,199
13-042-001,149,81,0,81,0,0,81
13-043-001,632,162,0,162,0,3,159
13-044-001,132,77,0,77,0,0,77
13-045-001,356,134,0,134,0,1,133
13-046-001,654,250,0,250,0,2,248
13-047-001,836,244,0,244,0,0,244
13-047-002,750,308,0,308,0,5,303
13-048-001,680,228,0,228,0,1,227
13-048-002,578,213,0,213,0,0,213
13-049-001,700,257,0,257,0,2,255
13-050-001,681,203,0,203,0,3,200
13-050-002,579,193,0,193,0,1,192
13-050-003,176,75,0,75,0,0,75
13-051-001,682,231,0,231,0,3,228
13-051-002,721,247,0,247,0,0,247
13-051-003,681,312,0,312,0,0,312
13-052-001,936,216,0,216,0,2,214
13-053-001,574,157,1,157,0,4,153
13-053-002,614,180,0,180,0,0,180
13-053-003,244,86,0,86,0,3,83
13-054-001,1066,358,0,358,0,1,357
13-055-001,560,257,0,257,0,1,256
13-056-001,398,189,0,189,0,2,187
13-057-001,335,128,0,128,0,1,127
13-058-001,141,94,0,94,0,0,94
13-059-001,152,94,0,94,0,4,90
13-060-001,469,193,0,193,0,2,191
13-061-001,142,88,0,88,0,0,88
13-062-001,88,57,0,57,0,0,57
13-063-001,373,148,0,148,0,7,141
13-064-001,612,164,0,164,0,1,163
13-065-001,480,206,0,206,0,0,206
13-066-001,641,215,0,215,0,2,213
13-066-002,395,112,0,112,0,3,109
13-067-001,467,195,0,195,0,1,194
13-067-002,147,39,0,39,0,0,39
13-068-001,918,345,0,345,0,3,342
13-069-001,186,91,0,91,0,0,91
13-070-001,652,274,0,274,0,3,271
13-071-001,914,356,0,356,0,1,355
13-071-002,481,154,0,154,0,3,151
13-072-001,760,294,1,294,0,3,291
13-073-001,1217,411,0,411,0,1,410
13-074-001,874,301,0,301,0,2,299
13-074-002,577,196,0,196,0,0,196
13-075-001,619,184,0,184,0,4,180
13-075-002,643,133,0,133,0,3,130
13-075-003,223,90,0,90,0,0,90
13-076-001,474,208,0,208,0,0,208
13-077-001,754,251,0,251,0,2,249
13-078-001,480,200,0,200,0,0,200
13-079-001,216,97,0,97,0,1,96
13-080-001,631,197,0,197,0,0,197
13-080-002,471,149,0,149,0,0,149
13-080-003,55,39,0,39,0,0,39
13-081-001,743,258,0,258,0,2,256
13-081-002,852,333,0,333,0,7,326
13-082-001,607,254,0,254,0,0,254
13-083-001,957,365,0,365,0,8,357
13-084-001,782,415,0,415,0,1,414
13-084-002,494,252,0,252,0,0,252
13-085-001,530,210,0,210,0,0,210
13-086-001,376,143,0,143,0,0,143
13-087-001,608,174,0,174,0,3,171
13-087-002,632,144,0,144,0,1,143
13-088-001,754,314,0,314,0,1,313
13-089-001,606,261,0,261,0,0,261
13-090-001,464,178,0,178,0,2,176
13-091-001,975,434,0,434,0,1,433
13-092-001,800,331,0,330,-1,0,330
13-093-001,277,142,0,142,0,1,141
13-094-001,656,281,0,281,0,4,277
13-094-002,667,249,0,249,0,0,249
13-095-001,734,363,0,363,0,2,361
13-096-001,604,272,0,272,0,5,267
13-097-001,953,402,0,402,0,5,397
13-097-002,973,332,0,332,0,4,328
13-097-003,776,363,0,363,0,0,363
13-097-004,765,378,0,378,0,1,377
13-097-005,1012,412,0,412,0,0,412
13-097-006,938,393,0,393,0,5,388
13-097-007,1066,524,0,524,0,2,522
13-097-008,772,319,0,319,0,7,312
13-097-009,308,171,0,171,0,1,170
13-098-001,454,173,0,173,0,1,172
13-099-001,123,70,0,70,0,0,70
13-100-001,1178,500,0,500,0,3,497
13-100-002,1077,472,0,472,0,3,469
13-101-001,741,177,0,177,0,1,176
13-101-002,566,238,1,237,-1,1,236
13-102-001,940,366,0,366,0,1,365
13-102-002,891,302,0,302,0,3,299
13-103-001,860,357,0,357,0,2,355
13-103-002,729,323,0,323,0,1,322
13-103-003,862,354,0,354,0,2,352
13-103-004,740,358,0,358,0,0,358
13-103-005,810,423,0,423,0,1,422
13-103-006,776,382,0,382,0,1,381
13-103-007,750,338,1,337,-1,0,337
13-103-008,541,196,0,196,0,0,196
13-103-009,221,88,0,88,0,0,88
13-103-010,213,97,0,97,0,0,97
13-103-011,113,39,0,39,0,0,39
13-103-012,119,61,0,61,0,0,61
13-103-013,670,242,0,242,0,2,240
13-103-014,748,271,0,271,0,2,269
13-103-015,595,151,0,151,0,1,150
13-103-016,1103,367,0,366,-1,3,363
13-103-017,880,462,0,462,0,2,460
13-103-018,1117,512,0,512,0,2,510
13-103-019,511,216,0,216,0,2,214
13-103-020,594,243,0,243,0,0,243
13-103-021,919,486,0,486,0,1,485
13-103-022,771,350,0,350,0,1,349
13-103-023,589,272,0,272,0,1,271
13-103-024,621,252,0,252,0,1,251
13-103-025,825,340,0,340,0,3,337
13-103-026,1044,356,0,356,0,0,356
13-103-027,919,262,0,262,0,1,261
13-103-028,877,382,0,382,0,0,382
13-103-029,748,286,0,285,-1,0,285
13-103-030,563,248,0,248,0,1,247
13-103-031,735,371,0,371,0,0,371
13-103-032,719,177,0,177,0,2,175
13-103-033,658,224,0,224,0,5,219
13-103-034,786,231,0,230,-1,0,230
13-103-035,864,258,0,258,0,1,257
13-103-036,793,156,0,156,0,0,156
13-103-037,596,249,0,248,-1,5,243
13-103-038,1285,518,0,517,-1,3,514
13-103-039,887,299,1,297,-2,1,296
13-103-040,764,297,0,297,0,1,296
13-104-001,765,214,0,214,0,3,211
13-105-001,219,118,1,117,-1,1,116
13-106-001,642,168,0,168,0,0,168
13-107-001,355,123,0,123,0,1,122
13-108-001,367,141,0,141,0,0,141
13-108-002,147,78,0,78,0,2,76
13-109-001,334,129,0,129,0,1,128
13-110-001,365,103,0,103,0,1,102
13-111-001,1035,494,0,494,0,4,490
13-111-002,253,122,0,122,0,1,121
13-112-001,266,123,0,123,0,1,122
13-113-001,173,107,0,107,0,0,107
13-114-001,1069,483,0,483,0,2,481
13-114-002,1053,453,0,453,0,1,452
13-114-003,1084,469,0,469,0,3,466
13-114-004,1143,472,0,472,0,2,470
13-114-005,146,79,0,79,0,2,77
13-114-006,210,82,0,82,0,1,81
13-115-001,327,143,0,143,0,0,143
13-116-001,223,101,0,101,0,0,101
13-117-001,835,195,0,195,0,1,194
13-118-001,389,189,0,189,0,1,188
13-118-002,68,44,0,44,0,0,44
13-119-001,915,355,0,355,0,3,352
13-119-002,663,260,0,260,0,4,256
13-120-001,629,279,0,279,0,5,274
13-120-002,544,229,2,227,-2,1,226
13-121-001,829,239,0,239,0,0,239
13-121-002,691,251,0,251,0,0,251
13-122-001,535,242,0,242,0,1,241
13-123-001,296,168,0,168,0,0,168
13-124-001,604,254,0,254,0,0,254
13-125-001,997,350,0,350,0,2,348
13-126-001,579,232,0,232,0,1,231
13-126-002,714,325,0,325,0,2,323
13-127-001,1068,312,0,310,-2,0,310
13-128-001,331,101,0,101,0,1,100
13-129-001,496,182,0,182,0,1,181
13-130-001,491,199,0,199,0,4,195
13-131-001,993,404,0,404,0,2,402
13-131-002,821,357,0,357,0,0,357
14-001-001,734,172,0,172,0,0,172
14-001-002,768,276,0,276,0,2,274
14-001-003,736,211,0,211,0,2,209
14-001-004,728,238,0,238,0,3,235
14-001-005,721,226,0,226,0,0,226
14-001-006,695,237,0,237,0,1,236
14-001-007,714,237,0,237,0,0,237
14-001-008,725,247,0,247,0,1,246
14-001-009,722,237,0,237,0,3,234
14-001-010,746,217,0,217,0,0,217
14-001-011,743,295,0,295,0,0,295
14-001-012,702,246,0,246,0,0,246
14-001-013,735,271,0,271,0,0,271
14-001-014,708,215,0,215,0,3,212
14-001-015,694,267,0,267,0,1,266
14-001-016,701,290,0,290,0,0,290
14-002-001,1132,351,0,351,0,3,348
14-003-001,578,266,0,265,-1,4,261
14-003-002,695,367,0,367,0,4,363
14-003-003,625,216,0,216,0,0,216
14-003-004,638,204,0,204,0,1,203
14-003-005,673,251,0,251,0,0,251
14-003-006,662,219,0,219,0,2,217
14-003-007,709,251,0,251,0,6,245
14-003-008,684,231,0,230,-1,1,229
14-003-009,653,250,0,250,0,1,249
14-003-010,640,184,0,184,0,2,182
14-003-011,627,241,0,241,0,1,240
14-003-012,623,217,0,217,0,2,215
14-003-013,601,233,0,233,0,0,233
14-003-014,610,231,0,231,0,3,228
14-003-015,626,229,0,229,0,0,229
14-003-016,635,179,1,179,0,0,179
14-004-001,758,320,0,320,0,3,317
14-004-002,785,336,0,336,0,5,331
14-004-003,798,325,0,325,0,2,323
14-004-004,707,293,0,293,0,2,291
14-004-005,1020,430,0,430,0,3,427
14-005-001,944,271,0,271,0,0,271
14-006-001,820,303,0,302,-1,3,299
14-006-002,784,359,0,359,0,3,356
14-006-003,776,350,0,350,0,2,348
14-006-004,859,427,0,427,0,2,425
14-006-005,800,378,0,378,0,1,377
14-006-006,835,325,0,325,0,0,325
14-007-001,1007,384,0,384,0,0,384
14-008-001,785,384,0,384,0,1,383
14-008-002,768,323,0,323,0,0,323
14-008-003,806,344,0,344,0,2,342
14-008-004,698,325,0,325,0,1,324
14-009-001,691,318,1,317,-1,4,313
14-010-001,982,422,0,421,-1,5,416
14-011-001,1405,700,0,699,-1,3,696
14-011-002,1211,571,0,571,0,4,567
14-011-003,1263,646,0,645,-1,1,644
14-011-004,1195,727,0,726,-1,1,725
14-011-005,1302,770,0,768,-2,2,766
14-011-006,1114,581,0,581,0,2,579
14-011-007,1468,605,0,605,0,2,603
14-011-008,1258,701,0,701,0,5,696
14-012-001,786,481,0,481,0,2,479
14-012-002,760,445,0,445,0,0,445
14-013-001,1078,591,0,591,0,2,589
14-013-002,1058,507,0,507,0,5,502
14-013-003,1125,628,0,628,0,4,624
14-013-004,1228,672,0,671,-1,1,670
14-013-005,1126,587,0,587,0,2,585
14-013-006,1036,623,0,623,0,0,623
14-013-007,1041,582,0,582,0,1,581
14-013-008,1033,571,0,571,0,3,568
14-014-001,683,458,0,458,0,4,454
14-014-002,595,342,0,342,0,0,342
14-014-003,989,615,0,615,0,1,614
14-014-004,653,369,0,369,0,1,368
14-014-005,1027,526,1,524,-2,1,523
14-014-006,803,488,0,487,-1,1,486
14-014-007,643,432,0,432,0,4,428
14-014-008,701,483,0,482,-1,3,479
14-014-009,682,390,0,390,0,0,390
14-014-010,614,329,0,329,0,3,326
14-014-011,598,376,0,376,0,0,376
14-014-012,674,444,0,444,0,0,444
14-014-013,714,426,0,426,0,4,422
14-014-014,682,410,0,410,0,1,409
14-014-015,800,431,0,431,0,2,429
14-014-016,638,326,0,326,0,0,326
14-015-001,1164,694,1,691,-3,4,687
14-015-002,1135,605,0,605,0,3,602
14-015-003,1123,630,0,630,0,3,627
14-015-004,1037,600,0,599,-1,5,594
14-015-005,1152,692,0,692,0,3,689
14-015-006,1031,622,1,620,-2,1,619
14-015-007,1127,681,1,681,0,0,681
14-015-008,1107,689,1,689,0,2,687
14-015-009,1069,490,0,490,0,4,486
14-015-010,1075,548,0,547,-1,2,545
14-015-011,1067,482,0,482,0,0,482
14-015-012,1108,508,0,508,0,3,505
14-015-013,1618,987,0,986,-1,4,982
14-015-014,1114,528,0,525,-3,16,509
14-015-015,975,544,0,542,-2,0,542
14-015-016,1037,614,0,614,0,2,612
14-015-017,1263,766,0,765,-1,2,763
14-015-018,1339,793,0,791,-2,1,790
14-015-019,905,521,0,521,0,3,518
14-015-020,1098,679,0,679,0,0,679
14-016-001,719,264,0,264,0,3,261
14-016-002,742,250,0,250,0,0,250
14-016-003,664,259,0,259,0,0,259
14-016-004,737,261,0,261,0,4,257
14-016-005,883,295,0,295,0,2,293
14-016-006,211,55,0,55,0,0,55
14-016-007,210,35,0,35,0,0,35
14-017-001,759,397,0,397,0,2,395
14-017-002,977,514,0,514,0,3,511
14-017-003,1037,520,0,519,-1,2,517
14-017-004,771,339,0,339,0,2,337
14-017-005,1112,440,0,440,0,5,435
14-017-006,754,376,0,376,0,1,375
14-017-007,616,256,0,256,0,1,255
14-017-008,631,310,0,310,0,1,309
14-017-009,907,482,0,482,0,1,481
14-017-010,953,441,0,441,0,4,437
14-017-011,654,314,0,315,1,11,304
14-017-012,651,309,1,308,-1,0,308
14-017-013,1248,490,0,490,0,1,489
14-017-014,1016,366,0,366,0,2,364
14-017-015,854,458,0,458,0,3,455
14-017-016,829,409,0,409,0,1,408
14-017-017,905,327,0,327,0,0,327
14-017-018,723,160,0,160,0,4,156
14-017-019,202,34,0,34,0,0,34
14-017-020,1187,329,0,329,0,1,328
14-017-021,962,283,0,283,0,3,280
14-017-022,1073,390,0,390,0,0,390
14-017-023,1111,470,0,470,0,0,470
14-017-024,842,302,0,302,0,1,301
14-017-025,908,291,0,291,0,3,288
14-017-026,1096,241,0,241,0,1,240
14-017-027,1094,351,0,351,0,4,347
14-017-028,793,355,0,355,0,1,354
14-017-029,650,204,0,204,0,0,204
14-017-030,696,277,0,277,0,0,277
14-017-031,932,497,0,496,-1,1,495
14-017-032,1428,419,0,419,0,0,419
14-017-033,1063,369,0,369,0,1,368
14-018-001,807,306,0,306,0,2,304
14-018-002,757,296,0,296,0,3,293
14-018-003,726,259,0,259,0,0,259
14-018-004,700,302,0,302,0,1,301
14-018-005,631,251,1,250,-1,0,250
14-019-001,1244,440,0,440,0,3,437
14-019-002,854,210,0,210,0,1,209
14-019-003,1281,288,0,288,0,3,285
14-020-001,875,282,0,282,0,3,279
14-020-002,788,241,0,241,0,0,241
14-021-001,933,258,0,258,0,0,258
14-021-002,925,484,1,483,-1,4,479
14-021-003,892,461,0,461,0,0,461
14-022-001,1284,568,0,568,0,3,565
14-023-001,1229,678,0,678,0,3,675
14-023-002,980,538,0,538,0,2,536
14-023-003,1014,563,0,563,0,1,562
14-023-004,998,427,2,425,-2,5,420
14-023-005,932,412,0,412,0,3,409
14-023-006,1147,549,0,549,0,4,545
14-023-007,1173,625,0,625,0,1,624
14-024-001,527,237,0,237,0,2,235
14-025-001,854,298,0,298,0,0,298
14-025-002,852,414,0,414,0,1,413
14-025-003,929,392,0,392,0,1,391
14-025-004,825,326,0,326,0,2,324
14-025-005,818,335,0,335,0,1,334
14-025-006,843,376,0,376,0,1,375
14-025-007,938,406,0,406,0,2,404
14-025-008,866,371,0,371,0,0,371
14-025-009,788,396,0,396,0,4,392
14-025-010,824,312,0,312,0,0,312
14-025-011,844,359,0,359,0,1,358
14-025-012,876,381,0,381,0,2,379
14-025-013,853,288,0,288,0,1,287
14-025-014,792,307,0,307,0,1,306
14-025-015,1111,378,0,378,0,2,376
14-025-016,638,220,0,220,0,2,218
14-026-001,798,247,0,247,0,0,247
14-026-002,1126,355,0,355,0,2,353
14-026-003,325,105,0,105,0,1,104
14-027-001,803,339,0,339,0,0,339
14-027-002,857,408,0,408,0,0,408
14-027-003,891,365,0,365,0,0,365
14-027-004,1016,345,0,345,0,4,341
14-028-001,1210,383,0,383,0,0,383
14-028-002,1269,495,0,495,0,1,494
14-028-003,1211,420,0,420,0,0,420
14-029-001,1145,692,0,692,0,2,690
14-029-002,930,479,0,479,0,1,478
14-029-003,946,508,0,508,0,1,507
14-029-004,955,451,0,451,0,1,450
14-029-005,958,542,0,542,0,3,539
14-029-006,964,509,0,509,0,0,509
14-029-007,976,548,1,547,-1,1,546
14-029-008,937,527,0,527,0,4,523
14-030-001,572,183,0,183,0,3,180
14-030-002,765,374,0,374,0,1,373
14-030-003,373,164,0,164,0,1,163
14-031-001,905,276,0,276,0,2,274
14-031-002,987,326,0,326,0,0,326
14-031-003,1096,385,0,385,0,4,381
14-031-004,947,386,1,385,-1,0,385
14-031-005,927,273,0,273,0,2,271
14-032-001,809,452,0,452,0,5,447
14-032-002,909,448,0,448,0,0,448
14-032-003,849,413,0,413,0,0,413
14-033-001,1353,519,0,520,1,13,507
14-033-002,1017,398,0,398,0,2,396
14-033-003,988,431,0,431,0,2,429
14-033-004,949,459,0,459,0,1,458
14-033-005,970,425,0,421,-4,0,421
14-033-006,1014,507,0,506,-1,4,502
14-033-007,875,441,0,440,-1,2,438
14-033-008,1510,718,0,716,-2,3,713
14-033-009,1005,443,0,443,0,2,441
14-033-010,1051,494,0,492,-2,0,492
14-033-011,1177,541,0,541,0,3,538
14-033-012,1223,488,0,488,0,1,487
14-033-013,1129,469,1,468,-1,4,464
14-033-014,1209,481,0,481,0,3,478
14-033-015,1103,491,0,489,-2,3,486
14-033-016,975,433,0,433,0,3,430
14-034-001,1003,470,0,469,-1,2,467
14-034-002,1135,611,0,611,0,0,611
14-034-003,1060,591,0,591,0,3,588
14-034-004,1066,503,1,502,-1,1,501
14-034-005,1075,458,0,458,0,1,457
14-034-006,928,421,0,421,0,0,421
14-034-007,1110,574,0,574,0,3,571
14-034-008,1192,646,0,646,0,1,645
14-034-009,1116,585,0,585,0,1,584
14-034-010,1182,519,0,519,0,2,517
14-034-011,1338,780,0,780,0,7,773
14-034-012,1171,530,0,530,0,4,526
14-034-013,963,583,0,583,0,1,582
14-034-014,1034,563,0,563,0,4,559
14-034-015,1031,581,0,580,-1,1,579
14-034-016,1153,601,0,601,0,3,598
14-034-017,992,498,0,497,-1,2,495
14-034-018,928,477,0,477,0,3,474
14-034-019,1261,594,0,594,0,2,592
14-034-020,989,559,0,558,-1,3,555
14-034-021,1092,510,0,510,0,5,505
14-034-022,1168,535,0,535,0,3,532
14-034-023,1215,468,0,468,0,2,466
14-034-024,1042,413,0,413,0,0,413
14-034-025,1098,521,0,520,-1,1,519
14-034-026,1364,660,0,660,0,0,660
14-034-027,1203,529,0,529,0,0,529
14-034-028,1201,534,2,534,0,4,530
14-034-029,1162,533,0,530,-3,1,529
14-034-030,981,466,0,466,0,4,462
14-035-001,978,403,0,403,0,2,401
14-035-002,1088,474,0,474,0,4,470
14-035-003,1138,422,0,422,0,1,421
14-035-004,1129,360,0,360,0,3,357
14-035-005,1072,435,0,435,0,3,432
14-035-006,1064,380,0,380,0,5,375
14-036-001,967,452,0,452,0,2,450
14-036-002,658,294,0,294,0,0,294
14-036-003,834,396,0,396,0,0,396
14-036-004,705,329,0,329,0,2,327
14-037-001,1227,532,0,532,0,1,531
14-037-002,1193,478,0,478,0,3,475
14-037-003,1076,432,0,432,0,3,429
14-037-004,1103,443,0,443,0,2,441
14-037-005,1085,429,0,429,0,1,428
14-037-006,1018,339,0,339,0,0,339
14-038-001,1180,398,0,396,-2,2,394
14-038-002,1078,471,0,471,0,5,466
14-038-003,968,552,0,552,0,3,549
14-038-004,961,448,0,448,0,0,448
14-038-005,1501,830,1,831,1,11,820
14-038-006,1180,570,0,570,0,0,570
14-038-007,1210,568,0,568,0,0,568
14-038-008,1151,452,0,449,-3,1,448
14-038-009,955,312,0,312,0,1,311
14-038-010,1188,370,1,370,0,2,368
14-038-011,959,421,0,421,0,2,419
14-038-012,1242,583,0,583,0,4,579
14-038-013,979,493,0,493,0,1,492
14-038-014,963,516,0,516,0,3,513
14-038-015,1175,654,0,654,0,2,652
14-038-016,1123,586,0,586,0,2,584
14-038-017,980,453,0,453,0,3,450
14-038-018,1008,585,0,585,0,5,580
14-038-019,1135,531,0,531,0,3,528
14-038-020,1292,566,0,565,-1,0,565
14-038-021,981,375,0,375,0,2,373
14-038-022,1028,455,1,453,-2,3,450
14-038-023,1062,567,0,567,0,2,565
14-038-024,1056,595,0,595,0,2,593
14-038-025,1166,515,0,515,0,1,514
14-038-026,1136,500,0,500,0,0,500
14-038-027,1201,592,0,592,0,0,592
14-038-028,1134,498,0,498,0,1,497
14-038-029,1161,682,0,682,0,4,678
14-038-030,956,453,0,453,0,3,450
14-038-031,1041,528,0,527,-1,4,523
14-038-032,1127,578,0,578,0,4,574
14-038-033,1290,520,0,520,0,0,520
14-038-034,1079,370,0,370,0,0,370
14-038-035,1122,498,0,498,0,2,496
14-038-036,1133,519,0,519,0,1,518
14-038-037,1103,559,0,559,0,2,557
14-038-038,1177,570,0,569,-1,1,568
14-038-039,1078,480,0,480,0,2,478
14-038-040,1094,552,0,552,0,0,552
14-038-041,1018,500,0,500,0,1,499
14-038-042,1139,594,0,594,0,2,592
14-038-043,1204,587,0,586,-1,1,585
14-038-044,1016,486,0,486,0,0,486
14-038-045,1202,619,0,619,0,1,618
14-038-046,1220,653,0,653,0,2,651
14-038-047,1187,591,0,591,0,0,591
14-038-048,1265,565,0,565,0,2,563
14-039-001,1166,444,0,444,0,2,442
14-039-002,843,267,0,267,0,1,266
14-039-003,840,192,0,192,0,1,191
14-040-001,894,311,0,311,0,4,307
14-040-002,953,393,0,393,0,0,393
14-040-003,1089,407,0,407,0,0,407
14-041-001,1120,631,0,631,0,2,629
14-041-002,884,456,0,456,0,4,452
14-041-003,956,471,0,471,0,0,471
14-041-004,949,469,0,468,-1,4,464
14-041-005,1056,487,0,487,0,1,486
14-041-006,993,457,0,457,0,0,457
14-041-007,995,449,0,449,0,3,446
14-041-008,847,391,0,391,0,3,388
14-041-009,1194,450,0,450,0,3,447
14-041-010,1087,528,0,528,0,3,525
14-041-011,856,388,0,388,0,1,387
14-041-012,937,346,0,346,0,0,346
14-041-013,1161,581,0,581,0,1,580
14-041-014,995,444,0,445,1,11,434
14-041-015,868,379,0,378,-1,3,375
14-041-016,1044,483,0,483,0,1,482
14-042-001,789,355,0,355,0,3,352
14-043-001,705,374,0,374,0,4,370
14-043-002,692,296,0,296,0,1,295
14-043-003,727,217,0,217,0,1,216
14-044-001,937,361,0,361,0,5,356
14-044-002,616,230,0,230,0,0,230
14-045-001,1226,454,0,454,0,0,454
14-045-002,1111,370,0,370,0,6,364
14-045-003,111,36,0,36,0,2,34
14-046-001,776,461,0,461,0,0,461
14-046-002,830,470,1,469,-1,2,467
14-046-003,882,525,0,525,0,2,523
14-046-004,1029,520,0,520,0,5,515
14-046-005,909,462,0,462,0,2,460
14-046-006,914,540,0,540,0,2,538
14-046-007,1084,500,0,500,0,9,491
14-046-008,1194,602,0,602,0,1,601
14-046-009,280,96,0,96,0,1,95
14-046-010,758,338,0,335,-3,1,334
14-046-011,873,491,0,491,0,1,490
14-046-012,1098,707,0,707,0,1,706
14-046-013,816,435,0,435,0,1,434
14-046-014,1303,677,0,677,0,7,670
14-046-015,1206,607,0,607,0,3,604
14-046-016,1170,562,0,562,0,3,559
14-046-017,904,479,0,479,0,1,478
14-047-001,814,453,0,453,0,1,452
14-047-002,826,306,0,306,0,0,306
14-047-003,1289,566,0,566,0,3,563
14-047-004,836,470,0,470,0,2,468
14-047-005,889,419,0,419,0,3,416
14-047-006,1097,576,0,576,0,6,570
14-047-007,906,352,0,352,0,1,351
14-047-008,850,433,0,433,0,2,431
14-047-009,950,495,0,495,0,0,495
14-047-010,294,142,0,142,0,2,140
14-047-011,1089,589,1,589,0,6,583
14-047-012,1070,575,0,575,0,1,574
14-047-013,884,446,0,446,0,0,446
14-047-014,877,411,0,411,0,0,411
14-047-015,846,390,0,386,-4,2,384
14-047-016,961,500,0,500,0,2,498
14-047-017,1297,835,0,834,-1,2,832
14-047-018,744,324,0,323,-1,0,323
14-047-019,785,388,0,388,0,1,387
14-047-020,793,415,0,415,0,2,413
14-047-021,997,483,0,483,0,1,482
14-047-022,618,352,0,352,0,0,352
14-047-023,699,369,0,369,0,0,369
14-047-024,1155,701,2,698,-3,3,695
14-047-025,803,450,1,449,-1,0,449
14-047-026,813,474,0,474,0,0,474
14-047-027,888,424,0,422,-2,3,419
14-047-028,1073,579,0,579,0,0,579
14-048-001,1097,472,0,472,0,4,468
14-048-002,1127,505,0,504,-1,0,504
14-048-003,1186,438,0,438,0,2,436
14-048-004,1273,470,0,470,0,2,468
14-048-005,1167,416,0,416,0,0,416
14-048-006,1137,385,0,385,0,1,384
14-048-007,1086,390,0,390,0,0,390
14-048-008,960,339,0,339,0,1,338
14-048-009,1282,400,1,399,-1,2,397
14-048-010,1123,385,0,385,0,2,383
14-048-011,1004,436,0,436,0,1,435
14-048-012,934,328,0,328,0,1,327
14-048-013,879,307,0,307,0,0,307
14-048-014,979,354,0,354,0,1,353
14-048-015,1025,360,0,360,0,0,360
14-048-016,849,275,0,275,0,2,273
14-048-017,1226,488,0,488,0,0,488
14-048-018,972,385,0,386,1,11,375
14-049-001,1014,365,0,365,0,2,363
14-049-002,987,437,0,437,0,3,434
14-049-003,1069,564,0,564,0,1,563
14-049-004,819,312,0,312,0,0,312
14-049-005,809,385,0,385,0,0,385
14-049-006,823,314,0,314,0,0,314
14-049-007,806,342,0,342,0,1,341
14-049-008,1023,394,0,394,0,1,393
14-049-009,901,299,0,299,0,1,298
14-049-010,759,365,0,365,0,0,365
14-049-011,769,319,0,318,-1,1,317
14-049-012,874,418,0,418,0,0,418
14-049-013,782,342,0,342,0,1,341
14-049-014,825,332,0,332,0,0,332
14-049-015,845,385,0,385,0,3,382
14-049-016,1339,566,0,565,-1,1,564
14-050-001,1124,501,0,499,-2,1,498
14-050-002,993,454,0,454,0,1,453
14-050-003,1088,488,0,488,0,0,488
14-050-004,1012,424,0,424,0,3,421
14-050-005,1015,435,0,434,-1,2,432
14-050-006,1163,521,0,521,0,1,520
14-050-007,1202,543,0,543,0,3,540
14-050-008,1083,469,0,469,0,1,468
14-051-001,924,527,0,527,0,0,527
14-051-002,934,561,1,560,-1,0,560
14-052-001,974,302,0,302,0,2,300
14-052-002,1234,397,0,397,0,0,397
14-052-003,1112,380,0,380,0,6,374
14-053-001,964,465,0,465,0,5,460
14-053-002,795,360,0,360,0,0,360
14-053-003,816,424,0,424,0,5,419
14-054-001,897,408,0,408,0,1,407
14-054-002,762,295,0,295,0,1,294
14-055-001,1057,423,0,423,0,5,418
14-055-002,824,334,0,334,0,1,333
14-055-003,959,363,0,363,0,0,363
14-055-004,878,342,0,342,0,3,339
14-056-001,317,144,0,144,0,0,144
14-057-001,234,101,0,101,0,1,100
14-058-001,1367,576,0,576,0,3,573
14-058-002,1166,441,0,441,0,0,441
14-058-003,1159,389,0,388,-1,1,387
14-058-004,1373,481,0,481,0,0,481
14-058-005,1071,506,0,505,-1,3,502
14-058-006,1042,519,0,519,0,2,517
14-058-007,1035,375,1,374,-1,0,374
14-058-008,1036,388,0,388,0,0,388
14-059-001,786,198,0,198,0,0,198
14-059-002,675,215,0,215,0,2,213
14-059-003,642,239,0,239,0,3,236
14-060-001,785,296,0,296,0,3,293
14-060-002,619,254,0,254,0,0,254
14-060-003,883,337,0,337,0,0,337
14-061-001,849,320,0,320,0,4,316
14-061-002,817,286,0,286,0,1,285
14-061-003,828,332,0,332,0,1,331
14-061-004,782,285,0,285,0,0,285
14-061-005,738,298,0,298,0,1,297
14-061-006,752,253,0,253,0,3,250
14-062-001,532,219,0,219,0,2,217
14-063-001,828,420,0,420,0,2,418
14-064-001,1067,465,0,465,0,1,464
14-064-002,993,474,0,473,-1,1,472
14-064-003,1120,591,0,591,0,2,589
14-064-004,1226,449,0,449,0,2,447
14-064-005,960,411,0,410,-1,3,407
14-064-006,1035,539,0,539,0,3,536
14-064-007,955,476,0,476,0,3,473
14-064-008,1017,501,0,501,0,1,500
14-065-001,1032,344,0,344,0,2,342
14-065-002,993,380,0,380,0,0,380
14-065-003,1128,378,0,378,0,2,376
14-065-004,1099,419,0,419,0,2,417
14-065-005,1064,337,0,337,0,0,337
14-065-006,1092,374,0,374,0,1,373
14-065-007,892,307,0,307,0,0,307
14-066-001,1025,575,0,575,0,1,574
14-066-002,884,526,0,526,0,2,524
14-067-001,576,245,0,245,0,2,243
14-068-001,822,475,1,475,0,3,472
14-069-001,1358,670,0,670,0,0,670
14-069-002,1285,700,0,700,0,4,696
14-069-003,1267,580,0,580,0,4,576
14-069-004,1235,535,0,535,0,2,533
14-069-005,1348,703,0,704,1,10,694
14-069-006,1166,578,0,578,0,5,573
14-069-007,1135,565,0,565,0,10,555
14-069-008,1346,597,0,597,0,0,597
14-070-001,665,291,0,291,0,0,291
14-070-002,766,287,0,287,0,2,285
14-071-001,1175,547,0,547,0,1,546
14-071-002,845,399,0,399,0,4,395
14-072-001,622,236,0,236,0,1,235
14-072-002,726,267,0,267,0,3,264
14-072-003,1155,370,0,369,-1,2,367
14-072-004,1070,308,0,308,0,0,308
14-073-001,607,289,0,289,0,0,289
14-074-001,656,274,0,274,0,4,270
14-075-001,1060,600,0,600,0,1,599
14-075-002,1081,520,0,520,0,1,519
14-075-003,951,567,0,567,0,3,564
14-076-001,917,437,0,437,0,2,435
14-077-001,255,118,0,118,0,2,116
14-078-001,1115,525,0,525,0,2,523
14-078-002,1267,564,0,564,0,3,561
14-078-003,1357,518,0,518,0,5,513
14-078-004,1286,553,0,553,0,1,552
14-078-005,1185,446,0,446,0,0,446
14-078-006,1130,469,0,469,0,0,469
14-078-007,1182,484,0,483,-1,1,482
14-078-008,1382,680,0,680,0,0,680
14-079-001,1376,615,0,614,-1,3,611
14-080-001,1058,370,0,370,0,3,367
14-081-001,693,271,0,271,0,2,269
14-082-001,777,275,0,275,0,1,274
14-082-002,774,360,0,360,0,0,360
14-082-003,846,287,0,287,0,1,286
14-082-004,986,407,0,407,0,2,405
14-083-001,595,187,0,187,0,0,187
14-084-001,1091,563,0,563,0,3,560
14-084-002,1157,508,0,507,-1,1,506
14-084-003,1135,587,0,587,0,3,584
14-084-004,1103,480,0,478,-2,2,476
14-084-005,1030,450,0,450,0,4,446
14-085-001,821,366,0,366,0,2,364
14-085-002,896,224,0,224,0,1,223
14-085-003,925,357,0,357,0,1,356
14-085-004,985,348,2,346,-2,0,346
14-085-005,865,362,0,362,0,2,360
14-085-006,877,344,0,344,0,1,343
14-085-007,1007,367,0,366,-1,1,365
14-085-008,825,281,0,281,0,0,281
14-085-009,913,374,0,374,0,2,372
14-085-010,931,383,0,383,0,0,383
14-085-011,920,443,0,442,-1,1,441
14-085-012,890,437,0,437,0,0,437
14-085-013,985,434,0,434,0,1,433
14-085-014,861,404,1,403,-1,2,401
14-085-015,918,341,0,340,-1,2,338
14-085-016,1002,324,0,324,0,1,323
14-086-001,541,251,0,251,0,3,248
14-087-001,606,288,0,288,0,1,287
14-087-002,863,298,0,297,-1,0,297
14-087-003,712,267,0,267,0,2,265
14-087-004,1032,519,0,519,0,7,512
14-087-005,1166,420,0,420,0,4,416
14-087-006,1163,479,0,479,0,1,478
14-087-007,673,167,0,167,0,1,166
14-087-008,1152,337,0,337,0,1,336
14-087-009,693,249,0,249,0,1,248
14-087-010,632,253,0,253,0,2,251
14-087-011,670,262,0,262,0,2,260
14-087-012,615,221,0,221,0,1,220
14-088-001,707,385,0,385,0,0,385
14-088-002,953,565,0,565,0,4,561
14-088-003,815,459,0,459,0,1,458
14-088-004,863,518,0,518,0,3,515
14-088-005,839,549,0,549,0,2,547
14-088-006,857,527,0,527,0,2,525
14-088-007,887,478,0,478,0,0,478
14-089-001,1219,418,0,418,0,2,416
14-089-002,1117,502,0,502,0,2,500
14-089-003,1102,438,0,438,0,4,434
14-089-004,1084,434,0,433,-1,3,430
14-089-005,1102,393,0,393,0,3,390
14-089-006,1091,437,0,437,0,1,436
14-089-007,877,294,0,294,0,5,289
14-089-008,775,285,0,285,0,1,284
14-089-009,783,308,0,308,0,0,308
14-089-010,791,338,0,337,-1,1,336
14-089-011,734,266,0,266,0,0,266
14-089-012,759,343,0,343,0,0,343
14-089-013,1087,319,0,319,0,2,317
14-089-014,1061,331,0,331,0,3,328
14-089-015,744,345,0,345,0,2,343
14-089-016,814,218,0,218,0,0,218
14-089-017,1008,339,0,339,0,1,338
14-089-018,888,274,0,274,0,5,269
14-089-019,920,396,0,396,0,0,396
14-089-020,976,268,0,268,0,1,267
14-090-001,975,435,0,435,0,4,431
14-090-002,1037,490,0,490,0,0,490
14-090-003,948,603,0,603,0,0,603
14-090-004,1082,567,1,567,0,5,562
14-091-001,843,376,0,376,0,1,375
14-091-002,855,395,0,394,-1,4,390
14-091-003,947,472,0,472,0,1,471
14-091-004,1052,527,1,525,-2,8,517
14-092-001,1065,297,0,297,0,1,296
14-092-002,1057,378,0,378,0,4,374
14-092-003,969,310,0,310,0,4,306
14-093-001,808,184,1,184,0,1,183
14-093-002,740,206,0,206,0,1,205
14-094-001,817,275,0,275,0,1,274
14-094-002,937,370,0,370,0,2,368
14-094-003,823,342,0,342,0,2,340
14-094-004,1017,357,0,357,0,2,355
14-094-005,736,283,0,283,0,1,282
14-094-006,987,400,0,399,-1,0,399
14-094-007,714,299,0,299,0,2,297
14-094-008,153,59,0,59,0,1,58
14-094-009,445,115,1,114,-1,2,112
14-094-010,983,360,0,360,0,1,359
14-095-001,713,260,0,260,0,0,260
14-095-002,1067,181,0,181,0,3,178
14-095-003,942,313,0,313,0,0,313
14-095-004,1018,328,0,328,0,2,326
14-096-001,824,359,0,359,0,1,358
14-096-002,950,419,0,419,0,0,419
14-096-003,799,369,0,369,0,4,365
14-096-004,825,380,0,380,0,1,379
14-096-005,789,355,0,355,0,1,354
14-096-006,787,354,0,354,0,3,351
14-096-007,944,400,0,400,0,2,398
14-097-001,707,221,0,221,0,1,220
14-097-002,799,182,0,182,0,2,180
14-098-001,978,452,0,452,0,1,451
14-098-002,1140,621,0,621,0,8,613
14-098-003,1297,658,1,659,1,16,643
14-098-004,1285,512,0,511,-1,1,510
14-098-005,1288,702,0,702,0,3,699
14-099-001,1223,520,0,520,0,1,519
14-100-001,870,414,0,414,0,2,412
14-100-002,784,358,0,358,0,0,358
14-101-001,295,168,0,168,0,2,166
14-102-001,835,393,0,392,-1,1,391
14-102-002,797,391,0,391,0,0,391
14-102-003,763,314,0,314,0,0,314
14-102-004,823,413,0,412,-1,1,411
14-102-005,842,265,0,265,0,2,263
14-102-006,682,293,0,293,0,4,289
14-102-007,877,371,1,369,-2,0,369
14-102-008,844,487,0,487,0,4,483
14-102-009,802,382,0,382,0,0,382
14-102-010,812,384,0,384,0,5,379
14-102-011,769,300,0,300,0,0,300
14-102-012,861,372,0,371,-1,2,369
14-102-013,775,325,0,324,-1,1,323
14-102-014,731,307,0,307,0,3,304
14-102-015,717,320,0,320,0,4,316
14-102-016,809,286,0,286,0,0,286
14-103-001,1075,406,0,406,0,1,405
14-103-002,847,332,1,331,-1,1,330
14-104-001,1178,294,0,294,0,0,294
14-104-002,1183,433,0,433,0,3,430
14-104-003,1058,428,0,428,0,2,426
14-104-004,1181,500,0,499,-1,1,498
14-104-005,1144,393,0,393,0,1,392
14-104-006,1170,298,0,298,0,1,297
14-104-007,1156,323,0,323,0,7,316
14-104-008,680,199,0,199,0,1,198
14-104-009,662,192,0,192,0,1,191
14-105-001,1141,657,0,657,0,2,655
14-105-002,1376,789,0,789,0,1,788
14-105-003,490,215,0,215,0,0,215
14-106-001,1169,597,0,597,0,2,595
14-106-002,1116,362,0,362,0,0,362
14-106-003,974,569,0,568,-1,1,567
14-106-004,783,510,0,510,0,5,505
14-106-005,1223,688,0,689,1,10,679
14-106-006,922,584,0,584,0,1,583
14-107-001,1318,625,0,625,0,2,623
14-108-001,939,457,0,457,0,0,457
14-108-002,1193,536,0,536,0,1,535
14-109-001,1189,645,0,645,0,3,642
14-109-002,1245,688,0,688,0,4,684
14-109-003,1067,550,0,550,0,5,545
14-110-001,938,490,0,490,0,2,488
14-110-002,817,408,0,408,0,1,407
14-111-001,933,410,0,410,0,3,407
14-112-001,1645,809,0,809,0,0,809
14-112-002,1477,556,0,556,0,4,552
14-112-003,1469,691,0,691,0,6,685
14-112-004,1375,682,0,682,0,4,678
14-112-005,1342,577,0,577,0,1,576
14-112-006,1452,701,0,701,0,4,697
14-112-007,1404,735,1,733,-2,1,732
14-112-008,1468,607,0,607,0,1,606
14-113-001,870,419,0,419,0,0,419
14-113-002,828,440,0,440,0,3,437
14-113-003,890,361,0,361,0,1,360
14-113-004,768,212,0,212,0,2,210
14-113-005,906,478,0,478,0,1,477
14-113-006,912,506,0,506,0,1,505
14-113-007,859,370,0,370,0,1,369
14-113-008,1229,718,0,717,-1,3,714
14-113-009,955,515,0,515,0,0,515
14-113-010,791,422,0,422,0,1,421
14-113-011,804,469,0,469,0,0,469
14-113-012,877,477,0,477,0,4,473
14-113-013,826,424,0,424,0,0,424
14-113-014,838,455,0,455,0,1,454
14-113-015,878,476,0,476,0,5,471
14-113-016,832,433,0,433,0,4,429
14-114-001,1087,496,0,496,0,1,495
14-114-002,970,501,0,501,0,5,496
14-115-001,1093,351,0,351,0,1,350
14-116-001,949,377,0,377,0,1,376
14-117-001,1113,529,0,529,0,0,529
14-118-001,569,280,0,280,0,0,280
14-119-001,1090,593,0,592,-1,5,587
14-119-002,1075,384,0,384,0,1,383
14-119-003,986,404,0,404,0,2,402
14-119-004,1058,453,0,453,0,0,453
14-119-005,1013,288,0,288,0,2,286
14-119-006,1034,225,0,225,0,0,225
14-119-007,1076,489,0,489,0,1,488
14-119-008,1139,478,0,478,0,1,477
14-120-001,1468,702,0,701,-1,2,699
14-121-001,940,512,0,512,0,2,510
14-121-002,1093,663,0,663,0,2,661
14-121-003,1014,630,0,630,0,2,628
14-121-004,1076,693,2,690,-3,2,688
14-121-005,1299,732,0,732,0,2,730
14-121-006,1132,713,0,712,-1,5,707
14-121-007,1070,641,0,642,1,12,630
14-121-008,959,497,0,497,0,3,494
14-122-001,1100,450,0,450,0,1,449
14-122-002,797,386,0,386,0,1,385
14-122-003,857,373,0,373,0,1,372
14-123-001,855,322,0,322,0,4,318
14-123-002,990,387,0,387,0,0,387
14-123-003,907,386,0,386,0,1,385
14-123-004,1142,493,0,493,0,3,490
14-123-005,846,372,0,372,0,4,368
14-123-006,943,396,0,396,0,4,392
14-123-007,1051,354,0,354,0,1,353
14-124-001,1450,746,0,746,0,2,744
14-124-002,1369,644,0,645,1,11,634
14-124-003,1282,594,0,594,0,5,589
14-125-001,796,344,0,344,0,1,343
14-125-002,847,325,0,325,0,5,320
14-125-003,788,307,0,307,0,0,307
14-125-004,871,338,0,338,0,1,337
14-125-005,901,357,0,357,0,3,354
14-125-006,801,340,0,340,0,1,339
14-125-007,906,417,0,417,0,1,416
14-125-008,1100,545,0,545,0,1,544
14-125-009,1011,422,0,422,0,0,422
14-125-010,967,512,1,512,0,1,511
14-125-011,993,534,0,533,-1,1,532
14-125-012,1069,575,0,575,0,5,570
14-125-013,833,424,0,423,-1,1,422
14-125-014,865,504,0,503,-1,3,500
14-125-015,1113,527,0,527,0,1,526
14-125-016,1101,562,0,562,0,0,562
14-126-001,1029,635,0,635,0,2,633
14-126-002,1455,868,0,868,0,3,865
14-126-003,1020,463,1,462,-1,2,460
14-126-004,999,509,0,509,0,0,509
14-126-005,990,534,0,534,0,0,534
14-126-006,1018,620,0,620,0,3,617
14-126-007,1016,450,0,450,0,4,446
14-126-008,1053,580,0,580,0,0,580
14-126-009,1053,496,0,496,0,2,494
14-126-010,1075,576,0,576,0,4,572
14-126-011,1005,638,0,638,0,3,635
14-126-012,980,570,0,570,0,0,570
14-126-013,1035,601,0,601,0,0,601
14-126-014,1001,552,0,552,0,0,552
14-126-015,1057,555,0,555,0,0,555
14-126-016,1042,521,0,521,0,1,520
14-126-017,1104,601,0,599,-2,1,598
14-126-018,1229,633,0,633,0,2,631
14-126-019,1251,640,0,640,0,1,639
14-126-020,1164,555,0,555,0,1,554
14-127-001,807,239,0,239,0,1,238
14-127-002,745,213,0,213,0,2,211
14-128-001,974,287,0,287,0,0,287
14-128-002,941,341,0,341,0,3,338
14-128-003,1131,286,0,286,0,1,285
14-128-004,980,340,0,340,0,1,339
14-129-001,1129,502,0,502,0,4,498
14-130-001,1095,439,0,439,0,0,439
14-130-002,979,416,0,416,0,2,414
14-131-001,765,284,0,284,0,3,281
14-131-002,852,267,0,267,0,1,266
14-131-003,900,358,0,358,0,0,358
14-131-004,957,419,0,419,0,0,419
14-131-005,832,295,0,295,0,0,295
14-131-006,1001,340,0,340,0,2,338
14-131-007,767,193,0,193,0,0,193
14-131-008,778,250,0,250,0,1,249
14-131-009,906,297,0,297,0,1,296
14-131-010,916,383,0,383,0,0,383
14-131-011,801,291,0,291,0,1,290
14-131-012,856,319,0,319,0,1,318
14-131-013,897,277,0,277,0,1,276
14-131-014,1054,361,0,361,0,3,358
14-131-015,951,274,0,274,0,0,274
14-131-016,998,369,0,369,0,1,368
14-132-001,1116,577,0,577,0,1,576
14-132-002,1133,477,1,476,-1,4,472
14-133-001,935,393,0,393,0,0,393
14-133-002,1004,469,0,469,0,3,466
14-134-001,998,403,0,403,0,0,403
14-134-002,1094,469,0,469,0,0,469
14-134-003,1005,321,0,321,0,4,317
14-134-004,807,282,0,282,0,0,282
14-134-005,1013,480,0,480,0,0,480
14-134-006,936,428,0,428,0,0,428
14-134-007,1010,356,0,356,0,1,355
14-134-008,1016,506,0,506,0,3,503
14-134-009,1402,492,0,491,-1,2,489
14-134-010,989,320,0,320,0,2,318
14-134-011,883,310,0,310,0,2,308
14-134-012,657,243,0,242,-1,2,240
14-134-013,969,425,0,425,0,2,423
14-134-014,836,421,0,421,0,2,419
14-134-015,982,399,0,399,0,3,396
14-134-016,995,512,0,512,0,3,509
14-134-017,769,353,0,353,0,1,352
14-134-018,740,355,0,355,0,2,353
14-134-019,918,424,0,424,0,1,423
14-134-020,1124,543,0,543,0,2,541
14-134-021,985,442,0,442,0,1,441
14-134-022,941,367,0,367,0,0,367
14-134-023,869,350,1,349,-1,13,336
14-134-024,1231,627,0,627,0,3,624
14-134-025,1097,462,0,462,0,0,462
14-134-026,1227,367,0,367,0,1,366
14-134-027,1258,416,0,416,0,6,410
14-134-028,1072,512,0,512,0,1,511
14-134-029,1106,412,0,411,-1,4,407
14-134-030,1010,403,0,402,-1,3,399
14-135-001,1046,453,0,453,0,3,450
14-135-002,765,351,0,351,0,0,351
14-136-001,670,275,0,275,0,2,273
14-136-002,667,273,0,273,0,0,273
14-136-003,860,411,0,411,0,2,409
14-137-001,701,296,0,296,0,3,293
14-137-002,846,347,0,347,0,1,346
14-138-001,1250,587,0,576,-11,3,573
14-138-002,1160,482,0,482,0,4,478
14-139-001,1047,579,0,579,0,3,576
14-139-002,1087,542,0,541,-1,2,539
14-139-003,812,388,0,388,0,2,386
14-139-004,757,431,0,431,0,1,430
14-140-001,1065,500,0,500,0,2,498
14-140-002,1163,522,0,522,0,1,521
14-140-003,1342,725,0,722,-3,0,722
14-140-004,1307,627,0,627,0,1,626
14-141-001,769,363,0,363,0,1,362
14-141-002,1005,415,0,415,0,3,412
14-141-003,794,372,0,372,0,0,372
14-141-004,837,315,0,315,0,2,313
14-141-005,905,391,0,391,0,4,387
14-141-006,809,375,0,375,0,0,375
14-142-001,789,256,0,256,0,5,251
14-142-002,657,191,0,191,0,10,181
14-143-001,978,327,0,327,0,0,327
14-143-002,897,256,0,256,0,0,256
14-143-003,876,244,0,244,0,0,244
14-144-001,874,329,0,329,0,3,326
14-144-002,924,346,0,346,0,2,344
14-144-003,989,250,0,250,0,2,248
14-145-001,601,177,0,177,0,2,175
14-145-002,834,266,0,266,0,3,263
14-145-003,617,214,0,214,0,2,212
14-145-004,653,180,0,180,0,0,180
14-146-001,544,154,0,154,0,0,154
14-146-002,883,327,0,327,0,0,327
14-146-003,830,289,0,289,0,3,286
14-147-001,792,269,0,268,-1,0,268
14-147-002,567,131,0,131,0,0,131
14-147-003,721,234,0,234,0,2,232
14-147-004,714,326,0,326,0,2,324
14-147-005,835,395,0,395,0,3,392
14-147-006,795,302,0,302,0,1,301
14-147-007,632,206,0,206,0,1,205
14-148-001,868,260,0,260,0,1,259
14-148-002,826,209,0,209,0,2,207
14-148-003,694,210,0,210,0,2,208
14-148-004,850,194,0,194,0,2,192
14-148-005,862,232,0,232,0,3,229
14-148-006,747,272,0,272,0,2,270
14-149-001,991,450,0,450,0,0,450
14-149-002,932,458,0,458,0,5,453
14-149-003,970,455,0,455,0,0,455
14-149-004,1200,325,0,325,0,3,322
14-149-005,429,140,2,138,-2,4,134
14-150-001,615,155,1,154,-1,0,154
14-150-002,579,192,0,192,0,4,188
14-150-003,634,211,0,211,0,0,211
14-150-004,620,211,0,211,0,0,211
14-151-001,1215,456,0,456,0,1,455
14-151-002,949,445,0,447,2,18,429
14-151-003,1259,628,0,628,0,1,627
14-151-004,1207,462,0,462,0,0,462
14-151-005,1106,477,0,477,0,5,472
14-151-006,1069,518,0,518,0,1,517
14-151-007,1087,511,0,510,-1,1,509
14-152-001,856,581,0,581,0,1,580
14-152-002,763,458,0,458,0,3,455
14-152-003,627,385,0,385,0,2,383
14-152-004,709,470,0,469,-1,2,467
14-153-001,79,49,0,49,0,0,49
14-154-001,1379,603,0,603,0,2,601
14-155-001,976,305,0,305,0,1,304
14-155-002,969,358,0,358,0,1,357
14-155-003,996,306,0,306,0,2,304
14-156-001,1082,529,0,529,0,0,529
14-157-001,820,267,0,267,0,1,266
14-157-002,830,281,0,281,0,1,280
14-157-003,1113,450,0,450,0,4,446
14-157-004,1227,506,0,505,-1,2,503
14-157-005,1076,393,0,393,0,0,393
14-157-006,1131,493,0,493,0,1,492
14-157-007,1163,452,0,452,0,0,452
14-157-008,975,350,0,350,0,1,349
14-158-001,650,323,0,323,0,1,322
14-158-002,576,277,0,277,0,0,277
14-158-003,816,427,0,427,0,2,425
14-158-004,655,310,0,310,0,1,309
14-158-005,672,370,0,370,0,0,370
14-158-006,677,398,0,398,0,1,397
14-158-007,587,259,0,259,0,0,259
14-158-008,621,353,0,352,-1,1,351
14-158-009,720,438,0,437,-1,1,436
14-158-010,841,505,0,505,0,1,504
14-158-011,757,259,0,259,0,0,259
14-158-012,752,298,0,298,0,2,296
14-158-013,604,345,1,344,-1,2,342
14-158-014,588,268,0,268,0,0,268
14-158-015,677,313,0,313,0,2,311
14-158-016,669,381,0,381,0,1,380
14-159-001,880,249,0,249,0,9,240
14-159-002,840,313,0,313,0,0,313
14-159-003,844,245,0,245,0,3,242
14-159-004,741,238,0,238,0,0,238
14-160-001,743,375,0,375,0,0,375
14-160-002,1019,139,0,139,0,1,138
14-160-003,952,363,0,363,0,1,362
14-160-004,659,209,0,209,0,3,206
14-160-005,720,294,0,294,0,2,292
14-160-006,701,312,0,312,0,1,311
14-160-007,617,288,0,288,0,0,288
14-160-008,758,296,0,296,0,1,295
14-161-001,692,333,0,333,0,0,333
14-161-002,760,361,0,361,0,0,361
14-161-003,799,369,0,369,0,0,369
14-162-001,717,267,0,267,0,1,266
14-162-002,719,306,0,306,0,4,302
14-163-001,680,226,0,226,0,2,224
14-163-002,735,282,0,282,0,1,281
14-163-003,737,182,0,182,0,1,181
14-164-001,1046,428,0,428,0,1,427
14-164-002,1056,428,0,428,0,3,425
14-165-001,1181,481,0,480,-1,1,479
14-165-002,1304,527,0,527,0,2,525
14-165-003,1062,340,0,340,0,2,338
14-165-004,1028,286,0,286,0,0,286
14-165-005,1033,344,0,344,0,0,344
14-165-006,1215,514,0,514,0,0,514
14-165-007,1140,475,0,474,-1,0,474
14-165-008,1498,567,0,567,0,2,565
14-166-001,1049,612,0,612,0,5,607
14-166-002,1224,631,0,631,0,3,628
14-166-003,1048,577,0,577,0,1,576
14-166-004,1377,754,0,751,-3,3,748
14-166-005,1161,655,0,655,0,0,655
14-167-001,1060,330,0,330,0,6,324
14-167-002,871,256,0,256,0,0,256
14-168-001,780,329,0,329,0,2,327
14-168-002,774,266,0,266,0,2,264
14-169-001,892,327,0,327,0,0,327
14-169-002,1194,578,0,578,0,0,578
14-169-003,692,357,0,357,0,1,356
14-169-004,1028,482,0,482,0,1,481
14-169-005,945,488,0,488,0,2,486
14-169-006,891,471,0,471,0,2,469
14-169-007,767,398,0,398,0,5,393
14-169-008,816,464,0,464,0,1,463
14-169-009,840,440,0,440,0,1,439
14-169-010,894,479,0,479,0,2,477
14-169-011,1316,761,0,761,0,6,755
14-169-012,663,377,0,377,0,2,375
14-169-013,682,299,0,299,0,0,299
14-169-014,813,373,0,373,0,0,373
14-169-015,1018,480,0,480,0,9,471
14-169-016,659,280,0,280,0,1,279
14-169-017,778,332,0,332,0,2,330
14-169-018,977,311,0,311,0,2,309
14-169-019,593,354,0,354,0,1,353
14-169-020,951,547,0,547,0,0,547
14-169-021,1015,536,0,536,0,5,531
14-169-022,645,341,0,341,0,0,341
14-169-023,970,524,0,524,0,2,522
14-169-024,1163,558,0,558,0,1,557
14-169-025,1095,544,0,544,0,3,541
14-169-026,655,318,0,318,0,3,315
14-169-027,840,335,0,335,0,0,335
14-169-028,882,485,0,485,0,1,484
14-169-029,1155,480,0,480,0,3,477
14-169-030,1249,697,0,697,0,2,695
14-170-001,1213,555,0,554,-1,1,553
14-171-001,715,258,0,258,0,1,257
14-172-001,736,331,0,331,0,1,330
14-172-002,761,333,0,333,0,0,333
14-173-001,392,185,0,185,0,1,184
14-174-001,690,332,0,332,0,4,328
14-174-002,805,386,0,386,0,0,386
14-175-001,882,314,0,314,0,2,312
14-175-002,844,319,0,319,0,1,318
14-176-001,614,256,0,256,0,1,255
14-176-002,588,237,0,237,0,5,232
14-177-001,574,275,0,275,0,0,275
14-177-002,585,267,0,267,0,1,266
14-177-003,620,305,0,305,0,0,305
14-177-004,603,279,0,279,0,0,279
14-177-005,813,473,0,473,0,2,471
14-177-006,675,318,0,318,0,2,316
14-177-007,670,247,0,247,0,2,245
14-177-008,598,224,0,224,0,0,224
14-177-009,607,231,0,231,0,2,229
14-177-010,627,232,0,232,0,2,230
14-177-011,625,268,0,268,0,1,267
14-177-012,725,302,0,302,0,2,300
14-177-013,738,286,0,286,0,0,286
14-177-014,762,301,0,301,0,0,301
14-177-015,797,369,0,369,0,4,365
14-177-016,614,282,0,282,0,1,281
14-177-017,662,269,0,269,0,1,268
14-177-018,624,281,0,281,0,4,277
14-177-019,734,295,0,295,0,0,295
14-177-020,712,310,0,309,-1,1,308
14-177-021,798,268,0,268,0,0,268
14-177-022,874,319,0,319,0,1,318
14-177-023,792,309,0,309,0,1,308
14-177-024,818,318,0,318,0,0,318
14-178-001,965,446,0,446,0,0,446
14-178-002,841,411,0,411,0,1,410
14-178-003,1182,567,0,567,0,5,562
14-178-004,973,399,0,399,0,0,399
14-178-005,789,342,0,342,0,1,341
14-178-006,816,381,0,381,0,2,379
14-178-007,884,505,0,505,0,0,505
14-178-008,899,437,0,437,0,2,435
14-178-009,934,443,0,443,0,1,442
14-178-010,1007,530,0,530,0,2,528
14-178-011,858,466,0,466,0,1,465
14-178-012,878,453,0,453,0,2,451
14-178-013,780,387,0,387,0,0,387
14-178-014,972,434,0,434,0,0,434
14-178-015,833,372,1,371,-1,0,371
14-178-016,821,339,0,339,0,1,338
14-179-001,946,541,0,541,0,2,539
14-179-002,1085,577,0,577,0,5,572
14-179-003,971,501,0,501,0,2,499
14-180-001,1086,385,0,385,0,1,384
14-181-001,891,565,0,563,-2,6,557
14-181-002,653,312,0,312,0,1,311
14-182-001,1047,597,0,597,0,5,592
14-183-001,1154,645,0,645,0,4,641
14-183-002,1203,543,0,542,-1,0,542
14-183-003,920,434,0,433,-1,2,431
14-183-004,995,494,2,492,-2,6,486
14-184-001,969,404,0,404,0,0,404
14-184-002,1036,361,0,361,0,2,359
14-185-001,868,246,0,246,0,1,245
14-185-002,757,299,0,299,0,1,298
14-186-001,742,497,0,497,0,1,496
14-187-001,1094,397,0,397,0,0,397
14-187-002,776,289,0,289,0,2,287
14-187-003,952,316,0,316,0,6,310
14-187-004,950,277,0,277,0,2,275
15-001-001,204,84,0,84,0,1,83
15-002-001,711,262,0,262,0,2,260
15-002-002,89,40,0,40,0,0,40
15-003-001,773,279,0,279,0,1,278
15-003-002,972,314,0,314,0,3,311
15-004-001,640,193,0,193,0,0,193
15-004-002,565,151,0,151,0,1,150
15-005-001,154,49,0,49,0,0,49
15-006-001,935,505,0,505,0,3,502
15-007-001,1160,671,0,670,-1,0,670
15-007-002,778,323,0,323,0,1,322
15-007-003,833,405,0,405,0,2,403
15-007-004,851,381,0,381,0,1,380
15-007-005,783,389,0,389,0,0,389
15-007-006,574,225,0,225,0,0,225
15-008-001,1111,429,0,429,0,0,429
15-009-001,1037,618,0,616,-2,1,615
15-009-002,856,372,0,372,0,1,371
15-009-003,106,47,0,47,0,0,47
15-010-001,1081,666,0,665,-1,2,663
15-010-002,1011,542,0,542,0,1,541
15-011-001,683,325,0,325,0,3,322
15-011-002,720,320,0,320,0,0,320
15-012-001,847,318,0,318,0,0,318
15-012-002,1081,600,0,600,0,3,597
15-012-003,738,346,1,345,-1,1,344
15-012-004,698,319,0,319,0,0,319
15-012-005,850,365,0,365,0,3,362
15-013-001,710,398,1,397,-1,4,393
15-014-001,448,224,0,224,0,1,223
15-015-001,703,354,0,354,0,0,354
15-015-002,568,197,0,197,0,1,196
15-015-003,515,177,0,177,0,0,177
15-015-004,578,246,0,246,0,1,245
15-016-001,1081,664,0,664,0,3,661
15-016-002,897,401,0,401,0,0,401
15-017-001,879,461,0,461,0,2,459
15-017-002,703,407,0,407,0,1,406
15-018-001,667,327,0,327,0,1,326
15-018-002,636,282,0,282,0,1,281
15-019-001,421,206,0,206,0,0,206
15-020-001,1021,382,0,382,0,0,382
15-020-002,960,439,0,439,0,5,434
15-020-003,555,246,0,246,0,1,245
15-020-004,1152,266,0,266,0,4,262
15-020-005,1061,362,0,362,0,0,362
15-020-006,1125,521,0,521,0,5,516
15-020-007,1079,410,0,410,0,4,406
15-020-008,1101,416,0,416,0,1,415
15-020-009,519,207,0,207,0,0,207
15-020-010,252,91,0,91,0,0,91
15-021-001,640,235,0,235,0,2,233
15-022-001,624,176,0,176,0,2,174
15-023-001,486,153,0,153,0,0,153
15-024-001,928,339,0,339,0,5,334
15-025-001,302,91,0,91,0,2,89
15-026-001,451,130,0,130,0,2,128
15-027-001,848,345,0,345,0,1,344
15-027-002,1058,349,0,349,0,0,349
15-028-001,285,120,0,120,0,0,120
15-029-001,307,134,0,134,0,2,132
15-030-001,349,119,0,119,0,0,119
15-031-001,544,147,0,147,0,1,146
15-032-001,208,77,0,77,0,0,77
15-033-001,902,292,0,292,0,2,290
15-033-002,912,322,0,322,0,2,320
15-034-001,407,183,0,183,0,0,183
15-035-001,629,242,0,242,0,1,241
15-035-002,407,155,0,155,0,2,153
15-036-001,220,45,0,45,0,0,45
15-037-001,192,46,0,46,0,0,46
15-038-001,171,93,0,93,0,0,93
15-039-001,608,214,0,213,-1,0,213
15-039-002,614,186,0,186,0,1,185
15-040-001,367,180,0,180,0,0,180
15-041-001,209,76,0,76,0,1,75
15-042-001,781,226,0,226,0,2,224
15-043-001,220,98,0,98,0,1,97
15-044-001,580,209,0,209,0,0,209
15-044-002,716,241,0,241,0,2,239
15-044-003,788,313,0,313,0,1,312
15-044-004,802,339,0,339,0,1,338
15-044-005,618,280,0,280,0,2,278
15-044-006,554,225,0,225,0,0,225
15-045-001,129,52,0,52,0,0,52
15-046-001,702,246,0,246,0,2,244
15-047-001,110,53,0,53,0,2,51
15-048-001,194,94,0,94,0,0,94
15-049-001,149,88,0,88,0,0,88
15-050-001,147,58,0,58,0,0,58
15-051-001,296,116,0,116,0,0,116
15-052-001,104,45,0,45,0,0,45
15-053-001,244,90,0,90,0,0,90
15-054-001,1287,736,0,735,-1,2,733
15-054-002,1067,544,0,544,0,2,542
15-054-003,1087,522,0,522,0,2,520
15-054-004,1036,401,0,401,0,3,398
15-055-001,61,30,0,30,0,0,30
15-056-001,76,42,0,42,0,0,42
15-057-001,275,96,0,96,0,2,94
15-058-001,473,170,0,170,0,1,169
15-058-002,90,27,0,27,0,0,27
15-059-001,188,81,0,81,0,0,81
15-060-001,276,81,0,81,0,2,79
15-061-001,615,202,0,202,0,1,201
15-061-002,82,27,0,27,0,0,27
15-062-001,393,117,0,117,0,1,116
15-062-002,494,111,0,111,0,0,111
15-063-001,809,320,0,320,0,1,319
15-064-001,234,96,0,96,0,1,95
15-065-001,175,61,0,61,0,0,61
15-066-001,292,99,0,99,0,1,98
15-067-001,570,187,0,187,0,3,184
15-068-001,308,85,0,85,0,1,84
15-069-001,284,99,0,99,0,1,98
15-070-001,205,72,0,72,0,0,72
15-071-001,950,395,0,395,0,2,393
15-072-001,192,76,0,76,0,1,75
15-073-001,865,200,0,200,0,0,200
15-074-001,38,18,0,18,0,0,18
15-075-001,1073,446,0,446,0,2,444
15-076-001,377,131,0,131,0,0,131
15-077-001,979,297,0,297,0,1,296
15-078-001,974,242,0,242,0,3,239
15-079-001,378,98,1,98,0,0,98
15-080-001,498,189,0,189,0,1,188
15-081-001,973,422,0,422,0,2,420
15-082-001,670,213,0,212,-1,3,209
15-082-002,648,192,0,192,0,2,190
15-082-003,705,227,0,227,0,1,226
15-083-001,528,171,0,171,0,0,171
15-084-001,676,276,0,276,0,3,273
15-084-002,628,198,0,198,0,3,195
15-085-001,84,47,0,47,0,0,47
15-086-001,352,122,0,122,0,0,122
15-087-001,244,58,0,58,0,0,58
15-088-001,682,254,0,254,0,0,254
15-088-002,636,233,0,233,0,4,229
15-088-003,628,278,0,278,0,4,274
15-089-001,841,354,0,354,0,6,348
15-090-001,578,263,0,263,0,0,263
15-091-001,1031,431,0,431,0,2,429
15-091-002,686,307,0,307,0,1,306
15-091-003,830,292,0,292,0,0,292
15-091-004,664,272,0,272,0,2,270
15-091-005,954,411,0,411,0,0,411
15-091-006,1020,491,0,491,0,1,490
15-091-007,1011,455,0,454,-1,0,454
15-091-008,860,309,0,309,0,2,307
15-091-009,761,269,0,269,0,0,269
15-091-010,602,275,0,275,0,0,275
15-091-011,685,312,0,312,0,0,312
15-091-012,909,423,0,423,0,0,423
15-091-013,737,290,0,290,0,0,290
15-091-014,611,282,1,282,0,2,280
15-091-015,789,364,0,364,0,6,358
15-091-016,1144,508,0,508,0,2,506
15-091-017,1069,567,1,566,-1,2,564
15-091-018,756,334,0,334,0,1,333
15-091-019,595,216,0,216,0,2,214
15-091-020,739,285,0,285,0,0,285
15-091-021,1037,479,0,479,0,5,474
15-091-022,1060,433,0,433,0,3,430
15-091-023,1106,547,0,547,0,1,546
15-091-024,1323,499,0,497,-2,9,488
15-091-025,717,308,0,308,0,1,307
15-091-026,770,361,0,361,0,2,359
15-091-027,739,281,0,281,0,0,281
15-091-028,690,290,0,290,0,1,289
15-091-029,767,298,0,296,-2,0,296
15-091-030,1122,496,0,496,0,2,494
15-091-031,995,417,0,417,0,1,416
15-091-032,785,277,0,277,0,0,277
15-091-033,877,377,0,377,0,1,376
15-091-034,750,396,0,396,0,1,395
15-091-035,758,394,0,394,0,3,391
15-091-036,1143,572,0,570,-2,1,569
15-091-037,911,421,0,420,-1,0,420
15-091-038,929,436,0,436,0,2,434
15-091-039,1095,470,0,470,0,0,470
15-091-040,821,444,0,444,0,3,441
15-091-041,884,441,0,441,0,3,438
15-091-042,838,469,0,469,0,3,466
15-091-043,864,490,1,489,-1,3,486
15-091-044,815,449,0,449,0,3,446
15-091-045,865,414,1,412,-2,2,410
15-091-046,794,394,0,394,0,0,394
15-091-047,668,363,0,359,-4,8,351
15-091-048,611,328,0,327,-1,0,327
15-091-049,682,364,0,364,0,1,363
15-091-050,937,441,0,441,0,4,437
15-091-051,819,274,0,274,0,3,271
15-091-052,1228,570,0,570,0,1,569
15-091-053,631,265,0,265,0,1,264
15-091-054,1034,318,0,317,-1,9,308
15-091-055,933,184,0,184,0,4,180
15-091-056,737,327,0,327,0,2,325
15-091-057,1082,474,0,474,0,0,474
15-091-058,876,341,0,341,0,1,340
15-091-059,1047,580,0,579,-1,2,577
15-092-001,565,249,0,249,0,1,248
15-092-002,622,213,0,213,0,0,213
15-093-001,178,61,0,61,0,1,60
15-094-001,89,56,0,56,0,0,56
15-095-001,226,87,0,87,0,3,84
15-096-001,457,131,0,131,0,1,130
15-097-001,347,116,0,116,0,0,116
15-098-001,43,25,0,25,0,1,24
15-099-001,260,102,0,102,0,1,101
15-100-001,287,92,0,92,0,0,92
15-101-001,447,172,0,172,0,0,172
15-102-001,588,191,0,191,0,0,191
15-102-002,507,218,0,218,0,1,217
15-102-003,613,244,0,244,0,2,242
15-103-001,143,49,0,49,0,0,49
15-104-001,303,89,0,89,0,2,87
15-105-001,308,117,0,117,0,4,113
15-106-001,120,41,0,41,0,0,41
15-107-001,185,77,0,77,0,0,77
15-108-001,706,219,0,219,0,0,219
15-109-001,148,73,0,73,0,1,72
15-110-001,419,164,0,164,0,2,162
15-111-001,277,67,0,67,0,3,64
15-111-002,131,32,0,32,0,1,31
15-112-001,1234,543,0,543,0,2,541
15-113-001,520,183,0,183,0,2,181
15-113-002,575,166,0,166,0,0,166
15-114-001,477,168,0,168,0,0,168
15-115-001,440,92,0,92,0,0,92
15-116-001,808,222,0,222,0,0,222
15-116-002,701,261,0,261,0,2,259
15-117-001,542,215,0,215,0,0,215
15-117-002,623,228,1,227,-1,1,226
15-118-001,788,317,0,317,0,0,317
15-118-002,751,236,0,236,0,0,236
15-118-003,841,212,0,212,0,4,208
15-119-001,29,20,0,20,0,0,20
15-120-001,185,75,0,75,0,0,75
15-121-001,530,209,0,209,0,2,207
15-121-002,153,77,0,77,0,0,77
15-122-001,484,188,0,188,0,1,187
15-123-001,1000,332,0,332,0,1,331
15-123-002,176,67,0,67,0,0,67
15-123-003,907,395,0,395,0,2,393
15-123-004,1171,438,0,438,0,1,437
15-123-005,1143,498,0,498,0,3,495
15-123-006,1087,461,0,461,0,2,459
15-123-007,1157,411,0,411,0,2,409
15-123-008,854,362,0,362,0,1,361
15-123-009,1115,398,0,398,0,2,396
15-123-010,385,156,0,156,0,2,154
15-123-011,75,36,0,36,0,0,36
15-123-012,283,85,0,85,0,0,85
15-124-001,513,237,0,237,0,1,236
15-124-002,452,151,0,151,0,1,150
15-124-003,112,38,0,38,0,0,38
15-125-001,594,205,0,205,0,1,204
15-125-002,413,201,0,201,0,1,200
15-126-001,948,223,0,223,0,0,223
15-127-001,480,127,0,127,0,4,123
15-128-001,167,78,0,78,0,1,77
15-129-001,754,278,0,278,0,3,275
15-130-001,217,71,0,71,0,0,71
15-130-002,1046,469,0,469,0,2,467
15-130-003,1081,457,0,457,0,2,455
15-130-004,1236,509,0,509,0,4,505
15-130-005,1065,499,0,498,-1,2,496
15-130-006,1108,494,0,494,0,4,490
15-130-007,1128,425,0,425,0,0,425
15-130-008,1050,433,0,433,0,1,432
15-130-009,896,305,0,305,0,0,305
15-131-001,862,259,0,259,0,6,253
15-131-002,814,215,0,215,0,2,213
15-131-003,796,166,0,166,0,2,164
15-132-001,1106,310,0,310,0,4,306
15-133-001,1131,387,0,387,0,0,387
15-134-001,286,148,0,148,0,4,144
15-135-001,414,136,0,136,0,0,136
15-136-001,319,104,0,104,0,0,104
15-137-001,486,153,0,153,0,0,153
15-138-001,505,117,0,117,0,1,116
15-139-001,79,40,0,40,0,1,39
15-140-001,501,163,0,163,0,2,161
15-141-001,528,200,0,200,0,1,199
15-142-001,270,105,0,105,0,1,104
15-143-001,441,197,0,197,0,0,197
15-144-001,662,264,0,264,0,2,262
15-145-001,585,207,0,207,0,3,204
15-146-001,558,161,0,160,-1,3,157
15-146-002,583,174,0,174,0,1,173
15-147-001,639,160,0,160,0,1,159
15-148-001,98,30,0,30,0,0,30
15-148-002,298,133,0,133,0,0,133
15-149-001,199,80,0,80,0,0,80
15-150-001,255,129,0,129,0,4,125
15-151-001,50,25,0,25,0,0,25
15-152-001,202,64,0,64,0,2,62
15-153-001,216,73,0,73,0,0,73
15-154-001,130,56,0,55,-1,1,54
15-155-001,389,116,0,116,0,0,116
15-156-001,171,74,0,74,0,0,74
15-157-001,158,84,0,84,0,1,83
15-158-001,220,83,0,83,0,0,83
15-159-001,73,35,0,35,0,0,35
15-160-001,155,55,0,55,0,0,55
15-161-001,461,173,0,173,0,0,173
15-161-002,114,34,0,34,0,0,34
15-162-001,318,130,0,130,0,2,128
15-163-001,375,146,0,146,0,1,145
15-164-001,144,40,0,40,0,2,38
15-165-001,123,61,1,60,-1,0,60
15-166-001,310,64,0,64,0,1,63
15-167-001,237,68,1,67,-1,0,67
15-168-001,33,12,0,12,0,0,12
15-169-001,764,313,0,313,0,3,310
15-169-002,775,248,0,248,0,1,247
15-170-001,418,182,0,182,0,0,182
15-171-001,347,118,0,118,0,0,118
15-172-001,900,194,0,194,0,5,189
15-172-002,1004,263,0,263,0,0,263
15-173-001,119,55,0,55,0,0,55
15-174-001,305,123,0,123,0,1,122
15-175-001,262,127,0,127,0,1,126
15-175-002,649,310,0,310,0,2,308
15-175-003,574,283,0,283,0,0,283
15-175-004,1080,802,0,802,0,1,801
15-175-005,1210,594,0,594,0,3,591
15-175-006,831,440,0,440,0,0,440
15-175-007,952,460,0,459,-1,0,459
15-175-008,847,440,0,439,-1,2,437
15-175-009,967,534,0,534,0,2,532
15-175-010,1112,523,0,523,0,2,521
15-175-011,656,326,0,326,0,0,326
15-175-012,582,307,0,307,0,0,307
15-175-013,905,409,0,409,0,0,409
15-175-014,776,360,0,360,0,1,359
15-175-015,826,390,0,390,0,2,388
15-175-016,841,440,0,440,0,2,438
15-175-017,1170,421,0,421,0,1,420
15-175-018,1076,438,0,438,0,1,437
15-175-019,1167,431,0,431,0,1,430
15-175-020,1301,521,0,521,0,6,515
15-175-021,1326,580,0,579,-1,0,579
15-175-022,275,130,0,130,0,0,130
15-175-023,695,318,0,318,0,0,318
15-175-024,646,337,0,337,0,0,337
15-176-001,529,169,0,169,0,2,167
15-177-001,553,200,0,200,0,2,198
15-178-001,323,97,0,97,0,0,97
15-179-001,127,44,0,44,0,0,44
15-180-001,108,32,0,32,0,0,32
15-181-001,464,187,0,187,0,0,187
15-181-002,146,55,0,55,0,0,55
15-182-001,401,154,0,154,0,0,154
15-183-001,69,34,0,34,0,0,34
15-184-001,115,59,0,59,0,0,59
15-185-001,116,47,0,47,0,4,43
15-186-001,162,60,0,60,0,1,59
15-187-001,392,165,0,165,0,1,164
15-188-001,333,83,0,83,0,3,80
15-189-001,546,208,0,208,0,2,206
15-189-002,737,251,0,251,0,0,251
15-190-001,398,143,0,143,0,0,143
15-191-001,487,160,0,160,0,2,158
15-192-001,1027,260,0,260,0,4,256
15-193-001,53,32,0,32,0,0,32
15-194-001,472,141,0,141,0,1,140
15-195-001,547,176,0,176,0,1,175
15-196-001,558,227,0,227,0,0,227
15-196-002,720,221,0,221,0,2,219
15-197-001,364,136,0,136,0,0,136
15-198-001,441,169,0,169,0,2,167
15-198-002,414,146,0,146,0,1,145
15-199-001,599,195,0,195,0,2,193
15-200-001,768,327,0,327,0,4,323
15-200-002,465,150,0,150,0,1,149
15-200-003,112,36,0,36,0,0,36
15-201-001,258,75,0,75,0,0,75
15-201-002,167,69,0,69,0,2,67
15-202-001,250,112,0,112,0,1,111
15-203-001,430,131,0,131,0,1,130
15-204-001,627,371,0,371,0,4,367
15-205-001,152,77,0,77,0,1,76
15-206-001,572,278,0,278,0,3,275
15-207-001,318,144,0,144,0,2,142
15-208-001,267,143,0,143,0,1,142
15-209-001,97,44,0,44,0,0,44
15-210-001,392,142,0,142,0,0,142
15-211-001,240,87,0,87,0,2,85
15-212-001,161,66,0,66,0,1,65
15-213-001,79,46,0,46,0,0,46
15-214-001,490,244,0,242,-2,0,242
15-215-001,203,81,0,81,0,0,81
15-216-001,471,176,0,176,0,0,176
15-216-002,520,180,0,180,0,0,180
15-217-001,494,216,0,216,0,1,215
15-218-001,659,224,0,224,0,1,223
15-218-002,717,300,0,300,0,3,297
15-218-003,630,207,0,207,0,0,207
15-218-004,746,277,0,277,0,1,276
15-218-005,757,322,0,322,0,0,322
15-219-001,497,151,0,151,0,0,151
15-220-001,465,146,0,146,0,4,142
15-220-002,458,131,0,131,0,1,130
15-221-001,784,329,0,329,0,4,325
15-221-002,846,305,0,305,0,2,303
15-222-001,283,127,0,127,0,1,126
15-223-001,163,53,0,53,0,0,53
15-224-001,348,97,0,97,0,1,96
15-225-001,101,26,0,26,0,1,25
15-226-001,195,83,0,83,0,0,83
15-227-001,185,82,0,82,0,0,82
15-228-001,346,123,0,123,0,0,123
15-229-001,92,36,0,36,0,0,36
15-229-002,99,53,0,53,0,0,53
15-230-001,114,50,0,50,0,0,50
15-231-001,381,172,0,172,0,1,171
15-232-001,586,180,0,180,0,0,180
15-233-001,170,61,0,61,0,0,61
15-234-001,152,85,0,85,0,0,85
15-235-001,465,143,0,143,0,0,143
15-236-001,349,170,0,170,0,3,167
15-237-001,216,91,0,91,0,1,90
15-238-001,1233,741,0,741,0,1,740
15-238-002,1122,550,0,550,0,2,548
15-239-001,406,175,0,175,0,0,175
15-239-002,509,228,0,228,0,5,223
15-240-001,278,108,2,107,-1,1,106
15-241-001,437,149,0,149,0,2,147
15-242-001,196,73,0,73,0,2,71
15-243-001,357,147,0,147,0,0,147
15-244-001,345,169,0,169,0,1,168
15-245-001,426,139,0,139,0,0,139
15-246-001,1235,623,0,623,0,5,618
16-001-001,990,418,0,418,0,1,417
16-001-002,936,457,0,457,0,5,452
16-001-003,1161,398,0,398,0,2,396
16-002-001,810,261,0,261,0,2,259
16-002-002,792,163,0,163,0,0,163
16-003-001,651,227,0,227,0,0,227
16-003-002,626,198,0,198,0,6,192
16-003-003,661,194,0,194,0,3,191
16-004-001,755,264,0,264,0,0,264
16-004-002,787,301,0,301,0,1,300
16-005-001,750,561,0,561,0,25,536
16-005-002,840,607,0,607,0,5,602
16-005-003,1169,894,0,894,0,19,875
16-006-001,826,303,0,303,0,1,302
16-006-002,988,337,0,337,0,2,335
16-006-003,1117,364,0,364,0,4,360
16-006-004,345,104,1,103,-1,1,102
16-006-005,647,164,0,164,0,7,157
16-006-006,1047,241,0,241,0,0,241
16-007-001,618,257,0,257,0,1,256
16-008-001,824,369,0,369,0,8,361
16-009-001,556,215,0,215,0,6,209
16-010-001,382,172,0,172,0,1,171
16-011-001,788,387,0,387,0,9,378
16-012-001,764,345,0,345,0,7,338
16-013-001,621,316,0,316,0,2,314
16-014-001,570,261,0,261,0,3,258
16-015-001,775,196,0,196,0,1,195
16-016-001,1117,379,0,379,0,7,372
16-017-001,688,243,0,243,0,6,237
16-018-001,575,214,0,214,0,7,207
16-018-002,635,194,0,194,0,0,194
16-018-003,604,191,0,191,0,1,190
16-018-004,622,150,0,150,0,3,147
16-019-001,593,250,0,249,-1,4,245
16-019-002,666,212,0,212,0,0,212
16-019-003,549,176,0,176,0,0,176
16-020-001,533,252,0,252,0,0,252
16-021-001,426,247,0,247,0,3,244
16-022-001,507,221,0,221,0,1,220
16-023-001,309,128,0,128,0,0,128
16-024-001,556,233,1,232,-1,2,230
16-025-001,748,269,0,269,0,1,268
16-025-002,822,363,0,363,0,1,362
16-025-003,929,392,0,392,0,8,384
16-025-004,733,345,0,345,0,4,341
16-025-005,830,324,0,324,0,3,321
16-026-001,671,272,0,272,0,4,268
16-027-001,663,401,0,400,-1,5,395
16-028-001,132,46,0,46,0,0,46
16-029-001,619,285,0,285,0,0,285
16-029-002,903,375,0,375,0,7,368
16-029-003,981,318,0,318,0,5,313
16-029-004,661,278,0,278,0,1,277
16-029-005,235,78,0,78,0,1,77
16-030-001,1062,278,0,278,0,1,277
16-030-002,1026,380,0,379,-1,7,372
16-030-003,921,367,0,367,0,1,366
16-031-001,902,270,0,270,0,3,267
16-031-002,864,283,0,283,0,5,278
16-032-001,669,254,0,254,0,1,253
16-032-002,745,337,0,337,0,1,336
16-033-001,896,312,0,312,0,10,302
16-034-001,641,246,0,246,0,3,243
16-034-002,683,229,0,229,0,4,225
16-035-001,490,118,0,118,0,2,116
16-035-002,712,251,0,251,0,2,249
16-035-003,177,55,0,55,0,0,55
16-036-001,933,429,0,429,0,2,427
16-036-002,995,529,0,529,0,2,527
16-036-003,877,377,0,377,0,3,374
16-036-004,900,444,0,444,0,1,443
16-036-005,925,482,0,482,0,1,481
16-036-006,952,433,0,433,0,4,429
16-036-007,966,340,0,340,0,0,340
16-037-001,1048,503,0,503,0,2,501
16-037-002,1011,336,0,336,0,3,333
16-038-001,367,146,0,146,0,1,145
16-039-001,241,150,0,150,0,3,147
16-040-001,650,190,0,190,0,0,190
16-041-001,115,74,0,74,0,0,74
16-042-001,923,302,0,302,0,6,296
16-042-002,933,342,0,342,0,6,336
16-042-003,893,296,0,296,0,3,293
16-043-001,507,200,0,200,0,7,193
16-044-001,642,255,0,255,0,1,254
16-045-001,752,290,0,290,0,0,290
16-045-002,711,225,0,224,-1,1,223
16-046-001,426,218,0,218,0,2,216
16-047-001,831,251,0,251,0,2,249
16-047-002,732,202,0,202,0,0,202
16-048-001,820,373,0,373,0,7,366
16-049-001,109,46,0,46,0,0,46
16-050-001,1233,441,0,441,0,6,435
16-051-001,776,216,0,216,0,1,215
16-051-002,815,170,0,170,0,0,170
16-052-001,227,110,0,110,0,1,109
16-053-001,985,426,0,426,0,1,425
16-054-001,229,88,0,88,0,1,87
16-055-001,247,104,0,104,0,0,104
16-056-001,885,198,0,198,0,3,195
16-056-002,756,151,0,150,-1,2,148
16-056-003,793,141,0,141,0,1,140
16-057-001,1002,312,0,312,0,0,312
16-057-002,962,356,0,356,0,0,356
16-057-003,1053,304,0,304,0,1,303
16-057-004,1071,193,0,193,0,0,193
16-057-005,1067,278,0,278,0,1,277
16-057-006,177,60,0,60,0,2,58
16-058-001,971,463,0,463,0,7,456
16-059-001,633,329,0,329,0,3,326
16-060-001,1374,622,0,622,0,5,617
16-061-001,1044,367,0,367,0,2,365
16-062-001,632,225,0,225,0,8,217
16-063-001,619,202,0,202,0,0,202
16-063-002,732,232,0,232,0,0,232
16-063-003,592,229,0,229,0,2,227
16-063-004,862,286,2,284,-2,2,282
16-063-005,220,80,0,80,0,1,79
16-064-001,738,232,0,232,0,3,229
16-064-002,606,216,0,216,0,3,213
16-064-003,174,62,0,62,0,0,62
16-065-001,725,256,0,256,0,1,255
16-065-002,915,261,0,261,0,4,257
16-066-001,1090,521,0,521,0,5,516
16-066-002,1048,490,0,490,0,7,483
16-066-003,783,403,0,402,-1,6,396
16-066-004,991,459,0,459,0,8,451
16-067-001,746,253,0,253,0,1,252
16-067-002,798,270,0,270,0,0,270
16-068-001,615,276,0,276,0,1,275
16-068-002,599,250,0,250,0,4,246
16-069-001,242,133,0,133,0,0,133
16-070-001,828,348,0,348,0,7,341
16-071-001,57,38,0,38,0,1,37
16-072-001,1294,473,0,473,0,0,473
16-073-001,221,97,0,97,0,6,91
16-074-001,606,165,0,165,0,0,165
16-075-001,430,225,0,225,0,1,224
16-076-001,841,325,0,325,0,0,325
16-077-001,761,287,0,287,0,4,283
16-077-002,943,353,0,353,0,3,350
16-077-003,732,301,0,301,0,1,300
16-077-004,972,400,0,400,0,2,398
16-077-005,1123,458,0,458,0,7,451
16-077-006,704,336,0,336,0,6,330
16-077-007,862,291,0,291,0,1,290
16-077-008,967,396,0,396,0,5,391
16-077-009,829,291,0,291,0,2,289
16-077-010,854,370,0,370,0,6,364
16-077-011,841,413,0,413,0,3,410
16-077-012,622,296,0,296,0,1,295
16-077-013,922,315,0,315,0,3,312
16-077-014,841,375,0,375,0,2,373
16-077-015,792,301,0,301,0,5,296
16-077-016,819,306,0,306,0,5,301
16-078-001,967,378,0,378,0,5,373
16-078-002,630,258,0,258,0,0,258
16-078-003,742,266,1,266,0,1,265
16-079-001,111,41,0,41,0,0,41
16-080-001,1103,324,0,324,0,3,321
16-081-001,1245,286,0,286,0,1,285
16-081-002,1219,315,0,315,0,1,314
16-081-003,1216,381,0,381,0,1,380
16-082-001,1095,422,0,419,-3,2,417
16-083-001,492,183,0,183,0,4,179
16-084-001,789,319,0,319,0,6,313
16-085-001,783,273,0,273,0,0,273
16-085-002,759,267,0,267,0,1,266
16-085-003,818,262,0,262,0,9,253
16-086-001,770,246,0,246,0,0,246
16-087-001,417,199,0,199,0,3,196
16-088-001,228,110,0,110,0,0,110
16-089-001,705,233,0,233,0,5,228
16-090-001,243,100,0,100,0,1,99
16-091-001,700,269,0,269,0,8,261
16-091-002,752,276,0,276,0,2,274
16-091-003,1004,250,0,250,0,4,246
16-091-004,843,360,0,360,0,3,357
16-092-001,851,424,0,424,0,4,420
16-092-002,855,237,0,237,0,3,234
16-093-001,522,195,0,195,0,5,190
16-094-001,1130,451,0,451,0,2,449
16-094-002,697,338,0,338,0,1,337
16-094-003,721,343,0,343,0,5,338
16-094-004,788,373,0,373,0,0,373
16-094-005,762,284,0,284,0,1,283
16-094-006,821,357,0,357,0,2,355
16-094-007,905,352,0,352,0,2,350
16-094-008,697,294,0,294,0,1,293
16-094-009,918,432,0,432,0,1,431
16-094-010,790,357,0,357,0,2,355
16-094-011,819,323,0,323,0,1,322
16-094-012,1037,406,0,406,0,5,401
16-094-013,823,362,0,362,0,2,360
16-094-014,777,317,0,317,0,2,315
16-094-015,923,397,1,397,0,5,392
16-094-016,942,435,0,435,0,0,435
16-095-001,253,74,0,74,0,2,72
16-096-001,828,254,0,254,0,2,252
16-097-001,570,215,0,215,0,5,210
16-098-001,1057,371,0,371,0,1,370
16-098-002,625,259,0,259,0,0,259
16-099-001,760,384,0,384,0,2,382
16-100-001,528,245,0,245,0,0,245
16-101-001,925,255,0,255,0,2,253
16-101-002,224,69,0,69,0,0,69
16-101-003,107,44,0,43,-1,0,43
16-102-001,831,251,0,251,0,4,247
16-102-002,849,272,0,272,0,4,268
16-103-001,1040,310,0,310,0,1,309
16-103-002,559,153,0,153,0,0,153
16-103-003,834,219,0,219,0,0,219
16-103-004,691,133,0,133,0,0,133
16-103-005,990,137,0,137,0,3,134
16-103-006,800,230,0,230,0,2,228
16-104-001,712,224,0,224,0,6,218
16-104-002,631,172,0,172,0,1,171
16-104-003,798,184,0,184,0,1,183
16-104-004,834,154,0,154,0,1,153
16-104-005,770,225,0,225,0,1,224
16-104-006,778,181,0,181,0,1,180
16-105-001,121,63,0,63,0,1,62
16-106-001,994,417,0,417,0,5,412
16-106-002,1036,326,0,326,0,2,324
16-106-003,1012,332,0,332,0,2,330
16-106-004,940,319,0,319,0,6,313
16-106-005,929,357,0,357,0,6,351
16-106-006,996,330,1,329,-1,6,323
16-106-007,939,335,0,335,0,1,334
16-106-008,1014,396,0,396,0,2,394
16-107-001,453,157,0,157,0,3,154
16-108-001,1157,477,0,477,0,3,474
16-109-001,950,355,0,355,0,0,355
16-109-002,1004,309,1,308,-1,9,299
16-109-003,1156,281,0,281,0,1,280
16-110-001,748,338,0,338,0,5,333
16-111-001,98,53,0,53,0,3,50
16-112-001,1397,357,0,357,0,9,348
16-112-002,1142,429,0,429,0,2,427
16-112-003,1071,401,0,401,0,1,400
16-112-004,1129,489,0,489,0,2,487
16-112-005,1160,472,0,472,0,1,471
16-112-006,1226,587,0,587,0,3,584
16-112-007,1187,404,0,404,0,1,403
16-112-008,1159,531,0,531,0,3,528
16-113-001,693,245,0,245,0,0,245
16-113-002,828,336,0,336,0,3,333
16-113-003,627,213,0,213,0,1,212
16-114-001,914,679,0,679,0,13,666
16-114-002,757,557,0,557,0,5,552
16-114-003,834,601,0,601,0,8,593
16-115-001,593,195,0,195,0,2,193
16-115-002,874,229,0,229,0,5,224
16-115-003,855,343,0,343,0,1,342
16-116-001,1111,471,0,471,0,4,467
16-116-002,643,225,0,225,0,5,220
16-117-001,980,465,0,465,0,7,458
16-118-001,487,249,0,249,0,4,245
16-119-001,847,428,0,427,-1,1,426
16-119-002,1001,480,0,480,0,1,479
16-119-003,767,335,0,335,0,4,331
16-119-004,1398,579,0,579,0,5,574
16-119-005,1010,450,0,450,0,2,448
16-119-006,952,430,0,430,0,0,430
16-119-007,906,500,0,500,0,2,498
16-119-008,1054,459,0,459,0,0,459
16-119-009,843,340,0,340,0,2,338
16-119-010,872,446,0,446,0,6,440
16-119-011,976,396,0,396,0,1,395
16-119-012,834,336,0,336,0,3,333
16-119-013,987,287,0,287,0,1,286
16-119-014,926,417,0,417,0,1,416
16-119-015,1123,595,0,592,-3,1,591
16-119-016,727,352,0,352,0,0,352
16-119-017,966,616,0,616,0,5,611
16-119-018,697,349,0,346,-3,2,344
16-119-019,1170,401,0,401,0,3,398
16-119-020,828,364,0,364,0,0,364
16-119-021,824,381,0,381,0,0,381
16-119-022,1295,641,0,640,-1,4,636
16-119-023,952,407,0,407,0,1,406
16-119-024,1108,459,0,458,-1,3,455
16-119-025,922,421,0,421,0,1,420
16-119-026,814,314,0,314,0,2,312
16-119-027,751,309,0,309,0,1,308
16-119-028,991,484,0,484,0,1,483
16-119-029,844,386,0,386,0,1,385
16-119-030,1081,438,0,438,0,4,434
16-119-031,832,394,0,394,0,0,394
16-119-032,873,448,0,448,0,0,448
16-119-033,834,435,0,435,0,1,434
16-119-034,982,411,0,411,0,5,406
16-119-035,726,220,0,220,0,3,217
16-119-036,919,371,0,371,0,2,369
16-119-037,590,282,0,282,0,1,281
16-119-038,699,338,0,338,0,7,331
16-119-039,668,212,0,212,0,2,210
16-119-040,1023,405,0,405,0,5,400
16-119-041,1181,476,0,476,0,0,476
16-119-042,1230,458,0,457,-1,0,457
16-119-043,872,400,0,400,0,9,391
16-119-044,936,451,0,451,0,6,445
16-119-045,734,351,0,351,0,3,348
16-119-046,922,382,0,382,0,3,379
16-119-047,1392,924,0,923,-1,6,917
16-119-048,1152,475,0,475,0,3,472
16-119-049,655,221,0,221,0,1,220
16-119-050,866,376,0,376,0,2,374
16-119-051,978,348,0,339,-9,2,337
16-119-052,893,397,0,397,0,11,386
16-119-053,707,302,0,302,0,1,301
16-119-054,1181,518,0,518,0,3,515
16-119-055,902,379,0,379,0,6,373
16-119-056,690,335,0,335,0,1,334
16-119-057,1045,505,0,505,0,3,502
16-119-058,817,399,0,399,0,1,398
16-119-059,853,479,0,479,0,0,479
16-119-060,757,392,0,390,-2,0,390
16-119-061,657,219,0,219,0,0,219
16-119-062,1325,582,0,582,0,1,581
16-119-063,879,359,0,353,-6,3,350
16-119-064,802,329,0,329,0,1,328
16-119-065,986,344,0,344,0,1,343
16-119-066,1231,450,0,450,0,4,446
16-119-067,1151,413,0,413,0,2,411
16-119-068,976,412,0,412,0,4,408
16-119-069,1087,336,0,335,-1,1,334
16-119-070,1185,552,0,552,0,1,551
16-119-071,860,473,0,473,0,1,472
16-119-072,855,300,0,300,0,1,299
16-119-073,1153,575,0,575,0,0,575
16-119-074,945,478,0,478,0,1,477
16-119-075,1159,519,0,519,0,1,518
16-119-076,565,128,0,128,0,0,128
16-119-077,655,244,0,244,0,0,244
16-119-078,841,258,0,258,0,5,253
16-119-079,1220,464,0,464,0,0,464
16-119-080,947,329,0,329,0,0,329
16-119-081,810,257,0,257,0,0,257
16-119-082,1023,293,0,293,0,1,292
16-119-083,727,169,0,169,0,4,165
16-119-084,1123,391,0,390,-1,0,390
16-119-085,1063,400,0,400,0,2,398
16-119-086,1017,288,0,288,0,0,288
16-119-087,908,354,0,353,-1,0,353
16-119-088,743,274,0,274,0,1,273
16-119-089,1150,496,0,496,0,1,495
16-119-090,1013,360,0,360,0,0,360
16-119-091,1127,398,0,398,0,1,397
16-119-092,823,263,0,263,0,4,259
16-119-093,1083,502,0,502,0,2,500
16-119-094,943,446,0,446,0,2,444
16-119-095,1084,480,0,480,0,3,477
16-119-096,1150,557,0,557,0,8,549
16-119-097,807,322,1,322,0,1,321
16-119-098,744,316,0,316,0,0,316
16-119-099,956,390,0,390,0,1,389
16-119-100,686,254,0,254,0,1,253
16-119-101,920,354,0,353,-1,0,353
16-120-001,740,246,0,246,0,0,246
16-120-002,170,65,0,65,0,0,65
16-121-001,783,257,0,257,0,1,256
16-121-002,850,241,0,241,0,2,239
16-122-001,926,320,0,320,0,6,314
16-123-001,701,408,0,408,0,2,406
16-124-001,779,315,0,315,0,3,312
16-124-002,1035,435,0,435,0,0,435
16-125-001,715,340,0,340,0,3,337
16-125-002,707,317,0,317,0,0,317
16-126-001,641,293,0,293,0,7,286
16-127-001,564,229,0,229,0,4,225
16-128-001,834,342,0,342,0,2,340
16-128-002,969,356,0,356,0,3,353
16-128-003,376,122,0,122,0,3,119
16-129-001,1026,197,0,197,0,1,196
16-129-002,862,166,0,166,0,1,165
16-129-003,922,259,0,259,0,1,258
16-129-004,850,240,0,240,0,2,238
16-130-001,1120,427,0,427,0,1,426
16-130-002,1043,357,0,357,0,0,357
16-131-001,699,296,0,296,0,1,295
16-131-002,761,262,0,262,0,1,261
16-132-001,741,375,0,375,0,5,370
16-133-001,668,288,0,288,0,2,286
16-133-002,684,286,0,286,0,0,286
16-133-003,813,353,0,351,-2,6,345
16-133-004,802,286,0,286,0,0,286
16-134-001,572,245,0,245,0,3,242
16-135-001,888,301,0,301,0,0,301
16-135-002,740,209,1,208,-1,2,206
16-136-001,889,344,0,344,0,2,342
16-136-002,1082,375,0,375,0,1,374
16-136-003,1120,327,0,327,0,3,324
16-136-004,744,171,0,171,0,0,171
16-136-005,1108,250,0,250,0,1,249
16-136-006,710,312,0,312,0,0,312
16-137-001,869,323,0,323,0,2,321
16-138-001,689,225,0,225,0,2,223
16-138-002,848,302,0,302,0,3,299
16-139-001,806,314,0,314,0,2,312
16-139-002,787,327,0,327,0,4,323
16-140-001,549,250,0,250,0,9,241
16-141-001,250,160,0,160,0,0,160
16-142-001,1019,363,0,363,0,2,361
16-142-002,1077,360,0,360,0,8,352
16-143-001,1007,391,0,391,0,4,387
16-143-002,1230,272,0,272,0,5,267
16-144-001,697,249,1,248,-1,4,244
16-144-002,704,258,0,258,0,4,254
16-145-001,372,134,0,134,0,1,133
16-146-001,629,199,0,199,0,1,198
16-146-002,553,187,0,187,0,4,183
16-147-001,491,226,0,226,0,2,224
16-148-001,768,258,0,258,0,2,256
16-148-002,768,218,0,218,0,2,216
16-149-001,683,240,1,240,0,1,239
16-150-001,929,390,0,390,0,8,382
16-151-001,743,307,0,307,0,2,305
16-151-002,937,333,0,333,0,2,331
16-151-003,639,248,0,248,0,1,247
16-152-001,552,216,0,216,0,3,213
16-153-001,775,365,0,365,0,3,362
16-154-001,640,280,0,280,0,3,277
16-155-001,753,275,0,275,0,1,274
16-155-002,678,260,0,260,0,6,254
16-156-001,611,292,0,292,0,2,290
16-156-002,685,273,0,273,0,2,271
16-157-001,683,290,0,290,0,1,289
16-157-002,704,255,0,255,0,2,253
16-157-003,655,231,0,231,0,0,231
16-158-001,678,256,0,256,0,1,255
16-158-002,674,211,0,211,0,1,210
16-159-001,1138,511,0,511,0,9,502
16-160-001,665,248,0,248,0,2,246
16-160-002,865,289,0,289,0,0,289
16-160-003,749,186,0,186,0,0,186
16-160-004,651,239,0,239,0,4,235
16-160-005,826,252,0,252,0,0,252
16-161-001,1167,374,0,374,0,3,371
16-162-001,112,38,0,38,0,1,37
16-163-001,841,226,0,226,0,2,224
16-164-001,1003,502,2,502,0,9,493
16-165-001,566,182,0,182,0,2,180
16-166-001,1156,373,0,373,0,2,371
16-167-001,680,308,0,308,0,5,303
16-168-001,286,143,0,143,0,2,141
16-169-001,939,257,0,257,0,1,256
16-170-001,581,183,0,183,0,2,181
16-170-002,635,172,0,172,0,5,167
16-171-001,817,215,0,215,0,1,214
16-171-002,638,181,0,181,0,2,179
16-171-003,684,146,0,146,0,1,145
16-172-001,423,165,0,165,0,2,163
16-173-001,337,135,0,135,0,1,134
16-174-001,348,135,0,135,0,0,135
16-175-001,585,206,0,206,0,5,201
16-176-001,639,321,0,321,0,0,321
16-176-002,835,318,1,317,-1,3,314
16-177-001,242,125,0,125,0,1,124
16-178-001,332,156,0,156,0,3,153
16-179-001,606,264,0,264,0,0,264
16-179-002,607,240,0,240,0,3,237
16-180-001,795,201,0,201,0,4,197
16-181-001,998,339,0,339,0,9,330
16-181-002,1030,484,0,484,0,5,479
16-182-001,287,187,0,187,0,0,187
16-183-001,564,185,0,185,0,4,181
16-184-001,832,312,0,312,0,0,312
16-185-001,994,281,0,281,0,7,274
16-186-001,515,303,0,303,0,3,300
16-187-001,1204,393,0,393,0,8,385
16-188-001,726,252,0,252,0,3,249
16-188-002,678,270,0,270,0,1,269
16-189-001,758,194,0,194,0,2,192
16-189-002,751,197,0,197,0,3,194
16-190-001,207,116,0,116,0,2,114
16-191-001,599,191,0,191,0,3,188
16-191-002,533,264,0,264,0,1,263
16-191-003,567,210,0,210,0,1,209
16-192-001,532,186,0,186,0,1,185
16-192-002,683,217,0,217,0,1,216
16-192-003,724,198,0,198,0,0,198
16-192-004,116,51,0,51,0,1,50
16-193-001,732,242,0,242,0,3,239
16-193-002,692,154,0,154,0,0,154
16-193-003,406,141,0,141,0,0,141
16-193-004,105,52,0,52,0,0,52
16-194-001,590,301,0,301,0,4,297
16-194-002,651,269,0,269,0,0,269
16-195-001,758,248,0,248,0,2,246
16-196-001,644,266,0,266,0,8,258
16-197-001,961,363,0,363,0,3,360
16-197-002,1023,323,0,322,-1,0,322
16-197-003,862,301,0,300,-1,7,293
16-197-004,920,328,0,328,0,3,325
16-197-005,325,55,0,55,0,2,53
16-197-006,188,97,0,97,0,4,93
16-198-001,517,234,0,234,0,0,234
16-199-001,603,172,0,172,0,0,172
16-199-002,624,212,0,212,0,1,211
16-199-003,292,99,0,99,0,2,97
16-200-001,419,89,0,89,0,1,88
16-201-001,821,329,0,329,0,1,328
16-202-001,951,293,0,293,0,3,290
16-203-001,617,197,0,197,0,0,197
16-203-002,518,167,0,167,0,2,165
16-204-001,755,125,0,125,0,0,125
16-204-002,708,168,0,168,0,1,167
16-204-003,994,377,0,377,0,1,376
16-204-004,1201,317,0,317,0,0,317
16-204-005,686,220,0,220,0,1,219
16-204-006,714,225,0,225,0,0,225
16-204-007,1075,387,0,387,0,0,387
16-204-008,1183,402,0,402,0,2,400
16-204-009,1094,393,0,393,0,1,392
16-204-010,1279,260,0,260,0,11,249
16-205-001,408,140,0,140,0,1,139
16-206-001,515,239,0,239,0,0,239
16-207-001,170,87,0,87,0,0,87
16-208-001,628,215,0,215,0,4,211
16-208-002,655,205,0,205,0,0,205
16-208-003,775,175,0,175,0,2,173
16-209-001,721,316,1,315,-1,0,315
16-209-002,644,225,0,225,0,2,223
16-209-003,612,175,0,175,0,1,174
16-210-001,914,305,0,305,0,1,304
16-210-002,808,274,0,274,0,1,273
16-210-003,818,241,0,241,0,2,239
16-211-001,573,286,0,286,0,8,278
16-212-001,538,253,1,251,-2,1,250
16-213-001,511,172,0,172,0,2,170
16-213-002,565,179,0,179,0,0,179
16-213-003,503,124,0,124,0,1,123
16-214-001,516,261,0,261,0,0,261
16-215-001,388,175,0,175,0,1,174
16-216-001,535,154,0,154,0,1,153
16-217-001,1202,470,0,470,0,2,468
16-217-002,1419,459,0,459,0,1,458
16-217-003,1172,344,0,344,0,0,344
16-217-004,1413,419,0,419,0,2,417
16-217-005,1357,316,0,316,0,1,315
16-217-006,1063,309,0,309,0,2,307
16-217-007,1157,384,0,384,0,1,383
16-217-008,1307,324,0,324,0,3,321
16-218-001,784,224,0,224,0,2,222
16-219-001,1012,270,0,270,0,5,265
16-219-002,1039,373,0,373,0,4,369
16-219-003,809,308,0,308,0,2,306
16-220-001,613,145,0,145,0,0,145
16-220-002,669,159,0,159,0,1,158
16-221-001,1013,404,0,404,0,2,402
16-222-001,474,154,0,154,0,3,151
16-223-001,460,279,0,279,0,6,273
16-224-001,741,290,0,290,0,1,289
16-224-002,977,376,0,376,0,3,373
16-224-003,1134,548,0,548,0,0,548
16-224-004,952,285,0,285,0,2,283
16-224-005,683,315,0,315,0,4,311
16-224-006,580,243,0,243,0,4,239
16-224-007,828,352,0,352,0,2,350
16-224-008,1075,374,0,374,0,1,373
16-224-009,188,89,0,89,0,1,88
16-225-001,348,139,0,139,0,1,138
16-226-001,974,415,0,415,0,2,413
16-226-002,1029,413,0,413,0,12,401
16-226-003,808,360,0,360,0,8,352
16-226-004,860,371,0,371,0,8,363
16-227-001,347,135,0,135,0,1,134
16-228-001,582,261,0,261,0,8,253
16-229-001,797,276,0,276,0,4,272
17-001-001,575,248,0,248,0,2,246
17-002-001,575,203,0,203,0,0,203
17-003-001,369,163,0,163,0,0,163
17-003-002,478,235,0,235,0,0,235
17-004-001,648,247,0,247,0,1,246
17-005-001,638,277,1,276,-1,3,273
17-005-002,644,225,0,225,0,8,217
17-006-001,330,99,0,99,0,0,99
17-007-001,1066,402,0,402,0,3,399
17-007-002,967,420,0,420,0,3,417
17-007-003,1050,450,0,450,0,5,445
17-007-004,1101,357,0,357,0,0,357
17-007-005,1076,402,1,400,-2,11,389
17-008-001,214,108,0,108,0,2,106
17-009-001,373,148,0,148,0,1,147
17-010-001,886,297,0,297,0,2,295
17-010-002,855,296,0,296,0,2,294
17-011-001,726,348,0,348,0,1,347
17-011-002,683,315,0,315,0,2,313
17-011-003,646,284,0,284,0,2,282
17-011-004,650,296,1,296,0,0,296
17-011-005,652,337,0,337,0,2,335
17-011-006,669,319,0,319,0,1,318
17-011-007,684,304,0,304,0,0,304
17-011-008,714,338,0,338,0,0,338
17-011-009,656,288,0,288,0,2,286
17-011-010,663,332,0,332,0,1,331
17-011-011,680,333,0,333,0,0,333
17-011-012,665,331,0,331,0,1,330
17-011-013,666,311,0,311,0,1,310
17-011-014,632,324,0,323,-1,7,316
17-011-015,929,418,0,417,-1,2,415
17-011-016,271,92,0,92,0,0,92
17-011-017,117,65,0,65,0,0,65
17-012-001,376,202,0,202,0,0,202
17-013-001,773,300,0,300,0,0,300
17-013-002,718,275,0,275,0,1,274
17-013-003,700,244,1,243,-1,1,242
17-014-001,745,257,0,257,0,0,257
17-015-001,240,81,0,81,0,0,81
17-016-001,658,240,0,240,0,1,239
17-017-001,864,313,0,312,-1,2,310
17-017-002,142,60,0,60,0,0,60
17-018-001,864,268,0,268,0,4,264
17-018-002,794,224,0,224,0,2,222
17-018-003,852,235,0,235,0,0,235
17-018-004,776,267,0,267,0,4,263
17-019-001,276,116,0,116,0,0,116
17-020-001,734,250,0,250,0,0,250
17-020-002,864,339,0,339,0,0,339
17-020-003,825,323,0,323,0,1,322
17-020-004,954,322,0,322,0,0,322
17-020-005,685,330,1,329,-1,0,329
17-020-006,550,211,0,211,0,2,209
17-020-007,579,268,0,268,0,1,267
17-020-008,826,393,0,393,0,2,391
17-020-009,807,340,0,340,0,2,338
17-020-010,907,424,0,424,0,2,422
17-020-011,743,305,0,305,0,0,305
17-020-012,611,227,0,227,0,0,227
17-020-013,690,300,0,299,-1,1,298
17-020-014,622,271,0,271,0,1,270
17-020-015,711,302,0,302,0,1,301
17-020-016,749,337,0,337,0,2,335
17-020-017,692,307,0,307,0,1,306
17-020-018,650,269,0,269,0,1,268
17-020-019,721,276,2,274,-2,0,274
17-020-020,596,211,0,211,0,7,204
17-020-021,199,37,0,37,0,0,37
17-020-022,611,234,0,234,0,0,234
17-021-001,563,194,0,194,0,1,193
17-021-002,486,126,0,126,0,0,126
17-021-003,509,143,0,143,0,1,142
17-022-001,1081,450,0,449,-1,1,448
17-022-002,1069,535,0,535,0,0,535
17-022-003,795,301,0,301,0,0,301
17-022-004,770,244,0,244,0,0,244
17-022-005,846,308,0,308,0,6,302
17-022-006,1189,424,0,424,0,2,422
17-022-007,1123,406,0,406,0,0,406
17-023-001,647,276,0,276,0,3,273
17-023-002,785,309,0,309,0,2,307
17-023-003,626,246,0,246,0,2,244
17-024-001,197,85,0,85,0,0,85
17-025-001,512,161,0,161,0,3,158
17-026-001,836,220,0,220,0,6,214
17-026-002,812,199,0,199,0,0,199
17-026-003,889,359,0,359,0,5,354
17-026-004,780,319,0,319,0,0,319
17-027-001,554,170,0,170,0,1,169
17-028-001,493,178,0,178,0,0,178
17-029-001,829,359,0,359,0,1,358
17-030-001,511,107,0,107,0,0,107
17-031-001,1014,356,0,356,0,2,354
17-032-001,134,73,0,73,0,0,73
17-033-001,751,327,0,327,0,0,327
17-033-002,734,311,0,311,0,0,311
17-034-001,556,205,0,205,0,1,204
17-035-001,806,307,0,307,0,1,306
17-036-001,642,186,0,186,0,0,186
17-037-001,697,257,1,256,-1,2,254
17-038-001,790,338,0,338,0,0,338
17-038-002,714,251,0,251,0,2,249
17-038-003,769,197,0,197,0,0,197
17-039-001,681,218,0,218,0,0,218
17-039-002,754,244,0,244,0,1,243
17-039-003,643,208,0,208,0,2,206
17-040-001,379,142,0,142,0,0,142
17-041-001,198,67,0,67,0,0,67
17-042-001,929,304,0,304,0,3,301
17-043-001,707,314,0,314,0,0,314
17-043-002,686,316,0,316,0,0,316
17-044-001,109,50,0,50,0,2,48
17-045-001,530,241,0,241,0,0,241
17-045-002,152,61,0,61,0,0,61
17-046-001,932,311,0,311,0,1,310
17-046-002,295,108,0,108,0,1,107
17-047-001,173,96,0,96,0,1,95
17-048-001,574,243,0,243,0,1,242
17-049-001,629,237,1,236,-1,1,235
17-050-001,279,116,0,116,0,0,116
17-051-001,244,132,0,132,0,1,131
17-052-001,276,113,0,113,0,2,111
17-053-001,291,90,0,90,0,0,90
17-054-001,933,201,0,201,0,2,199
17-055-001,251,100,0,100,0,0,100
17-056-001,559,148,0,148,0,1,147
17-056-002,552,155,0,155,0,1,154
17-056-003,81,25,0,25,0,0,25
17-057-001,911,254,0,254,0,1,253
17-058-001,120,51,0,51,0,0,51
17-059-001,408,189,0,189,0,2,187
17-060-001,482,211,0,211,0,1,210
17-060-002,631,283,0,283,0,1,282
17-060-003,443,210,0,210,0,0,210
17-061-001,839,192,0,192,0,2,190
17-062-001,534,192,0,192,0,1,191
17-062-002,92,28,0,28,0,0,28
17-063-001,237,120,0,120,0,1,119
17-064-001,499,182,0,182,0,3,179
17-064-002,82,29,0,29,0,0,29
17-065-001,281,112,0,112,0,0,112
17-066-001,299,146,0,146,0,0,146
17-067-001,345,107,0,107,0,1,106
17-068-001,47,24,0,24,0,1,23
17-069-001,663,239,0,239,0,1,238
17-069-002,702,252,0,252,0,1,251
17-069-003,750,230,0,230,0,0,230
17-070-001,56,20,0,20,0,0,20
17-070-002,788,275,0,275,0,2,273
17-071-001,909,375,0,375,0,4,371
17-071-002,988,465,0,465,0,6,459
17-072-001,314,144,0,144,0,0,144
17-073-001,668,228,0,228,0,2,226
17-074-001,118,47,0,47,0,0,47
17-075-001,431,137,0,137,0,0,137
17-076-001,718,259,0,259,0,1,258
17-076-002,691,258,0,258,0,2,256
17-077-001,650,229,0,229,0,0,229
17-077-002,590,204,0,204,0,0,204
17-078-001,792,351,0,351,0,0,351
17-078-002,595,183,0,183,0,0,183
17-078-003,586,157,0,157,0,1,156
17-079-001,846,471,0,471,0,5,466
17-079-002,1068,451,0,451,0,3,448
17-079-003,967,474,0,474,0,1,473
17-079-004,1184,592,0,592,0,0,592
17-079-005,1017,477,0,477,0,2,475
17-079-006,955,403,0,403,0,2,401
17-079-007,1048,508,0,508,0,1,507
17-079-008,1059,560,0,560,0,1,559
17-079-009,897,359,0,359,0,0,359
17-079-010,944,332,0,332,0,2,330
17-079-011,963,420,0,420,0,0,420
17-079-012,848,400,0,400,0,0,400
17-079-013,986,468,0,468,0,0,468
17-079-014,917,339,0,339,0,1,338
17-079-015,950,324,0,324,0,4,320
17-079-016,275,88,0,88,0,1,87
17-079-017,309,89,0,89,0,0,89
17-080-001,623,197,0,197,0,3,194
17-080-002,444,154,0,154,0,1,153
17-080-003,66,31,0,31,0,2,29
17-081-001,1045,418,0,418,0,0,418
17-081-002,748,281,0,281,0,4,277
17-082-001,445,168,0,168,0,0,168
17-083-001,804,224,0,224,0,0,224
17-084-001,875,360,0,360,0,3,357
17-085-001,445,118,0,118,0,2,116
17-086-001,570,207,0,207,0,1,206
17-086-002,194,76,0,76,0,0,76
17-086-003,69,27,0,27,0,0,27
17-087-001,1054,295,0,295,0,1,294
17-087-002,1102,378,0,378,0,0,378
17-087-003,1122,340,0,340,0,1,339
17-088-001,511,303,0,303,0,2,301
17-088-002,527,263,0,263,0,0,263
17-089-001,184,94,0,94,0,0,94
17-090-001,612,246,0,246,0,14,232
17-090-002,428,127,0,127,0,1,126
17-091-001,682,206,0,206,0,1,205
17-092-001,535,265,0,265,0,2,263
17-093-001,191,114,0,114,0,1,113
17-094-001,590,226,0,226,0,1,225
17-094-002,633,239,0,239,0,3,236
17-094-003,607,177,0,177,0,1,176
17-095-001,1079,409,0,409,0,2,407
17-095-002,699,347,0,346,-1,1,345
17-095-003,737,290,0,290,0,2,288
17-095-004,751,355,0,355,0,2,353
17-095-005,325,72,0,72,0,0,72
17-095-006,582,306,0,306,0,3,303
17-095-007,589,276,0,276,0,0,276
17-095-008,645,329,0,329,0,0,329
17-095-009,463,276,0,276,0,4,272
17-095-010,747,375,0,375,0,4,371
17-095-011,1090,544,0,544,0,0,544
17-095-012,692,333,0,333,0,0,333
17-095-013,515,224,0,224,0,0,224
17-095-014,465,205,0,205,0,1,204
17-095-015,557,276,2,274,-2,3,271
17-095-016,501,240,0,239,-1,1,238
17-095-017,571,235,1,235,0,1,234
17-095-018,613,325,1,324,-1,2,322
17-095-019,980,545,0,545,0,2,543
17-095-020,794,345,0,345,0,2,343
17-095-021,559,350,1,349,-1,4,345
17-095-022,530,281,0,281,0,3,278
17-095-023,576,298,0,298,0,1,297
17-095-024,513,280,0,280,0,0,280
17-095-025,521,289,0,289,0,5,284
17-095-026,655,323,0,323,0,3,320
17-095-027,611,261,0,261,0,5,256
17-095-028,611,250,0,250,0,5,245
17-095-029,670,258,0,258,0,1,257
17-095-030,831,285,0,285,0,2,283
17-095-031,624,283,0,282,-1,1,281
17-095-032,719,291,0,291,0,0,291
17-095-033,657,295,0,295,0,1,294
17-095-034,763,372,0,372,0,1,371
17-095-035,688,310,0,311,1,9,302
17-095-036,828,402,0,402,0,3,399
17-095-037,916,404,0,404,0,0,404
17-095-038,894,457,0,457,0,2,455
17-095-039,959,437,0,437,0,2,435
17-096-001,242,75,0,75,0,0,75
17-096-002,920,419,0,419,0,4,415
17-096-003,898,314,0,314,0,12,302
17-096-004,891,400,0,400,0,3,397
17-096-005,1021,432,0,432,0,3,429
17-096-006,789,344,0,344,0,2,342
17-096-007,275,71,0,71,0,0,71
17-096-008,952,527,0,526,-1,2,524
17-096-009,603,205,0,205,0,0,205
17-097-001,659,259,0,259,0,1,258
17-097-002,298,84,0,84,0,1,83
17-097-003,219,42,0,42,0,0,42
17-097-004,625,216,0,216,0,3,213
17-098-001,571,209,0,209,0,1,208
17-098-002,556,203,0,203,0,0,203
17-099-001,1185,386,0,386,0,3,383
17-099-002,661,258,0,258,0,2,256
17-099-003,590,227,0,227,0,1,226
17-099-004,1012,384,0,384,0,1,383
17-099-005,701,292,0,292,0,1,291
17-099-006,625,264,0,264,0,2,262
17-099-007,719,223,0,223,0,3,220
17-099-008,599,226,0,226,0,1,225
17-099-009,583,260,0,260,0,2,258
17-099-010,614,262,0,262,0,4,258
17-099-011,899,398,0,398,0,2,396
17-099-012,608,183,0,183,0,0,183
17-099-013,589,201,0,201,0,0,201
17-100-001,845,291,0,291,0,3,288
17-101-001,268,100,0,100,0,0,100
17-102-001,220,93,0,93,0,1,92
17-103-001,290,137,0,137,0,1,136
17-104-001,661,254,0,254,0,1,253
17-105-001,979,425,0,425,0,2,423
17-106-001,118,53,0,53,0,0,53
17-107-001,226,130,0,130,0,0,130
17-108-001,632,287,0,286,-1,1,285
17-108-002,478,192,0,192,0,0,192
17-108-003,494,226,0,226,0,2,224
17-108-004,93,50,0,50,0,0,50
17-109-001,500,192,0,192,0,0,192
18-001-001,517,244,0,244,0,2,242
18-002-001,296,150,0,150,0,0,150
18-003-001,456,237,0,237,0,1,236
18-004-001,192,89,0,89,0,0,89
18-005-001,338,183,0,183,0,0,183
18-006-001,393,241,0,241,0,0,241
18-007-001,970,447,0,447,0,2,445
18-008-001,371,185,0,185,0,2,183
18-009-001,399,123,0,123,0,0,123
18-010-001,696,343,0,343,0,2,341
18-011-001,135,79,0,79,0,0,79
18-012-001,308,197,0,197,0,1,196
18-013-001,248,132,0,132,0,4,128
18-014-001,315,178,0,178,0,0,178
18-015-001,253,124,0,124,0,0,124
18-016-001,559,300,0,300,0,3,297
18-017-001,478,302,0,302,0,3,299
18-018-001,899,365,0,365,0,2,363
18-018-002,1006,498,0,498,0,0,498
18-018-003,976,441,0,441,0,3,438
18-019-001,230,136,0,136,0,0,136
18-020-001,1087,497,0,497,0,3,494
18-020-002,1000,536,0,536,0,4,532
18-020-003,1043,471,0,471,0,1,470
18-020-004,1030,506,0,506,0,1,505
18-020-005,1038,510,0,510,0,4,506
18-020-006,1079,449,0,449,0,2,447
18-020-007,913,334,1,333,-1,1,332
18-020-008,1171,465,0,465,0,2,463
18-020-009,283,144,0,144,0,0,144
18-021-001,147,74,0,74,0,0,74
18-022-001,503,249,0,249,0,2,247
18-022-002,719,327,0,327,0,3,324
18-023-001,288,161,0,161,0,1,160
18-024-001,208,101,0,101,0,1,100
18-025-001,290,140,0,140,0,1,139
18-026-001,276,144,0,144,0,2,142
18-027-001,1007,471,0,471,0,2,469
18-027-002,894,424,0,424,0,1,423
18-027-003,750,389,0,389,0,5,384
18-028-001,545,252,0,252,0,2,250
18-029-001,274,156,0,156,0,0,156
18-030-001,313,136,0,136,0,2,134
18-031-001,714,285,0,285,0,1,284
18-032-001,79,42,0,42,0,0,42
18-033-001,200,135,0,135,0,2,133
18-034-001,117,69,0,69,0,1,68
18-035-001,84,60,0,60,0,0,60
18-036-001,215,102,0,102,0,2,100
18-037-001,280,110,0,110,0,1,109
18-038-001,282,135,0,135,0,0,135
18-039-001,460,220,0,220,0,4,216
18-040-001,1072,592,0,590,-2,4,586
18-041-001,374,184,0,184,0,0,184
18-042-001,166,111,0,111,0,0,111
18-043-001,220,119,0,119,0,3,116
18-044-001,479,222,0,222,0,2,220
18-045-001,353,166,0,166,0,1,165
18-046-001,1050,582,0,582,0,3,579
18-046-002,1091,570,0,570,0,1,569
18-047-001,560,246,0,246,0,2,244
18-048-001,931,328,0,328,0,2,326
18-049-001,218,132,0,132,0,0,132
18-050-001,119,63,0,63,0,0,63
18-051-001,883,449,0,448,-1,3,445
18-052-001,531,234,0,234,0,0,234
18-053-001,73,43,0,43,0,1,42
18-054-001,217,125,0,125,0,1,124
18-055-001,128,63,0,63,0,0,63
18-056-001,641,315,1,314,-1,2,312
18-057-001,131,86,0,86,0,0,86
18-058-001,123,74,0,74,0,0,74
18-059-001,238,128,0,128,0,3,125
18-060-001,53,43,0,43,0,0,43
18-061-001,125,77,0,77,0,2,75
18-062-001,156,102,0,102,0,0,102
18-063-001,670,330,0,330,0,0,330
18-064-001,564,236,0,236,0,0,236
18-065-001,751,328,0,328,0,1,327
18-065-002,690,285,0,285,0,0,285
18-066-001,39,20,0,20,0,0,20
18-067-001,100,69,0,69,0,0,69
18-068-001,407,201,0,201,0,3,198
18-069-001,1110,401,0,401,0,0,401
18-069-002,934,364,0,364,0,9,355
18-070-001,403,181,0,181,0,2,179
18-071-001,696,252,0,252,0,1,251
18-071-002,633,245,0,245,0,3,242
18-071-003,736,224,1,223,-1,1,222
18-072-001,168,56,0,56,0,0,56
18-073-001,275,155,0,155,0,0,155
18-074-001,858,361,0,361,0,4,357
18-075-001,395,179,0,179,0,0,179
18-076-001,65,32,0,32,0,0,32
18-077-001,77,45,0,45,0,1,44
18-078-001,713,312,0,312,0,0,312
18-079-001,433,182,0,182,0,4,178
18-080-001,333,123,0,123,0,0,123
18-081-001,473,177,0,177,0,0,177
18-082-001,170,72,0,72,0,0,72
18-083-001,184,108,0,108,0,0,108
18-084-001,220,99,0,99,0,1,98
18-085-001,689,360,0,360,0,1,359
18-086-001,200,116,0,116,0,2,114
18-087-001,55,39,0,39,0,0,39
18-088-001,112,65,0,65,0,0,65
18-089-001,160,100,0,100,0,0,100
18-090-001,197,72,0,72,0,0,72
18-091-001,362,176,0,176,0,1,175
18-092-001,68,42,0,42,0,0,42
18-093-001,423,219,0,219,0,3,216
18-094-001,215,100,0,100,0,1,99
18-095-001,1028,553,0,553,0,0,553
18-095-002,1081,481,0,480,-1,1,479
18-095-003,1130,579,0,577,-2,2,575
18-095-004,1208,623,0,621,-2,4,617
18-095-005,1268,602,0,602,0,2,600
18-095-006,1187,618,0,618,0,3,615
18-095-007,1137,555,0,555,0,1,554
18-095-008,367,173,0,173,0,1,172
18-095-009,695,378,0,378,0,0,378
18-095-010,148,97,0,97,0,0,97
18-096-001,1130,539,0,539,0,1,538
18-096-002,1310,694,0,693,-1,4,689
18-096-003,1072,492,0,492,0,3,489
18-096-004,1128,495,0,495,0,3,492
18-096-005,1093,525,0,525,0,1,524
18-096-006,1408,744,0,743,-1,4,739
18-096-007,1053,472,0,472,0,0,472
18-096-008,695,331,0,331,0,3,328
18-096-009,421,249,0,249,0,1,248
18-097-001,207,118,0,118,0,2,116
18-098-001,153,72,0,72,0,0,72
18-099-001,406,216,0,216,0,2,214
18-100-001,89,52,0,52,0,0,52
18-101-001,888,453,0,453,0,3,450
18-102-001,657,328,0,328,0,0,328
18-103-001,184,107,0,107,0,0,107
18-104-001,364,195,0,195,0,4,191
18-105-001,222,123,0,123,0,1,122
18-106-001,549,208,0,208,0,1,207
18-107-001,259,129,0,129,0,0,129
18-108-001,477,229,0,229,0,2,227
18-109-001,136,69,0,69,0,0,69
18-110-001,178,92,0,92,0,1,91
18-111-001,181,113,0,113,0,4,109
18-112-001,244,98,0,98,0,1,97
18-113-001,334,181,0,181,0,1,180
18-114-001,222,111,0,111,0,1,110
18-115-001,117,61,0,61,0,0,61
18-116-001,96,73,0,73,0,0,73
18-117-001,221,111,0,111,0,0,111
18-118-001,810,376,0,376,0,1,375
18-119-001,103,33,0,33,0,0,33
18-120-001,407,265,0,265,0,1,264
18-121-001,1071,505,0,505,0,5,500
18-122-001,1098,517,0,517,0,2,515
18-123-001,520,244,0,244,0,2,242
18-124-001,244,144,0,144,0,2,142
18-125-001,237,104,0,104,0,0,104
18-126-001,262,128,0,128,0,0,128
18-127-001,300,132,0,132,0,1,131
18-128-001,110,62,0,62,0,0,62
18-129-001,24,14,0,14,0,0,14
18-130-001,228,100,0,100,0,2,98
18-131-001,441,235,0,235,0,1,234
18-132-001,270,144,0,144,0,2,142
18-133-001,321,144,0,144,0,0,144
18-134-001,70,44,0,44,0,0,44
18-135-001,649,298,0,298,0,1,297
18-136-001,539,222,0,222,0,1,221
18-137-001,88,50,0,50,0,0,50
18-138-001,587,235,0,235,0,0,235
18-139-001,197,126,0,126,0,0,126
18-140-001,977,525,0,525,0,1,524
18-141-001,360,162,0,162,0,0,162
18-142-001,244,116,0,116,0,2,114
18-143-001,239,147,0,147,0,1,146
18-144-001,650,298,0,298,0,1,297
18-145-001,559,309,0,309,0,1,308
18-146-001,432,250,0,250,0,4,246
18-147-001,176,100,0,100,0,3,97
18-148-001,145,83,0,83,0,3,80
18-149-001,277,172,0,172,0,3,169
18-150-001,115,62,0,62,0,2,60
18-151-001,225,126,0,126,0,1,125
18-152-001,128,74,0,74,0,2,72
18-153-001,717,381,0,381,0,5,376
18-154-001,640,300,0,300,0,4,296
18-155-001,779,269,0,269,0,1,268
18-156-001,721,265,0,265,0,1,264
18-156-002,646,250,0,250,0,0,250
18-157-001,196,100,0,100,0,0,100
18-158-001,226,130,0,130,0,0,130
18-159-001,187,85,0,85,0,1,84
18-160-001,648,332,0,332,0,0,332
18-160-002,873,430,0,430,0,2,428
18-160-003,654,319,0,319,0,2,317
18-161-001,97,59,0,59,0,1,58
18-162-001,339,130,0,130,0,0,130
18-163-001,924,365,0,365,0,2,363
18-164-001,244,130,0,130,0,0,130
18-165-001,387,200,0,200,0,0,200
18-166-001,81,55,0,55,0,0,55
18-167-001,828,384,0,384,0,3,381
18-167-002,539,198,0,198,0,0,198
18-167-003,601,286,0,286,0,4,282
18-167-004,669,300,0,300,0,1,299
18-167-005,45,27,0,27,0,0,27
18-167-006,678,344,0,344,0,0,344
18-167-007,653,345,0,345,0,0,345
18-167-008,833,418,0,417,-1,0,417
18-167-009,676,313,0,313,0,1,312
18-167-010,891,441,0,441,0,3,438
18-167-011,620,284,0,284,0,1,283
18-167-012,702,342,0,342,0,2,340
18-167-013,776,347,0,347,0,2,345
18-167-014,910,522,0,522,0,1,521
18-167-015,826,340,0,340,0,1,339
18-167-016,1061,523,1,522,-1,5,517
18-167-017,510,226,0,226,0,2,224
18-167-018,101,55,0,55,0,0,55
18-168-001,1102,531,0,531,0,1,530
18-169-001,431,220,0,220,0,4,216
18-170-001,569,276,0,276,0,3,273
18-171-001,313,134,0,134,0,1,133
18-171-002,135,69,0,69,0,1,68
18-171-003,87,39,0,39,0,0,39
18-172-001,204,99,0,99,0,1,98
18-173-001,662,295,0,295,0,0,295
18-174-001,513,249,0,249,0,1,248
18-175-001,651,302,0,302,0,4,298
18-176-001,49,42,0,42,0,0,42
18-177-001,298,157,0,157,0,1,156
18-178-001,182,101,0,101,0,1,100
18-179-001,195,124,0,124,0,0,124
18-180-001,59,42,0,42,0,0,42
18-181-001,527,247,0,247,0,1,246
18-182-001,274,91,0,91,0,1,90
18-183-001,622,222,0,222,0,2,220
18-183-002,680,304,0,304,0,2,302
18-183-003,719,339,0,339,0,2,337
18-183-004,778,461,0,461,0,1,460
18-183-005,699,369,0,369,0,1,368
18-183-006,649,319,0,319,0,1,318
18-183-007,635,322,0,322,0,0,322
18-183-008,377,169,0,169,0,0,169
18-183-009,682,386,0,386,0,4,382
18-183-010,217,120,0,120,0,0,120
18-183-011,307,153,0,153,0,1,152
18-183-012,283,148,0,148,0,0,148
18-183-013,58,41,0,41,0,0,41
18-184-001,838,471,0,471,0,1,470
18-185-001,246,106,0,106,0,0,106
18-186-001,864,525,0,525,0,0,525
18-186-002,906,514,0,514,0,1,513
18-186-003,893,510,0,510,0,2,508
18-186-004,871,514,0,514,0,2,512
18-186-005,1058,554,0,554,0,0,554
18-186-006,1020,496,0,496,0,5,491
18-186-007,1008,588,0,585,-3,0,585
18-186-008,874,418,0,418,0,5,413
18-186-009,687,327,0,327,0,4,323
18-186-010,735,298,0,299,1,12,287
18-186-011,844,423,0,423,0,0,423
18-186-012,942,426,0,426,0,1,425
18-186-013,876,422,0,422,0,0,422
18-186-014,855,332,0,332,0,3,329
18-186-015,848,382,0,382,0,2,380
18-186-016,776,366,0,366,0,3,363
18-186-017,785,386,0,386,0,0,386
18-186-018,867,383,0,383,0,1,382
18-186-019,866,371,1,370,-1,2,368
18-186-020,843,397,0,397,0,2,395
18-186-021,908,398,0,398,0,0,398
18-186-022,820,345,0,344,-1,0,344
18-186-023,875,443,0,443,0,2,441
18-186-024,809,383,0,383,0,0,383
18-186-025,781,365,0,365,0,1,364
18-186-026,991,476,0,476,0,0,476
18-186-027,830,470,2,468,-2,1,467
18-186-028,714,329,0,328,-1,2,326
18-186-029,768,423,0,423,0,1,422
18-186-030,1030,569,0,569,0,1,568
18-186-031,716,284,1,283,-1,0,283
18-186-032,711,306,0,306,0,2,304
18-186-033,983,444,0,444,0,4,440
18-186-034,881,442,0,442,0,0,442
18-186-035,1009,550,0,549,-1,1,548
18-186-036,933,474,0,474,0,4,470
18-186-037,680,406,0,406,0,3,403
18-186-038,1015,509,0,509,0,3,506
18-186-039,915,420,0,420,0,2,418
18-186-040,1330,798,0,798,0,9,789
18-186-041,876,392,0,392,0,0,392
18-186-042,823,365,0,365,0,2,363
18-186-043,810,418,0,418,0,1,417
18-186-044,920,418,0,417,-1,0,417
18-186-045,952,528,0,528,0,2,526
18-186-046,825,400,0,400,0,1,399
18-186-047,1031,574,0,574,0,3,571
18-186-048,873,480,1,479,-1,0,479
18-186-049,903,350,0,350,0,0,350
18-186-050,874,424,0,422,-2,1,421
18-186-051,1165,631,0,631,0,5,626
18-186-052,1431,745,0,744,-1,0,744
18-186-053,986,553,0,553,0,1,552
18-186-054,999,566,0,566,0,0,566
18-186-055,1443,801,0,801,0,6,795
18-186-056,681,370,0,370,0,1,369
18-186-057,776,439,0,439,0,3,436
18-186-058,693,339,0,339,0,5,334
18-186-059,469,233,0,232,-1,0,232
18-186-060,690,392,0,392,0,1,391
18-186-061,998,560,0,560,0,3,557
18-186-062,981,480,0,480,0,2,478
18-186-063,787,409,0,409,0,5,404
18-186-064,942,472,0,472,0,3,469
18-186-065,603,339,0,339,0,1,338
18-186-066,1258,643,0,643,0,5,638
18-186-067,1312,711,0,711,0,1,710
18-186-068,1006,494,0,494,0,0,494
18-186-069,745,407,0,407,0,1,406
18-187-001,282,156,0,156,0,0,156
18-188-001,612,300,0,300,0,0,300
18-189-001,1064,483,0,483,0,5,478
18-189-002,987,454,0,454,0,1,453
18-190-001,413,172,0,172,0,1,171
18-191-001,276,144,0,144,0,2,142
18-192-001,252,130,0,130,0,1,129
18-193-001,268,135,0,135,0,1,134
18-194-001,834,375,0,375,0,2,373
18-194-002,734,203,0,203,0,0,203
18-195-001,238,138,0,138,0,2,136
18-196-001,410,169,0,169,0,0,169
18-196-002,301,119,0,119,0,0,119
18-197-001,283,134,0,134,0,1,133
18-198-001,311,175,0,175,0,3,172
18-199-001,309,177,0,177,0,0,177
18-200-001,312,158,0,158,0,3,155
18-201-001,277,201,0,201,0,0,201
18-202-001,658,308,0,308,0,0,308
18-203-001,285,143,0,143,0,0,143
18-204-001,477,188,0,188,0,0,188
18-204-002,645,298,0,298,0,1,297
18-205-001,342,163,0,163,0,1,162
18-206-001,628,318,0,318,0,0,318
18-206-002,613,273,0,273,0,0,273
18-206-003,669,243,0,243,0,2,241
18-206-004,691,344,0,344,0,0,344
18-206-005,703,352,0,352,0,0,352
18-206-006,87,43,0,43,0,1,42
18-206-007,60,37,0,37,0,0,37
18-207-001,254,158,0,158,0,0,158
18-208-001,283,160,0,160,0,2,158
18-209-001,565,222,0,222,0,3,219
18-210-001,330,190,0,190,0,0,190
18-211-001,67,50,0,50,0,0,50
18-212-001,739,215,0,215,0,0,215
18-212-002,656,273,0,273,0,0,273
18-212-003,696,324,0,324,0,2,322
18-212-004,611,291,0,291,0,0,291
18-213-001,225,126,0,126,0,0,126
18-214-001,610,294,0,294,0,2,292
18-215-001,85,55,0,55,0,0,55
18-216-001,166,83,0,83,0,0,83
19-001-001,676,298,0,298,0,4,294
19-002-001,308,109,0,109,0,3,106
19-003-001,942,409,0,409,0,2,407
19-003-002,917,416,0,416,0,0,416
19-003-003,715,357,1,357,0,1,356
19-003-004,1048,527,1,526,-1,1,525
19-003-005,732,304,0,304,0,1,303
19-003-006,871,324,0,324,0,0,324
19-003-007,610,251,0,251,0,0,251
19-003-008,871,394,0,393,-1,0,393
19-003-009,924,288,0,288,0,0,288
19-003-010,834,336,0,336,0,2,334
19-003-011,713,343,0,343,0,0,343
19-003-012,999,377,0,377,0,6,371
19-003-013,637,231,0,231,0,0,231
19-003-014,991,400,0,400,0,1,399
19-003-015,848,364,0,364,0,1,363
19-003-016,766,320,0,320,0,1,319
19-003-017,609,281,0,281,0,0,281
19-003-018,876,413,0,413,0,1,412
19-003-019,823,364,0,364,0,0,364
19-003-020,734,391,0,391,0,0,391
19-003-021,753,303,0,303,0,4,299
19-003-022,1005,419,0,418,-1,0,418
19-003-023,813,299,0,299,0,1,298
19-003-024,452,140,0,140,0,1,139
19-003-025,889,467,0,467,0,1,466
19-003-026,893,457,0,457,0,2,455
19-003-027,773,253,0,253,0,2,251
19-003-028,621,229,0,229,0,0,229
19-003-029,911,345,0,345,0,2,343
19-004-001,921,549,0,549,0,0,549
19-004-002,701,377,0,377,0,1,376
19-005-001,131,59,0,59,0,1,58
19-006-001,407,252,0,252,0,4,248
19-007-001,543,367,0,367,0,1,366
19-008-001,845,512,0,512,0,1,511
19-008-002,566,281,0,281,0,4,277
19-008-003,579,256,0,256,0,1,255
19-009-001,796,445,0,445,0,2,443
19-010-001,1018,465,0,464,-1,0,464
19-011-001,590,304,0,304,0,4,300
19-012-001,179,96,0,96,0,1,95
19-013-001,819,276,0,276,0,2,274
19-014-001,370,169,0,169,0,0,169
19-015-001,327,119,0,119,0,0,119
19-016-001,59,36,0,36,0,1,35
19-017-001,168,87,0,87,0,1,86
19-018-001,689,234,0,234,0,0,234
19-019-001,253,140,0,140,0,0,140
19-020-001,503,203,0,203,0,0,203
19-021-001,677,372,1,371,-1,1,370
19-022-001,945,488,0,488,0,2,486
19-022-002,888,496,0,496,0,2,494
19-022-003,998,566,0,566,0,4,562
19-022-004,1191,797,0,797,0,2,795
19-022-005,948,509,0,509,0,1,508
19-022-006,1064,446,0,446,0,2,444
19-022-007,1071,512,0,511,-1,1,510
19-022-008,996,555,0,555,0,2,553
19-023-001,200,94,0,94,0,0,94
19-024-001,882,418,0,418,0,2,416
19-025-001,1127,450,0,450,0,7,443
19-026-001,1285,609,0,609,0,3,606
19-026-002,1271,512,0,512,0,4,508
19-026-003,1393,557,0,557,0,1,556
19-026-004,1366,552,0,552,0,0,552
19-026-005,2302,1509,0,1509,0,2,1507
19-026-006,1314,634,0,634,0,2,632
19-026-007,1386,727,0,727,0,0,727
19-026-008,1387,723,0,723,0,1,722
19-027-001,906,497,0,497,0,2,495
19-027-002,756,378,0,378,0,0,378
19-027-003,670,308,0,308,0,1,307
19-027-004,748,292,0,292,0,1,291
19-027-005,705,389,0,389,0,0,389
19-028-001,110,61,0,61,0,0,61
19-029-001,786,384,0,384,0,3,381
19-029-002,721,335,0,335,0,3,332
19-029-003,904,546,0,546,0,0,546
19-030-001,175,121,0,121,0,0,121
19-031-001,464,272,0,272,0,8,264
19-032-001,527,236,0,236,0,1,235
19-033-001,372,239,0,239,0,3,236
19-035-001,114,77,0,77,0,0,77
19-036-001,355,106,0,106,0,0,106
19-037-001,546,298,0,298,0,2,296
19-038-001,793,226,0,226,0,0,226
19-038-002,816,210,0,210,0,2,208
19-038-003,839,186,0,186,0,0,186
19-038-004,935,274,0,274,0,2,272
19-038-005,629,206,0,206,0,3,203
19-038-006,596,229,0,229,0,0,229
19-039-001,199,120,0,120,0,2,118
19-040-001,165,74,0,74,0,0,74
19-041-001,86,49,0,49,0,0,49
19-042-001,281,133,0,133,0,0,133
19-043-001,606,235,0,235,0,1,234
19-044-001,666,299,0,299,0,0,299
19-044-002,642,217,0,217,0,3,214
19-044-003,712,238,0,238,0,0,238
19-044-004,281,60,0,60,0,0,60
19-044-005,57,45,0,45,0,0,45
19-045-001,700,236,0,236,0,2,234
19-046-001,246,142,0,142,0,1,141
19-047-001,436,200,0,200,0,2,198
19-048-001,749,316,0,316,0,2,314
19-048-002,773,333,0,333,0,0,333
19-049-001,928,560,0,556,-4,3,553
19-049-002,888,507,0,507,0,3,504
19-050-001,806,314,0,314,0,3,311
19-051-001,518,198,0,198,0,1,197
19-052-001,355,126,0,126,0,2,124
19-053-001,330,104,0,104,0,5,99
19-054-001,347,157,0,157,0,1,156
19-055-001,871,283,0,283,0,7,276
19-055-002,896,330,0,330,0,3,327
19-055-003,866,325,0,325,0,1,324
19-055-004,880,250,0,250,0,1,249
19-056-001,379,200,0,200,0,1,199
19-057-001,233,122,0,122,0,0,122
19-058-001,254,163,0,163,0,0,163
19-059-001,674,242,0,242,0,2,240
19-059-002,709,279,0,279,0,0,279
19-060-001,185,129,0,129,0,1,128
19-061-001,398,160,0,160,0,0,160
19-062-001,431,233,0,233,0,0,233
19-063-001,356,220,0,220,0,4,216
19-064-001,1421,755,0,755,0,1,754
19-065-001,224,142,0,142,0,1,141
19-066-001,326,120,0,120,0,1,119
19-067-001,305,115,0,115,0,0,115
19-068-001,641,222,0,222,0,1,221
19-069-001,271,124,0,124,0,0,124
19-070-001,604,241,0,241,0,1,240
19-071-001,933,395,0,395,0,3,392
19-071-002,683,205,0,205,0,1,204
19-071-003,852,193,0,193,0,1,192
19-072-001,960,344,0,344,0,4,340
19-073-001,548,276,0,276,0,0,276
19-074-001,142,91,0,91,0,0,91
19-075-001,238,134,0,134,0,0,134
19-076-001,730,382,0,382,0,2,380
19-076-002,718,334,0,334,0,1,333
19-076-003,670,290,0,290,0,1,289
19-076-004,721,307,0,307,0,1,306
19-077-001,76,29,0,29,0,0,29
19-078-001,363,176,0,176,0,1,175
19-079-001,566,231,0,231,0,1,230
19-080-001,60,39,0,39,0,0,39
19-081-001,277,135,0,135,0,2,133
19-082-001,615,301,0,301,0,3,298
19-083-001,281,121,0,121,0,3,118
19-084-001,309,131,0,131,0,0,131
19-085-001,225,108,0,108,0,0,108
19-086-001,661,237,0,237,0,2,235
19-087-001,401,191,0,191,0,0,191
19-088-001,371,129,0,129,0,1,128
19-089-001,492,202,0,202,0,1,201
19-090-001,461,187,0,187,0,1,186
19-091-001,66,49,0,49,0,0,49
19-092-001,421,169,0,169,0,1,168
19-093-001,309,135,0,135,0,1,134
19-094-001,81,36,0,36,0,0,36
19-095-001,90,56,0,56,0,0,56
19-096-001,969,349,0,349,0,2,347
19-097-001,60,34,0,34,0,1,33
19-098-001,96,34,0,34,0,0,34
19-099-001,592,200,0,200,0,1,199
19-100-001,319,170,0,170,0,2,168
19-101-001,662,316,0,316,0,3,313
19-102-001,369,116,0,116,0,0,116
19-103-001,635,254,0,254,0,5,249
19-104-001,446,167,0,167,0,2,165
19-105-001,261,126,0,126,0,1,125
19-106-001,796,305,0,305,0,0,305
19-107-001,797,308,0,308,0,0,308
19-108-001,895,384,1,384,0,0,384
19-108-002,876,373,1,372,-1,0,372
19-109-001,404,238,0,238,0,2,236
19-110-001,915,318,0,317,-1,7,310
19-111-001,374,158,0,157,-1,0,157
19-112-001,427,154,0,154,0,1,153
19-113-001,1106,506,0,506,0,4,502
19-114-001,427,213,0,213,0,1,212
19-115-001,318,114,0,114,0,0,114
19-116-001,432,163,0,163,0,0,163
19-116-002,205,99,0,99,0,1,98
19-117-001,1151,605,0,605,0,1,604
19-118-001,28,14,0,14,0,0,14
19-119-001,237,126,0,126,0,1,125
19-120-001,760,277,0,277,0,2,275
19-121-001,609,233,0,233,0,3,230
19-122-001,241,104,0,104,0,0,104
19-123-001,905,395,0,395,0,1,394
19-124-001,108,66,0,66,0,0,66
19-125-001,535,205,0,205,0,2,203
19-126-001,389,176,0,176,0,1,175
19-127-001,274,99,0,99,0,1,98
19-128-001,951,339,0,339,0,0,339
19-129-001,465,235,0,235,0,1,234
19-130-001,226,102,0,102,0,1,101
19-131-001,449,211,0,211,0,0,211
19-132-001,840,402,0,402,0,1,401
19-132-002,643,240,0,240,0,4,236
19-133-001,530,239,0,239,0,1,238
19-134-001,840,387,0,387,0,2,385
19-135-001,298,119,0,119,0,0,119
19-136-001,704,282,0,282,0,1,281
19-137-001,1163,551,0,545,-6,1,544
19-137-002,1173,577,0,577,0,2,575
19-138-001,299,144,1,143,-1,0,143
19-139-001,81,55,0,55,0,1,54
19-140-001,794,296,0,296,0,1,295
19-141-001,183,115,0,115,0,1,114
19-142-001,720,371,0,371,0,3,368
19-143-001,810,304,0,304,0,1,303
19-143-002,708,276,0,276,0,1,275
19-144-001,854,382,0,382,0,1,381
19-145-001,117,51,0,51,0,0,51
19-146-001,43,34,0,34,0,1,33
19-147-001,161,78,0,78,0,1,77
19-148-001,165,115,0,115,0,1,114
19-149-001,1073,427,0,427,0,0,427
19-149-002,784,280,0,280,0,1,279
19-150-001,1022,353,1,353,0,1,352
19-150-002,644,246,0,246,0,4,242
19-151-001,455,292,0,292,0,2,290
19-152-001,1101,327,0,327,0,0,327
19-152-002,185,81,0,81,0,1,80
19-153-001,902,400,0,400,0,1,399
19-153-002,776,340,1,339,-1,1,338
19-153-003,772,290,0,290,0,3,287
19-153-004,909,518,0,518,0,1,517
19-153-005,783,442,0,442,0,6,436
19-153-006,909,405,0,405,0,5,400
19-153-007,988,415,0,415,0,1,414
19-153-008,586,304,0,304,0,0,304
19-153-009,648,345,0,345,0,0,345
19-153-010,928,538,0,538,0,6,532
19-153-011,938,540,0,539,-1,2,537
19-153-012,624,321,0,321,0,1,320
19-153-013,688,365,0,365,0,2,363
19-153-014,763,314,0,314,0,0,314
19-153-015,1047,459,0,459,0,2,457
19-153-016,990,405,0,405,0,4,401
19-153-017,647,295,0,295,0,0,295
19-153-018,781,272,0,272,0,4,268
19-153-019,663,364,0,364,0,0,364
19-153-020,365,184,0,184,0,3,181
19-153-021,695,321,0,321,0,0,321
19-153-022,630,308,0,308,0,1,307
19-153-023,983,497,0,497,0,3,494
19-153-024,772,363,0,363,0,0,363
19-153-025,701,343,0,342,-1,0,342
19-153-026,607,305,0,305,0,0,305
19-153-027,657,284,0,284,0,1,283
19-153-028,974,427,0,427,0,1,426
19-153-029,762,266,0,266,0,1,265
19-153-030,1071,333,0,332,-1,3,329
19-153-031,699,369,0,369,0,0,369
19-154-001,215,106,0,106,0,1,105
19-155-001,475,218,0,218,0,0,218
19-156-001,264,84,0,84,0,0,84
19-157-001,944,356,0,356,0,2,354
19-158-001,504,272,0,272,0,2,270
19-159-001,286,115,0,115,0,0,115
19-160-001,613,234,0,234,0,1,233
19-160-002,813,323,0,323,0,0,323
19-160-003,776,235,0,235,0,0,235
19-160-004,859,326,0,325,-1,1,324
19-160-005,778,268,0,268,0,3,265
19-161-001,377,172,0,172,0,1,171
19-162-001,160,93,0,93,0,0,93
19-163-001,308,98,0,98,0,1,97
19-164-001,210,112,0,112,0,0,112
19-165-001,1114,659,0,659,0,4,655
19-166-001,159,53,0,53,0,0,53
19-167-001,75,49,0,49,0,0,49
19-168-001,225,111,0,111,0,2,109
19-169-001,236,89,0,89,0,2,87
19-170-001,539,225,0,225,0,6,219
19-171-001,900,322,0,322,0,4,318
19-172-001,68,38,0,38,0,0,38
19-173-001,420,213,0,213,0,4,209
19-174-001,832,354,0,353,-1,2,351
19-174-002,620,284,0,284,0,2,282
19-174-003,592,193,0,193,0,0,193
19-174-004,780,347,0,347,0,3,344
19-174-005,669,332,0,331,-1,2,329
19-174-006,791,330,0,330,0,0,330
19-174-007,725,283,0,283,0,2,281
19-175-001,519,192,0,192,0,1,191
19-176-001,404,148,0,148,0,4,144
19-177-001,369,142,0,142,0,2,140
19-178-001,214,139,0,139,0,1,138
19-179-001,788,250,0,250,0,1,249
19-179-002,705,278,0,278,0,2,276
19-179-003,712,232,0,231,-1,0,231
19-180-001,174,66,0,66,0,0,66
19-181-001,88,57,0,57,0,0,57
19-182-001,804,348,0,348,0,2,346
19-182-002,826,373,0,373,0,1,372
19-183-001,833,452,0,452,0,0,452
19-184-001,356,152,0,152,0,0,152
19-185-001,81,56,0,56,0,0,56
19-186-001,689,285,0,285,0,0,285
19-187-001,556,202,0,202,0,0,202
19-188-001,876,490,0,490,0,1,489
19-188-002,950,335,1,334,-1,3,331
19-188-003,1255,573,0,573,0,3,570
19-188-004,804,344,0,344,0,3,341
19-188-005,875,401,0,401,0,0,401
19-188-006,847,396,0,396,0,1,395
19-188-007,847,369,0,369,0,0,369
19-188-008,883,430,0,430,0,1,429
19-188-009,794,364,0,364,0,2,362
19-188-010,960,400,0,400,0,1,399
19-188-011,808,326,0,326,0,0,326
19-188-012,888,444,0,444,0,1,443
19-188-013,801,382,0,382,0,2,380
19-188-014,647,343,0,343,0,4,339
19-188-015,708,316,0,316,0,0,316
19-189-001,698,311,0,311,0,1,310
19-190-001,1269,724,0,724,0,5,719
19-191-001,1088,490,0,489,-1,4,485
19-192-001,472,205,0,205,0,1,204
19-193-001,1083,426,0,426,0,4,422
19-194-001,275,97,0,97,0,1,96
19-195-001,279,134,0,134,0,2,132
19-196-001,869,294,0,294,0,1,293
19-196-002,837,336,0,336,0,3,333
19-197-001,446,174,0,174,0,2,172
19-198-001,635,254,0,254,0,2,252
19-198-002,607,267,0,267,0,0,267
19-199-001,151,81,0,81,0,1,80
19-200-001,1080,490,0,490,0,4,486
19-201-001,870,388,0,388,0,4,384
19-201-002,974,324,0,324,0,0,324
19-201-003,817,333,0,332,-1,10,322
19-201-004,955,422,0,422,0,2,420
19-201-005,1046,413,0,413,0,1,412
19-201-006,1024,391,0,391,0,0,391
19-201-007,676,280,0,280,0,2,278
19-201-008,748,353,0,353,0,4,349
19-201-009,713,277,0,277,0,3,274
19-201-010,815,334,0,334,0,2,332
19-201-011,798,284,0,284,0,1,283
19-201-012,1003,377,1,376,-1,5,371
19-201-013,779,324,0,324,0,1,323
19-201-014,895,397,0,397,0,0,397
19-201-015,1088,485,2,482,-3,3,479
19-201-016,984,363,0,363,0,0,363
19-201-017,761,336,0,336,0,0,336
19-201-018,753,359,1,358,-1,1,357
19-201-019,788,233,0,233,0,3,230
19-202-001,217,142,0,142,0,2,140
19-203-001,1469,927,0,927,0,3,924
19-203-002,806,407,0,407,0,4,403
19-203-003,697,400,0,400,0,4,396
19-203-004,1102,593,0,592,-1,1,591
19-203-005,819,494,0,494,0,6,488
19-203-006,735,434,0,433,-1,1,432
19-203-007,841,501,0,501,0,2,499
19-203-008,1076,599,0,598,-1,3,595
19-203-009,823,402,0,401,-1,1,400
19-203-010,855,427,0,427,0,2,425
19-203-011,937,565,0,565,0,2,563
19-203-012,876,420,0,420,0,0,420
19-203-013,1079,608,0,608,0,0,608
19-203-014,812,528,0,528,0,1,527
19-203-015,585,286,0,286,0,0,286
19-203-016,705,351,0,351,0,1,350
19-203-017,598,380,0,380,0,1,379
19-203-018,671,374,0,374,0,0,374
19-203-019,683,416,0,416,0,1,415
19-203-020,690,431,0,431,0,1,430
19-203-021,746,422,0,422,0,1,421
19-203-022,653,299,0,299,0,2,297
19-203-023,807,402,0,402,0,2,400
19-203-024,918,478,0,478,0,1,477
19-203-025,1041,514,0,514,0,2,512
19-203-026,930,446,0,446,0,0,446
19-203-027,1050,595,0,595,0,1,594
19-203-028,557,205,1,204,-1,2,202
19-203-029,760,450,0,450,0,1,449
19-203-030,661,398,0,397,-1,1,396
19-203-031,1055,609,0,609,0,4,605
19-203-032,940,578,0,578,0,1,577
19-203-033,660,279,0,279,0,1,278
19-203-034,980,443,0,443,0,1,442
19-203-035,910,398,0,397,-1,1,396
19-203-036,844,334,0,334,0,1,333
19-203-037,609,229,0,229,0,2,227
19-203-038,852,341,0,341,0,0,341
19-203-039,691,260,0,260,0,2,258
19-203-040,893,358,0,358,0,0,358
19-203-041,600,217,0,215,-2,1,214
19-203-042,705,286,0,286,0,0,286
19-203-043,808,317,0,317,0,3,314
19-203-044,920,409,0,409,0,4,405
19-203-045,766,317,0,317,0,0,317
19-203-046,618,275,0,275,0,0,275
19-203-047,599,290,1,289,-1,0,289
19-203-048,384,209,0,209,0,1,208
19-203-049,750,387,0,387,0,0,387
19-203-050,1026,471,0,471,0,1,470
19-203-051,832,365,0,365,0,2,363
19-203-052,231,113,0,113,0,1,112
19-203-053,1173,594,0,594,0,3,591
19-203-054,787,397,0,395,-2,0,395
19-203-055,742,366,0,366,0,2,364
19-203-056,793,337,0,337,0,3,334
19-204-001,199,124,0,124,0,2,122
19-205-001,220,90,0,90,0,1,89
19-206-001,105,47,0,47,0,0,47
19-207-001,165,73,0,73,0,1,72
19-208-001,527,191,0,191,0,0,191
19-209-001,190,92,0,92,0,0,92
19-210-001,67,37,0,37,0,0,37
19-211-001,203,48,0,48,0,0,48
19-212-001,342,136,0,136,0,1,135
19-213-001,1028,388,0,388,0,0,388
19-214-001,45,21,0,21,0,1,20
19-215-001,123,69,0,69,0,0,69
19-216-001,864,468,0,468,0,5,463
19-217-001,774,316,0,316,0,5,311
19-217-002,752,285,0,285,0,2,283
19-217-003,786,345,0,344,-1,4,340
19-217-004,749,349,0,349,0,0,349
19-217-005,837,405,0,405,0,2,403
19-217-006,695,347,0,347,0,3,344
19-217-007,986,491,0,490,-1,6,484
19-218-001,896,543,0,543,0,4,539
20-001-001,341,172,0,172,0,1,171
20-002-001,64,38,0,38,0,0,38
20-003-001,576,247,0,247,0,1,246
20-004-001,1197,547,0,547,0,6,541
20-005-001,271,78,0,78,0,0,78
20-006-001,52,38,0,38,0,1,37
20-007-001,409,216,0,216,0,0,216
20-008-001,36,26,0,26,0,0,26
20-009-001,1026,442,0,442,0,3,439
20-010-001,662,309,0,309,0,2,307
20-010-002,675,287,0,287,0,3,284
20-011-001,278,96,0,96,0,0,96
20-012-001,1039,615,0,613,-2,2,611
20-013-001,382,119,0,119,0,0,119
20-014-001,110,68,0,68,0,0,68
20-015-001,296,111,0,111,0,0,111
20-016-001,474,173,0,173,0,6,167
20-017-001,482,241,0,241,0,2,239
20-017-002,102,52,0,52,0,0,52
20-018-001,634,247,0,247,0,0,247
20-018-002,590,230,0,230,0,0,230
20-018-003,477,158,0,158,0,3,155
20-019-001,645,260,0,260,0,0,260
20-020-001,615,206,0,206,0,3,203
20-021-001,87,56,0,56,0,0,56
20-022-001,110,57,0,57,0,1,56
20-023-001,932,400,0,400,0,2,398
20-024-001,248,86,0,86,0,0,86
20-025-001,259,144,0,144,0,0,144
20-026-001,582,192,0,192,0,5,187
20-027-001,237,105,0,105,0,1,104
20-028-001,222,103,0,103,0,1,102
20-029-001,36,26,0,26,0,0,26
20-030-001,43,21,0,21,0,1,20
20-031-001,590,301,0,301,0,1,300
20-032-001,176,78,0,78,0,0,78
20-033-001,121,49,0,49,0,0,49
20-034-001,426,193,0,193,0,0,193
20-035-001,1259,586,0,586,0,6,580
20-035-002,1059,478,0,478,0,3,475
20-036-001,32,9,0,9,0,0,9
20-037-001,706,393,0,393,0,1,392
20-038-001,283,141,0,141,0,2,139
20-039-001,67,47,0,47,0,0,47
20-040-001,477,192,0,192,0,1,191
20-041-001,324,103,0,103,0,1,102
20-042-001,382,136,0,136,0,0,136
20-043-001,146,68,0,68,0,0,68
20-044-001,121,76,0,76,0,4,72
20-045-001,71,47,0,47,0,2,45
20-046-001,26,21,0,21,0,0,21
20-047-001,247,100,0,100,0,4,96
20-048-001,854,367,0,366,-1,1,365
20-049-001,555,225,0,225,0,0,225
20-050-001,320,109,0,109,0,0,109
20-051-001,534,261,0,261,0,2,259
20-052-001,585,241,0,241,0,0,241
20-053-001,18,18,0,18,0,0,18
20-054-001,537,210,0,210,0,0,210
20-055-001,115,61,0,61,0,0,61
20-056-001,959,317,0,317,0,0,317
20-057-001,527,188,0,188,0,0,188
20-058-001,54,35,0,35,0,0,35
20-059-001,801,380,0,380,0,1,379
20-059-002,479,209,0,209,0,0,209
20-060-001,395,122,0,122,0,1,121
20-060-002,484,136,0,136,0,0,136
20-061-001,218,97,0,97,0,0,97
20-062-001,73,28,0,28,0,0,28
20-063-001,42,30,0,30,0,0,30
20-064-001,49,37,0,37,0,0,37
20-065-001,241,118,0,118,0,0,118
20-066-001,666,252,0,252,0,0,252
20-066-002,188,68,0,68,0,0,68
20-067-001,1047,479,0,479,0,3,476
20-067-002,1021,557,0,557,0,6,551
20-067-003,966,460,0,460,0,2,458
20-068-001,76,34,0,34,0,0,34
20-069-001,242,109,0,109,0,1,108
20-070-001,346,130,0,130,0,0,130
20-070-002,434,184,0,184,0,3,181
20-070-003,108,43,0,43,0,0,43
20-071-001,65,35,0,35,0,1,34
20-072-001,1221,911,1,910,-1,1,909
20-072-002,676,336,0,336,0,1,335
20-072-003,791,400,0,400,0,0,400
20-072-004,748,371,0,371,0,0,371
20-072-005,937,457,0,457,0,0,457
20-073-001,183,86,0,86,0,2,84
20-074-001,147,64,0,64,0,0,64
20-075-001,282,130,0,130,0,1,129
20-076-001,9,8,0,8,0,0,8
20-077-001,245,115,0,115,0,2,113
20-078-001,165,78,0,78,0,1,77
20-079-001,74,42,0,42,0,0,42
20-080-001,589,255,0,255,0,1,254
20-081-001,126,87,0,87,0,0,87
20-082-001,106,55,0,55,0,0,55
20-083-001,189,109,0,109,0,0,109
20-084-001,562,245,0,245,0,0,245
20-084-002,304,145,0,145,0,1,144
20-085-001,124,51,0,51,0,2,49
20-085-002,276,115,0,115,0,1,114
20-086-001,72,29,0,29,0,0,29
20-087-001,185,36,0,36,0,0,36
20-088-001,235,116,0,116,0,1,115
20-089-001,97,59,0,59,0,0,59
20-090-001,86,59,0,59,0,0,59
20-091-001,194,84,0,84,0,1,83
20-092-001,143,67,0,67,0,1,66
20-093-001,913,413,0,413,0,1,412
20-093-002,794,337,0,337,0,2,335
20-093-003,967,443,0,443,0,2,441
20-093-004,961,560,0,560,0,4,556
20-093-005,939,478,0,478,0,2,476
20-093-006,1155,533,0,531,-2,1,530
20-093-007,799,488,0,488,0,4,484
20-093-008,843,428,0,428,0,3,425
20-093-009,703,334,0,334,0,3,331
20-093-010,971,500,0,500,0,3,497
20-093-011,1062,512,0,512,0,0,512
20-093-012,815,438,0,438,0,1,437
20-093-013,948,412,0,412,0,0,412
20-093-014,1130,434,0,434,0,0,434
20-093-015,1023,427,0,427,0,1,426
20-093-016,1021,433,0,433,0,0,433
20-093-017,855,443,0,442,-1,0,442
20-094-001,183,75,0,75,0,0,75
20-095-001,372,150,0,150,0,1,149
20-096-001,150,72,0,72,0,0,72
20-097-001,142,75,0,75,0,0,75
20-098-001,166,81,0,81,0,0,81
20-099-001,219,123,0,123,0,0,123
20-100-001,142,66,0,66,0,0,66
20-101-001,139,74,0,74,0,0,74
20-102-001,138,50,0,50,0,0,50
20-103-001,43,27,0,27,0,0,27
20-104-001,35,29,0,29,0,0,29
20-105-001,389,165,0,165,0,0,165
20-106-001,66,38,0,38,0,0,38
20-107-001,386,180,0,180,0,3,177
20-108-001,49,21,0,21,0,0,21
20-109-001,25,18,0,18,0,0,18
20-110-001,32,23,0,23,0,1,22
20-111-001,996,582,0,582,0,8,574
20-111-002,1027,610,0,610,0,1,609
20-111-003,675,441,0,441,0,1,440
20-111-004,832,446,0,446,0,7,439
20-111-005,622,383,0,383,0,1,382
20-111-006,905,547,0,547,0,2,545
20-111-007,472,265,0,265,0,1,264
20-111-008,298,185,0,185,0,0,185
20-111-009,257,137,0,137,0,1,136
20-111-010,257,144,0,144,0,0,144
20-111-011,134,81,0,81,0,0,81
20-112-001,687,271,1,271,0,0,271
20-112-002,782,295,0,295,0,0,295
20-112-003,796,287,0,287,0,1,286
20-112-004,623,204,0,204,0,2,202
20-112-005,483,178,0,178,0,2,176
20-113-001,154,84,0,84,0,0,84
20-114-001,46,30,0,30,0,0,30
20-115-001,73,28,0,28,0,0,28
20-115-002,157,64,0,64,0,0,64
20-116-001,310,134,0,134,0,1,133
20-117-001,964,400,3,397,-3,0,397
20-118-001,47,29,0,29,0,0,29
20-119-001,220,97,0,97,0,0,97
20-120-001,366,159,0,159,0,3,156
20-121-001,65,31,0,31,0,1,30
20-122-001,41,32,0,32,0,0,32
20-123-001,595,193,0,193,0,2,191
20-124-001,292,154,1,152,-2,2,150
20-125-001,228,129,0,129,0,5,124
20-126-001,253,111,0,111,0,3,108
20-127-001,241,92,0,92,0,0,92
20-128-001,590,253,0,253,0,1,252
20-129-001,864,254,0,254,0,0,254
20-129-002,575,188,0,188,0,1,187
20-130-001,207,84,1,83,-1,0,83
20-131-001,207,85,0,85,0,0,85
20-131-002,93,53,0,53,0,2,51
20-131-003,78,39,0,39,0,0,39
20-132-001,342,120,0,120,0,2,118
20-133-001,126,60,0,60,0,1,59
20-134-001,876,371,0,371,0,0,371
20-134-002,1040,534,0,534,0,2,532
20-134-003,812,359,0,359,0,1,358
20-134-004,1205,485,0,485,0,3,482
20-134-005,960,440,0,440,0,1,439
20-134-006,1027,497,0,497,0,2,495
20-134-007,698,300,0,300,0,1,299
20-134-008,1043,438,0,438,0,2,436
20-134-009,1214,571,0,570,-1,1,569
20-134-010,1000,466,0,466,0,3,463
20-134-011,794,399,0,399,0,2,397
20-134-012,1071,584,0,584,0,5,579
20-134-013,888,470,0,470,0,1,469
20-134-014,1066,449,0,449,0,3,446
20-134-015,1011,447,0,447,0,2,445
20-134-016,790,185,0,185,0,0,185
20-134-017,218,87,0,87,0,1,86
20-134-018,1072,474,0,473,-1,3,470
20-134-019,1036,379,0,379,0,2,377
20-134-020,837,274,0,274,0,0,274
20-134-021,802,317,0,317,0,0,317
20-134-022,1013,400,0,398,-2,4,394
20-134-023,1078,431,0,431,0,0,431
20-134-024,765,348,0,348,0,1,347
20-134-025,820,324,0,324,0,1,323
20-134-026,1225,394,0,394,0,0,394
20-134-027,1257,516,0,516,0,1,515
20-134-028,1191,393,0,393,0,0,393
20-134-029,1135,525,0,525,0,1,524
20-134-030,964,363,0,363,0,2,361
20-134-031,750,331,0,331,0,0,331
20-134-032,846,395,0,395,0,3,392
20-134-033,954,448,0,448,0,1,447
20-134-034,1228,589,0,588,-1,2,586
20-134-035,1233,507,0,507,0,1,506
20-134-036,510,192,0,192,0,2,190
20-134-037,829,384,1,383,-1,0,383
20-134-038,914,407,0,407,0,3,404
20-134-039,1175,498,0,498,0,0,498
20-134-040,1131,488,0,488,0,1,487
20-135-001,726,265,0,265,0,2,263
20-136-001,370,191,0,191,0,0,191
20-137-001,395,187,0,187,0,0,187
20-138-001,407,168,0,168,0,0,168
20-139-001,404,145,1,145,0,0,145
20-140-001,891,374,0,374,0,1,373
20-141-001,387,151,0,151,0,0,151
20-142-001,537,255,0,255,0,6,249
20-143-001,217,103,0,103,0,1,102
20-144-001,129,83,0,83,0,0,83
20-145-001,218,87,1,87,0,0,87
20-146-001,261,129,0,129,0,1,128
20-147-001,251,111,0,111,0,3,108
20-148-001,211,102,0,102,0,0,102
20-149-001,160,103,0,103,0,0,103
20-150-001,640,236,0,236,0,0,236
20-151-001,200,55,0,55,0,0,55
20-152-001,95,47,0,47,0,0,47
20-153-001,83,55,0,55,0,1,54
20-154-001,333,93,0,93,0,0,93
20-155-001,95,42,0,42,0,1,41
20-156-001,153,80,0,80,0,0,80
20-157-001,459,159,0,159,0,1,158
20-158-001,640,210,0,210,0,2,208
20-158-002,696,267,0,267,0,1,266
20-159-001,98,49,0,49,0,0,49
20-160-001,694,220,0,220,0,0,220
20-161-001,148,74,0,74,0,2,72
20-162-001,832,392,0,392,0,2,390
20-162-002,119,56,0,56,0,1,55
20-163-001,142,69,0,69,0,0,69
20-164-001,344,123,1,122,-1,2,120
20-165-001,311,148,0,148,0,1,147
20-166-001,308,115,0,115,0,0,115
20-167-001,765,306,0,306,0,1,305
20-168-001,232,157,0,157,0,0,157
20-169-001,672,234,0,234,0,1,233
20-170-001,296,90,0,90,0,1,89
20-171-001,34,30,0,30,0,0,30
20-172-001,231,105,0,105,0,1,104
20-173-001,26,24,0,24,0,0,24
20-174-001,138,68,0,68,0,0,68
20-175-001,434,180,0,180,0,0,180
20-176-001,467,219,0,219,0,3,216
20-177-001,30,18,0,18,0,1,17
20-178-001,231,97,0,97,0,0,97
20-179-001,1018,401,0,400,-1,2,398
20-180-001,753,352,0,352,0,1,351
20-181-001,330,158,0,158,0,2,156
20-182-001,479,219,0,219,0,3,216
20-183-001,322,141,0,141,0,0,141
20-184-001,627,298,0,298,0,2,296
20-185-001,774,248,0,248,0,1,247
20-185-002,735,222,1,221,-1,5,216
20-186-001,495,205,0,205,0,1,204
20-187-001,42,29,0,29,0,0,29
20-188-001,735,351,0,351,0,1,350
20-189-001,575,178,0,178,0,1,177
20-189-002,626,173,0,173,0,1,172
20-190-001,484,189,0,189,0,0,189
20-191-001,495,233,0,233,0,2,231
20-192-001,163,73,0,73,0,0,73
20-193-001,256,118,0,118,0,1,117
20-194-001,329,160,0,160,0,1,159
20-195-001,50,29,0,29,0,1,28
20-196-001,247,98,1,97,-1,1,96
20-197-001,69,31,0,31,0,0,31
20-198-001,108,39,0,39,0,0,39
20-199-001,692,169,0,169,0,0,169
20-200-001,625,220,0,220,0,3,217
20-200-002,664,226,0,226,0,1,225
20-201-001,185,103,0,103,0,0,103
20-202-001,20,12,0,12,0,0,12
20-203-001,150,110,0,110,0,0,110
20-204-001,872,440,0,440,0,1,439
20-205-001,73,53,0,53,0,0,53
20-205-002,54,35,0,35,0,0,35
20-206-001,290,132,0,132,0,0,132
20-207-001,452,189,0,189,0,4,185
20-208-001,550,174,0,174,0,0,174
20-209-001,701,248,0,248,0,0,248
20-210-001,404,139,0,139,0,0,139
20-210-002,497,169,0,169,0,0,169
20-211-001,476,98,0,98,0,1,97
20-211-002,781,276,0,276,0,4,272
20-212-001,800,333,0,333,0,1,332
20-213-001,47,23,0,23,0,0,23
20-214-001,467,185,0,185,0,1,184
20-215-001,236,151,0,151,0,1,150
20-215-002,59,36,0,36,0,0,36
20-216-001,110,47,0,47,0,0,47
20-217-001,154,47,0,47,0,2,45
20-218-001,877,401,0,401,0,0,401
20-219-001,100,56,0,56,0,1,55
20-220-001,61,30,0,30,0,0,30
20-221-001,281,127,0,127,0,0,127
20-222-001,1034,511,0,511,0,5,506
20-222-002,926,481,0,481,0,2,479
20-223-001,68,45,0,45,0,0,45
20-224-001,177,73,0,73,0,2,71
20-225-001,633,258,0,258,0,4,254
20-225-002,576,231,0,231,0,1,230
20-226-001,528,259,0,259,0,4,255
20-227-001,568,217,0,217,0,0,217
20-228-001,295,130,0,130,0,1,129
20-229-001,811,330,0,330,0,1,329
20-230-001,406,182,0,182,0,1,181
20-231-001,724,333,0,333,0,1,332
20-231-002,1084,502,0,502,0,0,502
20-231-003,1163,586,0,586,0,1,585
20-231-004,884,457,0,457,0,0,457
20-231-005,796,313,0,313,0,1,312
20-231-006,1201,571,0,571,0,2,569
20-231-007,827,354,0,354,0,3,351
20-231-008,695,343,0,343,0,1,342
20-231-009,828,405,0,405,0,1,404
20-231-010,859,397,0,397,0,0,397
20-231-011,803,359,0,359,0,2,357
20-231-012,1011,472,0,472,0,2,470
20-231-013,1089,514,0,513,-1,1,512
20-231-014,878,367,0,367,0,3,364
20-231-015,941,433,1,432,-1,1,431
20-231-016,1443,751,0,751,0,4,747
20-231-017,990,499,0,499,0,0,499
20-231-018,954,472,0,471,-1,4,467
20-231-019,857,447,1,447,0,4,443
20-231-020,968,502,0,502,0,0,502
20-231-021,1085,533,1,533,0,3,530
20-231-022,902,407,0,407,0,3,404
20-231-023,1110,588,0,588,0,3,585
20-231-024,495,203,0,203,0,1,202
20-231-025,529,265,0,265,0,0,265
20-231-026,1312,613,0,613,0,1,612
20-231-027,978,421,0,419,-2,2,417
20-231-028,1371,617,1,615,-2,2,613
20-231-029,892,433,0,432,-1,2,430
20-231-030,595,230,0,230,0,4,226
20-231-031,707,286,0,286,0,3,283
20-231-032,788,380,0,380,0,3,377
20-231-033,825,366,0,366,0,1,365
20-231-034,982,447,0,447,0,1,446
20-231-035,875,481,0,480,-1,2,478
20-231-036,980,456,0,456,0,2,454
20-231-037,1029,557,0,557,0,1,556
20-231-038,871,407,0,407,0,3,404
20-231-039,841,394,0,394,0,0,394
20-231-040,1013,567,0,567,0,3,564
20-231-041,1072,530,0,530,0,1,529
20-231-042,664,344,0,344,0,1,343
20-231-043,925,424,1,424,0,2,422
20-231-044,922,447,0,447,0,2,445
20-231-045,847,373,0,373,0,0,373
20-231-046,831,388,0,388,0,0,388
20-231-047,714,395,0,395,0,2,393
20-231-048,1373,697,0,697,0,6,691
20-231-049,997,474,0,474,0,3,471
20-231-050,652,263,0,263,0,3,260
20-231-051,633,349,0,349,0,0,349
20-232-001,302,153,0,153,0,0,153
20-233-001,88,46,0,46,0,1,45
20-234-001,303,137,0,137,0,1,136
20-235-001,1054,599,0,599,0,5,594
20-235-002,925,345,0,345,0,2,343
20-236-001,671,149,0,149,0,2,147
20-236-002,693,242,0,242,0,2,240
20-236-003,722,172,0,172,0,0,172
20-237-001,22,17,0,17,0,0,17
20-238-001,524,252,0,252,0,0,252
20-238-002,527,221,0,221,0,2,219
20-238-003,505,195,0,195,0,0,195
20-238-004,500,218,0,218,0,0,218
20-238-005,196,106,0,106,0,0,106
20-238-006,74,44,0,44,0,0,44
20-239-001,138,87,0,87,0,0,87
20-240-001,101,45,0,45,0,1,44
20-241-001,428,174,0,174,0,1,173
20-242-001,747,324,0,324,0,3,321
20-243-001,654,277,0,277,0,1,276
20-244-001,661,260,0,260,0,1,259
20-244-002,687,327,0,327,0,0,327
20-244-003,820,374,0,373,-1,0,373
20-244-004,1062,435,0,435,0,1,434
20-244-005,428,176,0,176,0,1,175
20-244-006,536,235,0,235,0,2,233
20-244-007,155,56,0,56,0,0,56
20-244-008,253,101,0,101,0,1,100
20-244-009,234,82,0,82,0,2,80
20-244-010,388,188,0,188,0,1,187
20-245-001,353,186,0,186,0,0,186
20-246-001,829,371,0,371,0,1,370
20-247-001,237,80,0,80,0,3,77
20-248-001,412,178,0,178,0,0,178
20-248-002,216,77,0,77,0,0,77
20-249-001,227,114,0,114,0,2,112
20-250-001,61,47,1,46,-1,1,45
20-251-001,814,330,0,330,0,0,330
20-252-001,46,40,0,40,0,1,39
20-253-001,504,173,0,173,0,0,173
20-254-001,75,45,0,45,0,0,45
20-255-001,740,279,0,279,0,3,276
20-256-001,290,113,0,113,0,0,113
20-257-001,46,27,0,27,0,0,27
20-258-001,380,161,0,161,0,0,161
