MEGYE,TELEPULES,SZAVAZOKOR,VALASZTOPOLGAR,MEGJELENTEK,NOSTAMP,URNABAN_LEVO,ELTERES,ERVENYTELEN,ERVENYES
BUDAPEST,Budapest I. kerület,001,1055,698,6,692,-6,4,688
BUDAPEST,Budapest I. kerület,002,978,602,0,602,0,3,599
BUDAPEST,Budapest I. kerület,003,1753,1183,0,1183,0,2,1181
BUDAPEST,Budapest I. kerület,004,1004,568,1,566,-2,9,557
BUDAPEST,Budapest I. kerület,005,932,576,0,576,0,0,576
BUDAPEST,Budapest I. kerület,006,998,624,0,624,0,4,620
BUDAPEST,Budapest I. kerület,007,899,559,0,557,-2,1,556
BUDAPEST,Budapest I. kerület,008,896,557,0,557,0,1,556
BUDAPEST,Budapest I. kerület,009,1026,615,0,615,0,3,612
BUDAPEST,Budapest I. kerület,010,962,589,0,588,-1,3,585
BUDAPEST,Budapest I. kerület,011,969,613,0,613,0,0,613
BUDAPEST,Budapest I. kerület,012,1017,613,0,613,0,2,611
BUDAPEST,Budapest I. kerület,013,1065,650,0,650,0,2,648
BUDAPEST,Budapest I. kerület,014,997,622,0,622,0,1,621
BUDAPEST,Budapest I. kerület,015,974,584,0,583,-1,2,581
BUDAPEST,Budapest I. kerület,016,895,577,0,577,0,2,575
BUDAPEST,Budapest I. kerület,017,1014,631,0,631,0,2,629
BUDAPEST,Budapest I. kerület,018,1011,634,0,633,-1,1,632
BUDAPEST,Budapest I. kerület,019,969,569,0,569,0,1,568
BUDAPEST,Budapest I. kerület,020,901,559,0,559,0,2,557
BUDAPEST,Budapest II. kerület,001,1077,661,3,658,-3,0,658
BUDAPEST,Budapest II. kerület,002,943,562,0,562,0,4,558
BUDAPEST,Budapest II. kerület,003,699,386,0,386,0,1,385
BUDAPEST,Budapest II. kerület,004,1020,592,0,592,0,3,589
BUDAPEST,Budapest II. kerület,005,1084,649,0,649,0,4,645
BUDAPEST,Budapest II. kerület,006,878,580,0,579,-1,2,577
BUDAPEST,Budapest II. kerület,007,799,508,0,508,0,2,506
BUDAPEST,Budapest II. kerület,008,886,588,0,587,-1,4,583
BUDAPEST,Budapest II. kerület,009,861,551,0,551,0,5,546
BUDAPEST,Budapest II. kerület,010,723,500,0,499,-1,2,497
BUDAPEST,Budapest II. kerület,011,2695,2015,2,2015,0,4,2011
BUDAPEST,Budapest II. kerület,012,988,657,0,657,0,0,657
BUDAPEST,Budapest II. kerület,013,668,427,1,426,-1,1,425
BUDAPEST,Budapest II. kerület,014,854,536,1,536,0,1,535
BUDAPEST,Budapest II. kerület,015,761,486,0,486,0,5,481
BUDAPEST,Budapest II. kerület,016,886,587,0,587,0,0,587
BUDAPEST,Budapest II. kerület,017,866,564,0,564,0,2,562
BUDAPEST,Budapest II. kerület,018,777,503,0,503,0,0,503
BUDAPEST,Budapest II. kerület,019,851,562,0,561,-1,2,559
BUDAPEST,Budapest II. kerület,020,830,552,0,551,-1,0,551
BUDAPEST,Budapest II. kerület,021,855,531,0,531,0,4,527
BUDAPEST,Budapest II. kerület,022,853,567,0,567,0,4,563
BUDAPEST,Budapest II. kerület,023,879,583,0,583,0,1,582
BUDAPEST,Budapest II. kerület,024,983,621,0,620,-1,0,620
BUDAPEST,Budapest II. kerület,025,829,524,0,524,0,1,523
BUDAPEST,Budapest II. kerület,026,873,614,0,613,-1,11,602
BUDAPEST,Budapest II. kerület,027,758,468,0,468,0,0,468
BUDAPEST,Budapest II. kerület,028,705,463,0,463,0,2,461
BUDAPEST,Budapest II. kerület,029,507,307,0,307,0,0,307
BUDAPEST,Budapest II. kerület,030,595,368,0,368,0,2,366
BUDAPEST,Budapest II. kerület,031,1115,691,0,691,0,3,688
BUDAPEST,Budapest II. kerület,032,977,679,0,679,0,1,678
BUDAPEST,Budapest II. kerület,033,855,601,1,602,1,9,593
BUDAPEST,Budapest II. kerület,034,764,461,0,461,0,1,460
BUDAPEST,Budapest II. kerület,035,879,557,0,558,1,18,540
BUDAPEST,Budapest II. kerület,036,880,602,0,601,-1,0,601
BUDAPEST,Budapest II. kerület,037,882,562,0,562,0,3,559
BUDAPEST,Budapest II. kerület,038,1009,652,0,652,0,2,650
BUDAPEST,Budapest II. kerület,039,841,547,0,547,0,5,542
BUDAPEST,Budapest II. kerület,040,847,514,0,514,0,2,512
BUDAPEST,Budapest II. kerület,041,782,453,0,453,0,3,450
BUDAPEST,Budapest II. kerület,042,786,473,0,473,0,2,471
BUDAPEST,Budapest II. kerület,043,796,534,0,534,0,0,534
BUDAPEST,Budapest II. kerület,044,919,625,0,625,0,1,624
BUDAPEST,Budapest II. kerület,045,887,540,1,541,1,11,530
BUDAPEST,Budapest II. kerület,046,911,578,0,578,0,2,576
BUDAPEST,Budapest II. kerület,047,895,605,0,605,0,0,605
BUDAPEST,Budapest II. kerület,048,947,609,0,608,-1,1,607
BUDAPEST,Budapest II. kerület,049,879,562,0,560,-2,3,557
BUDAPEST,Budapest II. kerület,050,819,497,0,497,0,1,496
BUDAPEST,Budapest II. kerület,051,758,519,0,519,0,4,515
BUDAPEST,Budapest II. kerület,052,693,447,0,447,0,2,445
BUDAPEST,Budapest II. kerület,053,720,475,0,475,0,0,475
BUDAPEST,Budapest II. kerület,054,1064,637,1,635,-2,1,634
BUDAPEST,Budapest II. kerület,055,925,548,0,547,-1,3,544
BUDAPEST,Budapest II. kerület,056,776,489,1,488,-1,3,485
BUDAPEST,Budapest II. kerület,057,743,479,0,479,0,2,477
BUDAPEST,Budapest II. kerület,058,937,541,0,541,0,2,539
BUDAPEST,Budapest II. kerület,059,798,504,0,504,0,1,503
BUDAPEST,Budapest II. kerület,060,816,451,1,451,0,3,448
BUDAPEST,Budapest II. kerület,061,917,575,0,573,-2,3,570
BUDAPEST,Budapest II. kerület,062,673,377,0,377,0,2,375
BUDAPEST,Budapest II. kerület,063,841,514,1,514,0,0,514
BUDAPEST,Budapest II. kerület,064,857,504,0,504,0,0,504
BUDAPEST,Budapest II. kerület,065,928,537,0,537,0,1,536
BUDAPEST,Budapest II. kerület,066,1036,580,0,580,0,2,578
BUDAPEST,Budapest II. kerület,067,860,456,0,456,0,0,456
BUDAPEST,Budapest II. kerület,068,885,503,0,502,-1,3,499
BUDAPEST,Budapest II. kerület,069,955,530,0,530,0,5,525
BUDAPEST,Budapest II. kerület,070,868,532,0,532,0,5,527
BUDAPEST,Budapest II. kerület,071,853,525,0,525,0,0,525
BUDAPEST,Budapest II. kerület,072,963,567,0,567,0,1,566
BUDAPEST,Budapest II. kerület,073,949,560,0,560,0,2,558
BUDAPEST,Budapest II. kerület,074,842,461,0,461,0,3,458
BUDAPEST,Budapest III. kerület,001,901,547,0,547,0,3,544
BUDAPEST,Budapest III. kerület,002,881,531,0,531,0,3,528
BUDAPEST,Budapest III. kerület,003,1000,528,0,524,-4,4,520
BUDAPEST,Budapest III. kerület,004,967,557,0,557,0,6,551
BUDAPEST,Budapest III. kerület,005,851,431,0,431,0,1,430
BUDAPEST,Budapest III. kerület,006,967,591,0,591,0,2,589
BUDAPEST,Budapest III. kerület,007,920,507,0,507,0,5,502
BUDAPEST,Budapest III. kerület,008,808,428,0,428,0,0,428
BUDAPEST,Budapest III. kerület,009,855,489,0,489,0,5,484
BUDAPEST,Budapest III. kerület,010,880,552,0,552,0,4,548
BUDAPEST,Budapest III. kerület,011,948,567,0,567,0,4,563
BUDAPEST,Budapest III. kerület,012,901,580,0,580,0,4,576
BUDAPEST,Budapest III. kerület,013,911,560,0,560,0,0,560
BUDAPEST,Budapest III. kerület,014,879,522,0,522,0,1,521
BUDAPEST,Budapest III. kerület,015,750,478,0,477,-1,1,476
BUDAPEST,Budapest III. kerület,016,795,534,0,534,0,1,533
BUDAPEST,Budapest III. kerület,017,851,551,0,551,0,0,551
BUDAPEST,Budapest III. kerület,018,947,567,0,567,0,0,567
BUDAPEST,Budapest III. kerület,019,1094,671,1,671,0,0,671
BUDAPEST,Budapest III. kerület,020,1113,598,0,598,0,2,596
BUDAPEST,Budapest III. kerület,021,813,438,0,438,0,2,436
BUDAPEST,Budapest III. kerület,022,1112,609,0,609,0,3,606
BUDAPEST,Budapest III. kerület,023,856,513,0,513,0,0,513
BUDAPEST,Budapest III. kerület,024,810,491,0,491,0,1,490
BUDAPEST,Budapest III. kerület,025,794,409,0,409,0,0,409
BUDAPEST,Budapest III. kerület,026,768,478,1,478,0,1,477
BUDAPEST,Budapest III. kerület,027,846,550,0,550,0,1,549
BUDAPEST,Budapest III. kerület,028,890,508,0,510,2,21,489
BUDAPEST,Budapest III. kerület,029,871,491,0,491,0,4,487
BUDAPEST,Budapest III. kerület,030,920,533,0,533,0,1,532
BUDAPEST,Budapest III. kerület,031,906,449,0,449,0,4,445
BUDAPEST,Budapest III. kerület,032,962,554,0,554,0,0,554
BUDAPEST,Budapest III. kerület,033,873,463,0,463,0,1,462
BUDAPEST,Budapest III. kerület,034,794,430,0,430,0,0,430
BUDAPEST,Budapest III. kerület,035,807,445,0,445,0,1,444
BUDAPEST,Budapest III. kerület,036,804,441,0,441,0,0,441
BUDAPEST,Budapest III. kerület,037,912,555,0,554,-1,0,554
BUDAPEST,Budapest III. kerület,038,784,418,0,418,0,2,416
BUDAPEST,Budapest III. kerület,039,793,452,0,452,0,0,452
BUDAPEST,Budapest III. kerület,040,731,368,1,367,-1,0,367
BUDAPEST,Budapest III. kerület,041,827,407,0,407,0,1,406
BUDAPEST,Budapest III. kerület,042,2699,1942,1,1938,-4,3,1935
BUDAPEST,Budapest III. kerület,043,1069,527,0,527,0,2,525
BUDAPEST,Budapest III. kerület,044,990,628,0,626,-2,6,620
BUDAPEST,Budapest III. kerület,045,947,456,0,456,0,2,454
BUDAPEST,Budapest III. kerület,046,1048,528,0,526,-2,2,524
BUDAPEST,Budapest III. kerület,047,570,316,0,316,0,2,314
BUDAPEST,Budapest III. kerület,048,822,420,0,420,0,1,419
BUDAPEST,Budapest III. kerület,049,861,468,0,468,0,0,468
BUDAPEST,Budapest III. kerület,050,865,466,1,465,-1,3,462
BUDAPEST,Budapest III. kerület,051,790,443,0,443,0,1,442
BUDAPEST,Budapest III. kerület,052,888,518,0,518,0,2,516
BUDAPEST,Budapest III. kerület,053,728,445,0,445,0,1,444
BUDAPEST,Budapest III. kerület,054,901,521,0,521,0,2,519
BUDAPEST,Budapest III. kerület,055,850,457,0,457,0,3,454
BUDAPEST,Budapest III. kerület,056,840,478,0,478,0,1,477
BUDAPEST,Budapest III. kerület,057,933,471,0,471,0,1,470
BUDAPEST,Budapest III. kerület,058,812,397,0,397,0,0,397
BUDAPEST,Budapest III. kerület,059,775,513,0,513,0,2,511
BUDAPEST,Budapest III. kerület,060,870,475,0,475,0,0,475
BUDAPEST,Budapest III. kerület,061,853,464,0,464,0,1,463
BUDAPEST,Budapest III. kerület,062,891,409,0,409,0,1,408
BUDAPEST,Budapest III. kerület,063,876,385,0,385,0,1,384
BUDAPEST,Budapest III. kerület,064,749,415,0,415,0,2,413
BUDAPEST,Budapest III. kerület,065,980,571,2,566,-5,1,565
BUDAPEST,Budapest III. kerület,066,840,455,2,453,-2,3,450
BUDAPEST,Budapest III. kerület,067,827,440,0,440,0,2,438
BUDAPEST,Budapest III. kerület,068,810,571,0,571,0,1,570
BUDAPEST,Budapest III. kerület,069,812,498,0,498,0,0,498
BUDAPEST,Budapest III. kerület,070,839,497,2,494,-3,1,493
BUDAPEST,Budapest III. kerület,071,918,538,0,538,0,1,537
BUDAPEST,Budapest III. kerület,072,914,530,0,530,0,4,526
BUDAPEST,Budapest III. kerület,073,845,534,0,534,0,2,532
BUDAPEST,Budapest III. kerület,074,896,574,0,574,0,0,574
BUDAPEST,Budapest III. kerület,075,756,468,1,466,-2,1,465
BUDAPEST,Budapest III. kerület,076,945,565,0,565,0,2,563
BUDAPEST,Budapest III. kerület,077,894,574,0,571,-3,1,570
BUDAPEST,Budapest III. kerület,078,838,523,0,523,0,0,523
BUDAPEST,Budapest III. kerület,079,892,558,0,558,0,1,557
BUDAPEST,Budapest III. kerület,080,871,527,1,526,-1,1,525
BUDAPEST,Budapest III. kerület,081,915,563,0,563,0,3,560
BUDAPEST,Budapest III. kerület,082,1025,650,0,650,0,2,648
BUDAPEST,Budapest III. kerület,083,972,646,0,644,-2,1,643
BUDAPEST,Budapest III. kerület,084,889,534,1,532,-2,1,531
BUDAPEST,Budapest III. kerület,085,814,431,0,431,0,0,431
BUDAPEST,Budapest III. kerület,086,822,330,0,330,0,0,330
BUDAPEST,Budapest III. kerület,087,954,446,0,446,0,2,444
BUDAPEST,Budapest III. kerület,088,881,478,0,478,0,3,475
BUDAPEST,Budapest III. kerület,089,987,465,0,465,0,2,463
BUDAPEST,Budapest III. kerület,090,835,335,0,335,0,0,335
BUDAPEST,Budapest III. kerület,091,805,382,0,382,0,0,382
BUDAPEST,Budapest III. kerület,092,994,446,1,446,0,2,444
BUDAPEST,Budapest III. kerület,093,886,432,0,431,-1,3,428
BUDAPEST,Budapest III. kerület,094,819,395,0,393,-2,1,392
BUDAPEST,Budapest III. kerület,095,819,353,2,350,-3,2,348
BUDAPEST,Budapest III. kerület,096,980,480,0,480,0,0,480
BUDAPEST,Budapest III. kerület,097,997,446,0,446,0,3,443
BUDAPEST,Budapest III. kerület,098,728,276,0,276,0,0,276
BUDAPEST,Budapest III. kerület,099,977,428,0,427,-1,1,426
BUDAPEST,Budapest III. kerület,100,873,375,0,375,0,1,374
BUDAPEST,Budapest III. kerület,101,905,342,0,342,0,5,337
BUDAPEST,Budapest III. kerület,102,916,416,0,415,-1,1,414
BUDAPEST,Budapest III. kerület,103,848,447,0,447,0,1,446
BUDAPEST,Budapest III. kerület,104,781,351,0,351,0,1,350
BUDAPEST,Budapest III. kerület,105,757,371,0,370,-1,1,369
BUDAPEST,Budapest III. kerület,106,843,441,0,441,0,3,438
BUDAPEST,Budapest III. kerület,107,781,426,0,426,0,3,423
BUDAPEST,Budapest III. kerület,108,854,423,0,423,0,3,420
BUDAPEST,Budapest III. kerület,109,825,407,0,407,0,1,406
BUDAPEST,Budapest III. kerület,110,824,391,0,391,0,0,391
BUDAPEST,Budapest III. kerület,111,770,375,0,375,0,2,373
BUDAPEST,Budapest III. kerület,112,826,342,0,342,0,1,341
BUDAPEST,Budapest IV. kerület,001,1202,690,0,690,0,0,690
BUDAPEST,Budapest IV. kerület,002,1142,550,0,550,0,0,550
BUDAPEST,Budapest IV. kerület,003,1180,620,0,619,-1,0,619
BUDAPEST,Budapest IV. kerület,004,1350,792,0,792,0,0,792
BUDAPEST,Budapest IV. kerület,005,1267,556,0,555,-1,2,553
BUDAPEST,Budapest IV. kerület,006,1275,708,0,708,0,1,707
BUDAPEST,Budapest IV. kerület,007,1248,559,0,559,0,4,555
BUDAPEST,Budapest IV. kerület,008,1009,483,0,483,0,1,482
BUDAPEST,Budapest IV. kerület,009,1058,528,0,528,0,1,527
BUDAPEST,Budapest IV. kerület,010,1159,586,0,586,0,0,586
BUDAPEST,Budapest IV. kerület,011,980,515,0,515,0,0,515
BUDAPEST,Budapest IV. kerület,012,1048,471,0,471,0,2,469
BUDAPEST,Budapest IV. kerület,013,1045,443,0,443,0,2,441
BUDAPEST,Budapest IV. kerület,014,1009,525,0,525,0,0,525
BUDAPEST,Budapest IV. kerület,015,955,449,0,448,-1,1,447
BUDAPEST,Budapest IV. kerület,016,1023,565,0,565,0,0,565
BUDAPEST,Budapest IV. kerület,017,1109,689,0,688,-1,2,686
BUDAPEST,Budapest IV. kerület,018,1086,653,0,653,0,5,648
BUDAPEST,Budapest IV. kerület,019,1000,466,0,466,0,3,463
BUDAPEST,Budapest IV. kerület,020,1007,524,0,524,0,1,523
BUDAPEST,Budapest IV. kerület,021,1057,618,0,618,0,0,618
BUDAPEST,Budapest IV. kerület,022,1071,638,0,638,0,3,635
BUDAPEST,Budapest IV. kerület,023,1037,552,0,552,0,0,552
BUDAPEST,Budapest IV. kerület,024,1099,571,0,571,0,3,568
BUDAPEST,Budapest IV. kerület,025,1061,557,0,556,-1,1,555
BUDAPEST,Budapest IV. kerület,026,1102,658,0,658,0,0,658
BUDAPEST,Budapest IV. kerület,027,1103,658,0,658,0,1,657
BUDAPEST,Budapest IV. kerület,028,1085,632,0,631,-1,0,631
BUDAPEST,Budapest IV. kerület,029,1121,613,0,613,0,3,610
BUDAPEST,Budapest IV. kerület,030,1120,504,0,503,-1,3,500
BUDAPEST,Budapest IV. kerület,031,988,398,0,398,0,0,398
BUDAPEST,Budapest IV. kerület,032,956,520,0,520,0,1,519
BUDAPEST,Budapest IV. kerület,033,1004,441,0,441,0,1,440
BUDAPEST,Budapest IV. kerület,034,988,318,0,318,0,0,318
BUDAPEST,Budapest IV. kerület,035,1128,443,0,443,0,3,440
BUDAPEST,Budapest IV. kerület,036,1072,408,0,407,-1,2,405
BUDAPEST,Budapest IV. kerület,037,1003,426,0,426,0,0,426
BUDAPEST,Budapest IV. kerület,038,1067,500,0,500,0,0,500
BUDAPEST,Budapest IV. kerület,039,976,555,0,555,0,1,554
BUDAPEST,Budapest IV. kerület,040,955,427,0,427,0,1,426
BUDAPEST,Budapest IV. kerület,041,1055,595,0,595,0,0,595
BUDAPEST,Budapest IV. kerület,042,902,438,0,438,0,0,438
BUDAPEST,Budapest IV. kerület,043,1087,526,0,526,0,4,522
BUDAPEST,Budapest IV. kerület,044,1096,547,0,547,0,2,545
BUDAPEST,Budapest IV. kerület,045,1066,501,0,500,-1,0,500
BUDAPEST,Budapest IV. kerület,046,1254,697,0,697,0,0,697
BUDAPEST,Budapest IV. kerület,047,1006,490,0,490,0,2,488
BUDAPEST,Budapest IV. kerület,048,1039,503,0,503,0,1,502
BUDAPEST,Budapest IV. kerület,049,1243,597,0,597,0,2,595
BUDAPEST,Budapest IV. kerület,050,1266,648,0,648,0,1,647
BUDAPEST,Budapest IV. kerület,051,1196,431,0,431,0,1,430
BUDAPEST,Budapest IV. kerület,052,924,507,0,507,0,1,506
BUDAPEST,Budapest IV. kerület,053,875,422,0,422,0,0,422
BUDAPEST,Budapest IV. kerület,054,1088,522,0,522,0,2,520
BUDAPEST,Budapest IV. kerület,055,1095,519,0,519,0,1,518
BUDAPEST,Budapest IV. kerület,056,1079,535,0,535,0,2,533
BUDAPEST,Budapest IV. kerület,057,963,493,0,493,0,2,491
BUDAPEST,Budapest IV. kerület,058,1276,609,0,609,0,2,607
BUDAPEST,Budapest IV. kerület,059,1017,420,0,420,0,1,419
BUDAPEST,Budapest IV. kerület,060,1142,497,0,497,0,3,494
BUDAPEST,Budapest IV. kerület,061,1172,536,0,535,-1,1,534
BUDAPEST,Budapest IV. kerület,062,984,459,0,459,0,1,458
BUDAPEST,Budapest IV. kerület,063,2856,1817,0,1817,0,4,1813
BUDAPEST,Budapest IV. kerület,064,1146,561,0,561,0,2,559
BUDAPEST,Budapest IV. kerület,065,1022,451,0,451,0,1,450
BUDAPEST,Budapest IV. kerület,066,1140,528,0,528,0,3,525
BUDAPEST,Budapest IV. kerület,067,1118,537,0,537,0,3,534
BUDAPEST,Budapest IV. kerület,068,1142,500,0,500,0,0,500
BUDAPEST,Budapest IV. kerület,069,1171,527,0,527,0,1,526
BUDAPEST,Budapest IV. kerület,070,1114,548,0,548,0,1,547
BUDAPEST,Budapest V. kerület,001,863,483,0,482,-1,2,480
BUDAPEST,Budapest V. kerület,002,742,389,0,389,0,2,387
BUDAPEST,Budapest V. kerület,003,713,423,0,423,0,2,421
BUDAPEST,Budapest V. kerület,004,893,554,0,554,0,3,551
BUDAPEST,Budapest V. kerület,005,912,516,0,514,-2,2,512
BUDAPEST,Budapest V. kerület,006,771,438,0,438,0,4,434
BUDAPEST,Budapest V. kerület,007,864,476,1,476,0,1,475
BUDAPEST,Budapest V. kerület,008,1021,544,0,544,0,4,540
BUDAPEST,Budapest V. kerület,009,826,452,0,452,0,1,451
BUDAPEST,Budapest V. kerület,010,561,309,0,309,0,0,309
BUDAPEST,Budapest V. kerület,011,1718,1232,0,1233,1,17,1216
BUDAPEST,Budapest V. kerület,012,943,496,0,487,-9,3,484
BUDAPEST,Budapest V. kerület,013,907,481,0,480,-1,1,479
BUDAPEST,Budapest V. kerület,014,970,503,0,503,0,1,502
BUDAPEST,Budapest V. kerület,015,895,484,0,484,0,2,482
BUDAPEST,Budapest V. kerület,016,812,442,0,441,-1,2,439
BUDAPEST,Budapest V. kerület,017,795,449,0,449,0,0,449
BUDAPEST,Budapest V. kerület,018,827,487,1,486,-1,8,478
BUDAPEST,Budapest V. kerület,019,823,485,0,484,-1,1,483
BUDAPEST,Budapest V. kerület,020,966,540,0,540,0,2,538
BUDAPEST,Budapest V. kerület,021,960,543,0,543,0,1,542
BUDAPEST,Budapest VI. kerület,001,816,404,1,403,-1,1,402
BUDAPEST,Budapest VI. kerület,002,681,321,0,319,-2,2,317
BUDAPEST,Budapest VI. kerület,003,725,319,0,319,0,1,318
BUDAPEST,Budapest VI. kerület,004,749,371,0,371,0,1,370
BUDAPEST,Budapest VI. kerület,005,788,394,0,394,0,0,394
BUDAPEST,Budapest VI. kerület,006,692,316,0,316,0,0,316
BUDAPEST,Budapest VI. kerület,007,761,329,1,328,-1,1,327
BUDAPEST,Budapest VI. kerület,008,693,304,1,304,0,0,304
BUDAPEST,Budapest VI. kerület,009,716,312,0,311,-1,1,310
BUDAPEST,Budapest VI. kerület,010,686,353,0,352,-1,2,350
BUDAPEST,Budapest VI. kerület,011,737,389,0,389,0,1,388
BUDAPEST,Budapest VI. kerület,012,823,373,0,373,0,1,372
BUDAPEST,Budapest VI. kerület,013,802,328,0,328,0,4,324
BUDAPEST,Budapest VI. kerület,014,913,390,0,390,0,0,390
BUDAPEST,Budapest VI. kerület,015,920,491,0,491,0,1,490
BUDAPEST,Budapest VI. kerület,016,915,402,0,402,0,0,402
BUDAPEST,Budapest VI. kerület,017,928,399,0,399,0,0,399
BUDAPEST,Budapest VI. kerület,018,975,439,0,439,0,0,439
BUDAPEST,Budapest VI. kerület,019,1004,436,0,436,0,1,435
BUDAPEST,Budapest VI. kerület,020,796,360,0,360,0,4,356
BUDAPEST,Budapest VI. kerület,021,966,512,0,512,0,2,510
BUDAPEST,Budapest VI. kerület,022,884,393,0,393,0,0,393
BUDAPEST,Budapest VI. kerület,023,976,485,0,485,0,1,484
BUDAPEST,Budapest VI. kerület,024,925,494,0,494,0,0,494
BUDAPEST,Budapest VI. kerület,025,678,342,0,342,0,1,341
BUDAPEST,Budapest VI. kerület,026,1767,1260,0,1259,-1,7,1252
BUDAPEST,Budapest VI. kerület,027,911,474,0,474,0,2,472
BUDAPEST,Budapest VI. kerület,028,782,391,1,390,-1,0,390
BUDAPEST,Budapest VI. kerület,029,920,494,0,494,0,1,493
BUDAPEST,Budapest VI. kerület,030,768,432,0,431,-1,4,427
BUDAPEST,Budapest VII. kerület,001,1087,451,0,451,0,0,451
BUDAPEST,Budapest VII. kerület,002,1184,521,0,520,-1,3,517
BUDAPEST,Budapest VII. kerület,003,1118,511,0,510,-1,0,510
BUDAPEST,Budapest VII. kerület,004,2255,1625,0,1625,0,5,1620
BUDAPEST,Budapest VII. kerület,005,873,357,0,357,0,5,352
BUDAPEST,Budapest VII. kerület,006,1105,529,0,529,0,2,527
BUDAPEST,Budapest VII. kerület,007,1229,459,0,459,0,4,455
BUDAPEST,Budapest VII. kerület,008,653,255,0,255,0,3,252
BUDAPEST,Budapest VII. kerület,009,714,300,0,300,0,0,300
BUDAPEST,Budapest VII. kerület,010,997,421,0,421,0,2,419
BUDAPEST,Budapest VII. kerület,011,958,487,0,487,0,2,485
BUDAPEST,Budapest VII. kerület,012,747,363,0,363,0,1,362
BUDAPEST,Budapest VII. kerület,013,964,455,0,455,0,1,454
BUDAPEST,Budapest VII. kerület,014,876,419,0,419,0,3,416
BUDAPEST,Budapest VII. kerület,015,1125,575,0,575,0,1,574
BUDAPEST,Budapest VII. kerület,016,857,351,0,351,0,2,349
BUDAPEST,Budapest VII. kerület,017,865,434,0,435,1,15,420
BUDAPEST,Budapest VII. kerület,018,1082,486,0,486,0,1,485
BUDAPEST,Budapest VII. kerület,019,838,417,0,417,0,1,416
BUDAPEST,Budapest VII. kerület,020,821,398,0,398,0,0,398
BUDAPEST,Budapest VII. kerület,021,1068,504,0,504,0,2,502
BUDAPEST,Budapest VII. kerület,022,950,458,0,458,0,3,455
BUDAPEST,Budapest VII. kerület,023,824,351,0,351,0,0,351
BUDAPEST,Budapest VII. kerület,024,936,412,0,412,0,6,406
BUDAPEST,Budapest VII. kerület,025,880,413,0,413,0,3,410
BUDAPEST,Budapest VII. kerület,026,858,485,0,485,0,1,484
BUDAPEST,Budapest VII. kerület,027,861,461,0,461,0,1,460
BUDAPEST,Budapest VII. kerület,028,1156,464,0,464,0,4,460
BUDAPEST,Budapest VII. kerület,029,1202,440,0,439,-1,2,437
BUDAPEST,Budapest VII. kerület,030,1205,567,0,567,0,2,565
BUDAPEST,Budapest VII. kerület,031,840,394,0,394,0,2,392
BUDAPEST,Budapest VII. kerület,032,1183,516,0,516,0,1,515
BUDAPEST,Budapest VII. kerület,033,1000,468,0,468,0,0,468
BUDAPEST,Budapest VII. kerület,034,757,347,0,347,0,0,347
BUDAPEST,Budapest VII. kerület,035,992,440,0,440,0,2,438
BUDAPEST,Budapest VII. kerület,036,883,409,0,409,0,3,406
BUDAPEST,Budapest VII. kerület,037,1030,400,0,400,0,1,399
BUDAPEST,Budapest VII. kerület,038,873,345,0,345,0,1,344
BUDAPEST,Budapest VIII. kerület,001,751,396,1,394,-2,1,393
BUDAPEST,Budapest VIII. kerület,002,717,359,0,359,0,2,357
BUDAPEST,Budapest VIII. kerület,003,667,367,0,367,0,1,366
BUDAPEST,Budapest VIII. kerület,004,673,336,0,336,0,0,336
BUDAPEST,Budapest VIII. kerület,005,761,388,0,388,0,0,388
BUDAPEST,Budapest VIII. kerület,006,647,329,0,330,1,8,322
BUDAPEST,Budapest VIII. kerület,007,983,485,0,482,-3,0,482
BUDAPEST,Budapest VIII. kerület,008,3583,2331,1,2331,0,6,2325
BUDAPEST,Budapest VIII. kerület,009,928,497,0,495,-2,1,494
BUDAPEST,Budapest VIII. kerület,010,763,406,0,406,0,5,401
BUDAPEST,Budapest VIII. kerület,011,1059,508,0,508,0,1,507
BUDAPEST,Budapest VIII. kerület,012,723,280,0,280,0,1,279
BUDAPEST,Budapest VIII. kerület,013,1027,400,0,399,-1,1,398
BUDAPEST,Budapest VIII. kerület,014,1081,472,0,472,0,2,470
BUDAPEST,Budapest VIII. kerület,015,940,349,0,349,0,2,347
BUDAPEST,Budapest VIII. kerület,016,1060,489,0,489,0,3,486
BUDAPEST,Budapest VIII. kerület,017,1029,477,0,477,0,0,477
BUDAPEST,Budapest VIII. kerület,018,760,358,0,358,0,1,357
BUDAPEST,Budapest VIII. kerület,019,884,375,0,375,0,2,373
BUDAPEST,Budapest VIII. kerület,020,1054,368,0,368,0,1,367
BUDAPEST,Budapest VIII. kerület,021,961,363,0,363,0,0,363
BUDAPEST,Budapest VIII. kerület,022,737,271,0,271,0,0,271
BUDAPEST,Budapest VIII. kerület,023,679,271,0,271,0,0,271
BUDAPEST,Budapest VIII. kerület,024,915,341,0,341,0,0,341
BUDAPEST,Budapest VIII. kerület,025,779,334,0,334,0,3,331
BUDAPEST,Budapest VIII. kerület,026,786,339,0,339,0,1,338
BUDAPEST,Budapest VIII. kerület,027,874,331,0,331,0,3,328
BUDAPEST,Budapest VIII. kerület,028,646,259,0,259,0,1,258
BUDAPEST,Budapest VIII. kerület,029,972,335,0,335,0,1,334
BUDAPEST,Budapest VIII. kerület,030,1020,295,0,295,0,0,295
BUDAPEST,Budapest VIII. kerület,031,1283,186,0,186,0,0,186
BUDAPEST,Budapest VIII. kerület,032,958,284,0,284,0,1,283
BUDAPEST,Budapest VIII. kerület,033,627,245,0,245,0,2,243
BUDAPEST,Budapest VIII. kerület,034,684,296,0,296,0,1,295
BUDAPEST,Budapest VIII. kerület,035,692,227,0,227,0,2,225
BUDAPEST,Budapest VIII. kerület,036,710,348,0,348,0,0,348
BUDAPEST,Budapest VIII. kerület,037,497,132,0,132,0,0,132
BUDAPEST,Budapest VIII. kerület,038,787,336,0,335,-1,2,333
BUDAPEST,Budapest VIII. kerület,039,754,307,0,307,0,2,305
BUDAPEST,Budapest VIII. kerület,040,695,303,0,303,0,0,303
BUDAPEST,Budapest VIII. kerület,041,914,408,0,408,0,1,407
BUDAPEST,Budapest VIII. kerület,042,1254,379,0,379,0,0,379
BUDAPEST,Budapest VIII. kerület,043,1075,357,0,357,0,3,354
BUDAPEST,Budapest VIII. kerület,044,801,198,0,196,-2,1,195
BUDAPEST,Budapest VIII. kerület,045,742,330,0,330,0,1,329
BUDAPEST,Budapest VIII. kerület,046,946,337,0,337,0,0,337
BUDAPEST,Budapest VIII. kerület,047,535,226,0,226,0,0,226
BUDAPEST,Budapest VIII. kerület,048,975,289,0,289,0,2,287
BUDAPEST,Budapest VIII. kerület,049,1281,487,0,484,-3,2,482
BUDAPEST,Budapest VIII. kerület,050,1121,328,0,328,0,5,323
BUDAPEST,Budapest VIII. kerület,051,777,211,0,211,0,1,210
BUDAPEST,Budapest VIII. kerület,052,1065,383,0,383,0,2,381
BUDAPEST,Budapest VIII. kerület,053,625,391,0,390,-1,0,390
BUDAPEST,Budapest VIII. kerület,054,1026,541,0,541,0,6,535
BUDAPEST,Budapest VIII. kerület,055,723,279,0,279,0,2,277
BUDAPEST,Budapest VIII. kerület,056,1067,489,0,489,0,3,486
BUDAPEST,Budapest VIII. kerület,057,614,305,0,305,0,1,304
BUDAPEST,Budapest VIII. kerület,058,643,373,0,373,0,1,372
BUDAPEST,Budapest VIII. kerület,059,594,252,0,252,0,1,251
BUDAPEST,Budapest VIII. kerület,060,631,213,0,213,0,0,213
BUDAPEST,Budapest IX. kerület,001,617,338,0,338,0,1,337
BUDAPEST,Budapest IX. kerület,002,597,309,0,309,0,2,307
BUDAPEST,Budapest IX. kerület,003,617,312,0,311,-1,0,311
BUDAPEST,Budapest IX. kerület,004,645,343,0,343,0,2,341
BUDAPEST,Budapest IX. kerület,005,633,305,0,305,0,3,302
BUDAPEST,Budapest IX. kerület,006,662,355,0,354,-1,0,354
BUDAPEST,Budapest IX. kerület,007,742,383,0,381,-2,2,379
BUDAPEST,Budapest IX. kerület,008,615,315,0,315,0,2,313
BUDAPEST,Budapest IX. kerület,009,3393,2607,0,2606,-1,5,2601
BUDAPEST,Budapest IX. kerület,010,649,394,0,394,0,0,394
BUDAPEST,Budapest IX. kerület,011,737,394,0,394,0,0,394
BUDAPEST,Budapest IX. kerület,012,695,366,0,366,0,1,365
BUDAPEST,Budapest IX. kerület,013,815,450,0,449,-1,1,448
BUDAPEST,Budapest IX. kerület,014,897,513,0,513,0,1,512
BUDAPEST,Budapest IX. kerület,015,617,310,0,310,0,1,309
BUDAPEST,Budapest IX. kerület,016,592,288,0,288,0,0,288
BUDAPEST,Budapest IX. kerület,017,1012,521,0,521,0,0,521
BUDAPEST,Budapest IX. kerület,018,787,362,0,362,0,2,360
BUDAPEST,Budapest IX. kerület,019,868,374,0,373,-1,1,372
BUDAPEST,Budapest IX. kerület,020,1058,357,0,357,0,2,355
BUDAPEST,Budapest IX. kerület,021,816,361,0,361,0,1,360
BUDAPEST,Budapest IX. kerület,022,807,364,0,364,0,1,363
BUDAPEST,Budapest IX. kerület,023,800,302,1,302,0,2,300
BUDAPEST,Budapest IX. kerület,024,619,302,0,302,0,0,302
BUDAPEST,Budapest IX. kerület,025,895,427,0,427,0,0,427
BUDAPEST,Budapest IX. kerület,026,745,356,0,356,0,0,356
BUDAPEST,Budapest IX. kerület,027,736,399,0,399,0,2,397
BUDAPEST,Budapest IX. kerület,028,710,394,0,394,0,2,392
BUDAPEST,Budapest IX. kerület,029,998,452,0,452,0,1,451
BUDAPEST,Budapest IX. kerület,030,962,467,0,467,0,5,462
BUDAPEST,Budapest IX. kerület,031,812,318,0,318,0,2,316
BUDAPEST,Budapest IX. kerület,032,679,274,0,274,0,0,274
BUDAPEST,Budapest IX. kerület,033,862,370,0,370,0,2,368
BUDAPEST,Budapest IX. kerület,034,665,294,0,294,0,0,294
BUDAPEST,Budapest IX. kerület,035,732,405,0,405,0,0,405
BUDAPEST,Budapest IX. kerület,036,1079,495,1,493,-2,1,492
BUDAPEST,Budapest IX. kerület,037,693,249,0,249,0,1,248
BUDAPEST,Budapest IX. kerület,038,791,224,0,224,0,0,224
BUDAPEST,Budapest IX. kerület,039,899,226,0,226,0,0,226
BUDAPEST,Budapest IX. kerület,040,655,122,0,122,0,0,122
BUDAPEST,Budapest IX. kerület,041,655,330,0,330,0,0,330
BUDAPEST,Budapest IX. kerület,042,674,379,0,378,-1,1,377
BUDAPEST,Budapest IX. kerület,043,713,400,0,400,0,1,399
BUDAPEST,Budapest IX. kerület,044,609,319,0,319,0,0,319
BUDAPEST,Budapest IX. kerület,045,832,369,0,369,0,9,360
BUDAPEST,Budapest IX. kerület,046,764,385,0,385,0,0,385
BUDAPEST,Budapest IX. kerület,047,702,371,0,371,0,0,371
BUDAPEST,Budapest IX. kerület,048,659,348,0,348,0,1,347
BUDAPEST,Budapest IX. kerület,049,875,469,0,469,0,2,467
BUDAPEST,Budapest IX. kerület,050,827,468,0,468,0,5,463
BUDAPEST,Budapest IX. kerület,051,816,445,0,446,1,10,436
BUDAPEST,Budapest IX. kerület,052,792,421,0,421,0,4,417
BUDAPEST,Budapest IX. kerület,053,712,375,0,375,0,1,374
BUDAPEST,Budapest X. kerület,001,597,307,0,306,-1,1,305
BUDAPEST,Budapest X. kerület,002,595,312,0,312,0,0,312
BUDAPEST,Budapest X. kerület,003,588,180,2,178,-2,1,177
BUDAPEST,Budapest X. kerület,004,613,187,0,187,0,1,186
BUDAPEST,Budapest X. kerület,005,596,195,0,195,0,0,195
BUDAPEST,Budapest X. kerület,006,623,219,0,219,0,0,219
BUDAPEST,Budapest X. kerület,007,579,271,0,271,0,0,271
BUDAPEST,Budapest X. kerület,008,675,258,0,258,0,0,258
BUDAPEST,Budapest X. kerület,009,985,428,0,428,0,0,428
BUDAPEST,Budapest X. kerület,010,605,269,0,269,0,0,269
BUDAPEST,Budapest X. kerület,011,710,368,0,368,0,2,366
BUDAPEST,Budapest X. kerület,012,673,400,0,400,0,0,400
BUDAPEST,Budapest X. kerület,013,740,336,0,336,0,3,333
BUDAPEST,Budapest X. kerület,014,682,298,0,298,0,1,297
BUDAPEST,Budapest X. kerület,015,727,275,0,275,0,1,274
BUDAPEST,Budapest X. kerület,016,745,367,0,367,0,0,367
BUDAPEST,Budapest X. kerület,017,709,321,0,321,0,2,319
BUDAPEST,Budapest X. kerület,018,725,285,0,285,0,0,285
BUDAPEST,Budapest X. kerület,019,713,340,0,340,0,3,337
BUDAPEST,Budapest X. kerület,020,867,335,0,335,0,1,334
BUDAPEST,Budapest X. kerület,021,937,364,0,364,0,2,362
BUDAPEST,Budapest X. kerület,022,767,434,0,433,-1,1,432
BUDAPEST,Budapest X. kerület,023,711,337,0,337,0,1,336
BUDAPEST,Budapest X. kerület,024,810,358,0,358,0,2,356
BUDAPEST,Budapest X. kerület,025,571,259,0,259,0,1,258
BUDAPEST,Budapest X. kerület,026,605,309,0,309,0,0,309
BUDAPEST,Budapest X. kerület,027,807,331,0,331,0,3,328
BUDAPEST,Budapest X. kerület,028,764,328,0,328,0,2,326
BUDAPEST,Budapest X. kerület,029,791,382,0,382,0,1,381
BUDAPEST,Budapest X. kerület,030,670,315,0,315,0,0,315
BUDAPEST,Budapest X. kerület,031,802,429,0,429,0,2,427
BUDAPEST,Budapest X. kerület,032,871,543,0,543,0,1,542
BUDAPEST,Budapest X. kerület,033,730,266,0,266,0,2,264
BUDAPEST,Budapest X. kerület,034,780,293,0,293,0,0,293
BUDAPEST,Budapest X. kerület,035,2427,1606,0,1604,-2,6,1598
BUDAPEST,Budapest X. kerület,036,800,372,0,372,0,1,371
BUDAPEST,Budapest X. kerület,037,840,334,0,334,0,1,333
BUDAPEST,Budapest X. kerület,038,776,383,0,383,0,3,380
BUDAPEST,Budapest X. kerület,039,618,270,0,270,0,0,270
BUDAPEST,Budapest X. kerület,040,614,270,0,270,0,0,270
BUDAPEST,Budapest X. kerület,041,613,333,0,333,0,1,332
BUDAPEST,Budapest X. kerület,042,682,311,0,311,0,0,311
BUDAPEST,Budapest X. kerület,043,644,290,0,289,-1,2,287
BUDAPEST,Budapest X. kerület,044,662,342,0,342,0,0,342
BUDAPEST,Budapest X. kerület,045,583,323,0,323,0,0,323
BUDAPEST,Budapest X. kerület,046,585,249,0,249,0,1,248
BUDAPEST,Budapest X. kerület,047,659,272,0,272,0,6,266
BUDAPEST,Budapest X. kerület,048,728,244,0,244,0,1,243
BUDAPEST,Budapest X. kerület,049,632,211,2,211,0,0,211
BUDAPEST,Budapest X. kerület,050,793,259,0,259,0,2,257
BUDAPEST,Budapest X. kerület,051,640,331,0,331,0,2,329
BUDAPEST,Budapest X. kerület,052,668,343,0,343,0,1,342
BUDAPEST,Budapest X. kerület,053,649,349,0,349,0,0,349
BUDAPEST,Budapest X. kerület,054,677,397,0,397,0,1,396
BUDAPEST,Budapest X. kerület,055,701,327,0,327,0,4,323
BUDAPEST,Budapest X. kerület,056,845,327,0,327,0,0,327
BUDAPEST,Budapest X. kerület,057,826,357,0,357,0,0,357
BUDAPEST,Budapest X. kerület,058,645,276,0,276,0,1,275
BUDAPEST,Budapest X. kerület,059,598,252,0,252,0,2,250
BUDAPEST,Budapest X. kerület,060,712,276,0,276,0,2,274
BUDAPEST,Budapest X. kerület,061,803,387,0,387,0,0,387
BUDAPEST,Budapest X. kerület,062,731,322,1,320,-2,0,320
BUDAPEST,Budapest X. kerület,063,827,357,2,356,-1,0,356
BUDAPEST,Budapest X. kerület,064,754,349,0,349,0,5,344
BUDAPEST,Budapest X. kerület,065,754,327,1,326,-1,0,326
BUDAPEST,Budapest X. kerület,066,799,346,0,346,0,0,346
BUDAPEST,Budapest X. kerület,067,749,301,0,301,0,1,300
BUDAPEST,Budapest X. kerület,068,676,339,0,339,0,0,339
BUDAPEST,Budapest X. kerület,069,705,301,0,301,0,3,298
BUDAPEST,Budapest X. kerület,070,925,410,0,410,0,2,408
BUDAPEST,Budapest X. kerület,071,888,410,0,410,0,1,409
BUDAPEST,Budapest X. kerület,072,880,391,0,391,0,3,388
BUDAPEST,Budapest X. kerület,073,869,343,0,343,0,0,343
BUDAPEST,Budapest X. kerület,074,804,317,0,317,0,1,316
BUDAPEST,Budapest X. kerület,075,635,369,0,369,0,2,367
BUDAPEST,Budapest X. kerület,076,681,360,0,360,0,0,360
BUDAPEST,Budapest XI. kerület,001,765,462,0,461,-1,1,460
BUDAPEST,Budapest XI. kerület,002,843,522,0,522,0,4,518
BUDAPEST,Budapest XI. kerület,003,770,528,0,528,0,1,527
BUDAPEST,Budapest XI. kerület,004,810,493,0,492,-1,1,491
BUDAPEST,Budapest XI. kerület,005,819,540,0,539,-1,2,537
BUDAPEST,Budapest XI. kerület,006,862,526,0,526,0,0,526
BUDAPEST,Budapest XI. kerület,007,793,461,1,461,0,3,458
BUDAPEST,Budapest XI. kerület,008,678,427,0,427,0,0,427
BUDAPEST,Budapest XI. kerület,009,752,450,0,450,0,0,450
BUDAPEST,Budapest XI. kerület,010,1053,602,0,602,0,5,597
BUDAPEST,Budapest XI. kerület,011,968,578,0,578,0,2,576
BUDAPEST,Budapest XI. kerület,012,865,500,0,500,0,1,499
BUDAPEST,Budapest XI. kerület,013,778,474,0,474,0,1,473
BUDAPEST,Budapest XI. kerület,014,958,590,0,586,-4,2,584
BUDAPEST,Budapest XI. kerület,015,759,450,1,449,-1,5,444
BUDAPEST,Budapest XI. kerület,016,782,443,0,443,0,1,442
BUDAPEST,Budapest XI. kerület,017,776,426,0,425,-1,4,421
BUDAPEST,Budapest XI. kerület,018,898,506,0,506,0,1,505
BUDAPEST,Budapest XI. kerület,019,763,411,0,411,0,1,410
BUDAPEST,Budapest XI. kerület,020,791,448,0,448,0,0,448
BUDAPEST,Budapest XI. kerület,021,811,464,0,464,0,1,463
BUDAPEST,Budapest XI. kerület,022,674,454,0,454,0,0,454
BUDAPEST,Budapest XI. kerület,023,816,529,0,529,0,4,525
BUDAPEST,Budapest XI. kerület,024,786,468,0,468,0,1,467
BUDAPEST,Budapest XI. kerület,025,816,486,1,486,0,3,483
BUDAPEST,Budapest XI. kerület,026,923,568,0,568,0,2,566
BUDAPEST,Budapest XI. kerület,027,852,467,0,467,0,4,463
BUDAPEST,Budapest XI. kerület,028,1061,612,0,612,0,3,609
BUDAPEST,Budapest XI. kerület,029,838,487,0,487,0,1,486
BUDAPEST,Budapest XI. kerület,030,792,473,0,473,0,1,472
BUDAPEST,Budapest XI. kerület,031,1030,600,0,600,0,0,600
BUDAPEST,Budapest XI. kerület,032,1074,641,0,641,0,2,639
BUDAPEST,Budapest XI. kerület,033,609,420,0,420,0,2,418
BUDAPEST,Budapest XI. kerület,034,1045,622,0,621,-1,1,620
BUDAPEST,Budapest XI. kerület,035,831,507,0,507,0,1,506
BUDAPEST,Budapest XI. kerület,036,769,523,0,522,-1,4,518
BUDAPEST,Budapest XI. kerület,037,898,609,1,607,-2,1,606
BUDAPEST,Budapest XI. kerület,038,878,581,0,581,0,0,581
BUDAPEST,Budapest XI. kerület,039,767,531,0,531,0,1,530
BUDAPEST,Budapest XI. kerület,040,934,635,0,635,0,0,635
BUDAPEST,Budapest XI. kerület,041,962,678,0,678,0,0,678
BUDAPEST,Budapest XI. kerület,042,884,617,0,615,-2,5,610
BUDAPEST,Budapest XI. kerület,043,834,605,0,605,0,1,604
BUDAPEST,Budapest XI. kerület,044,912,638,0,637,-1,1,636
BUDAPEST,Budapest XI. kerület,045,1122,789,0,788,-1,1,787
BUDAPEST,Budapest XI. kerület,046,935,636,0,636,0,2,634
BUDAPEST,Budapest XI. kerület,047,997,699,0,699,0,2,697
BUDAPEST,Budapest XI. kerület,048,854,479,0,480,1,10,470
BUDAPEST,Budapest XI. kerület,049,904,506,0,505,-1,2,503
BUDAPEST,Budapest XI. kerület,050,764,508,0,508,0,0,508
BUDAPEST,Budapest XI. kerület,051,811,521,0,521,0,4,517
BUDAPEST,Budapest XI. kerület,052,803,495,0,495,0,0,495
BUDAPEST,Budapest XI. kerület,053,865,528,0,528,0,4,524
BUDAPEST,Budapest XI. kerület,054,846,519,0,519,0,1,518
BUDAPEST,Budapest XI. kerület,055,773,488,0,487,-1,1,486
BUDAPEST,Budapest XI. kerület,056,4176,3125,0,3124,-1,6,3118
BUDAPEST,Budapest XI. kerület,057,740,438,0,438,0,3,435
BUDAPEST,Budapest XI. kerület,058,761,466,0,466,0,3,463
BUDAPEST,Budapest XI. kerület,059,1006,593,0,588,-5,2,586
BUDAPEST,Budapest XI. kerület,060,1026,622,0,622,0,0,622
BUDAPEST,Budapest XI. kerület,061,1045,633,1,633,0,2,631
BUDAPEST,Budapest XI. kerület,062,1057,690,0,690,0,3,687
BUDAPEST,Budapest XI. kerület,063,972,591,0,591,0,1,590
BUDAPEST,Budapest XI. kerület,064,892,498,0,498,0,6,492
BUDAPEST,Budapest XI. kerület,065,1092,619,0,618,-1,6,612
BUDAPEST,Budapest XI. kerület,066,802,431,0,431,0,1,430
BUDAPEST,Budapest XI. kerület,067,914,468,0,468,0,0,468
BUDAPEST,Budapest XI. kerület,068,745,335,1,333,-2,3,330
BUDAPEST,Budapest XI. kerület,069,817,498,0,495,-3,1,494
BUDAPEST,Budapest XI. kerület,070,952,621,0,621,0,3,618
BUDAPEST,Budapest XI. kerület,071,787,429,0,429,0,1,428
BUDAPEST,Budapest XI. kerület,072,687,374,0,374,0,1,373
BUDAPEST,Budapest XI. kerület,073,968,531,0,531,0,1,530
BUDAPEST,Budapest XI. kerület,074,1099,666,0,666,0,3,663
BUDAPEST,Budapest XI. kerület,075,950,526,0,526,0,2,524
BUDAPEST,Budapest XI. kerület,076,1127,610,0,610,0,1,609
BUDAPEST,Budapest XI. kerület,077,1090,589,0,589,0,2,587
BUDAPEST,Budapest XI. kerület,078,973,592,0,592,0,2,590
BUDAPEST,Budapest XI. kerület,079,1132,610,0,610,0,1,609
BUDAPEST,Budapest XI. kerület,080,1089,542,0,542,0,0,542
BUDAPEST,Budapest XI. kerület,081,988,607,0,607,0,3,604
BUDAPEST,Budapest XI. kerület,082,1096,638,0,637,-1,4,633
BUDAPEST,Budapest XI. kerület,083,812,459,0,459,0,1,458
BUDAPEST,Budapest XI. kerület,084,839,385,1,384,-1,1,383
BUDAPEST,Budapest XI. kerület,085,997,498,0,498,0,1,497
BUDAPEST,Budapest XI. kerület,086,1079,575,0,575,0,3,572
BUDAPEST,Budapest XI. kerület,087,727,340,0,340,0,1,339
BUDAPEST,Budapest XI. kerület,088,770,487,0,486,-1,1,485
BUDAPEST,Budapest XI. kerület,089,859,446,0,446,0,1,445
BUDAPEST,Budapest XI. kerület,090,713,369,0,369,0,2,367
BUDAPEST,Budapest XI. kerület,091,965,462,0,462,0,2,460
BUDAPEST,Budapest XI. kerület,092,669,363,0,363,0,0,363
BUDAPEST,Budapest XI. kerület,093,812,458,0,457,-1,3,454
BUDAPEST,Budapest XI. kerület,094,1114,559,0,559,0,5,554
BUDAPEST,Budapest XI. kerület,095,1139,490,0,490,0,2,488
BUDAPEST,Budapest XI. kerület,096,751,394,0,394,0,2,392
BUDAPEST,Budapest XI. kerület,097,874,486,0,486,0,5,481
BUDAPEST,Budapest XI. kerület,098,864,530,0,530,0,0,530
BUDAPEST,Budapest XI. kerület,099,1026,686,0,686,0,0,686
BUDAPEST,Budapest XI. kerület,100,1030,625,0,625,0,3,622
BUDAPEST,Budapest XI. kerület,101,931,500,0,499,-1,1,498
BUDAPEST,Budapest XI. kerület,102,824,429,0,429,0,3,426
BUDAPEST,Budapest XI. kerület,103,714,383,0,383,0,2,381
BUDAPEST,Budapest XI. kerület,104,749,483,0,483,0,3,480
BUDAPEST,Budapest XI. kerület,105,709,416,0,415,-1,2,413
BUDAPEST,Budapest XI. kerület,106,830,502,0,502,0,1,501
BUDAPEST,Budapest XI. kerület,107,869,550,0,550,0,0,550
BUDAPEST,Budapest XI. kerület,108,805,514,0,514,0,4,510
BUDAPEST,Budapest XI. kerület,109,967,579,0,579,0,2,577
BUDAPEST,Budapest XI. kerület,110,1000,631,0,631,0,2,629
BUDAPEST,Budapest XI. kerület,111,812,508,0,507,-1,1,506
BUDAPEST,Budapest XI. kerület,112,1138,619,0,619,0,2,617
BUDAPEST,Budapest XI. kerület,113,1141,404,0,404,0,4,400
BUDAPEST,Budapest XII. kerület,001,692,431,0,431,0,1,430
BUDAPEST,Budapest XII. kerület,002,683,382,0,381,-1,1,380
BUDAPEST,Budapest XII. kerület,003,509,281,0,281,0,4,277
BUDAPEST,Budapest XII. kerület,004,761,497,0,497,0,4,493
BUDAPEST,Budapest XII. kerület,005,636,317,0,317,0,0,317
BUDAPEST,Budapest XII. kerület,006,556,328,0,328,0,2,326
BUDAPEST,Budapest XII. kerület,007,767,461,0,461,0,3,458
BUDAPEST,Budapest XII. kerület,008,846,533,0,533,0,1,532
BUDAPEST,Budapest XII. kerület,009,891,582,0,582,0,2,580
BUDAPEST,Budapest XII. kerület,010,942,607,0,607,0,4,603
BUDAPEST,Budapest XII. kerület,011,784,533,0,532,-1,2,530
BUDAPEST,Budapest XII. kerület,012,936,618,0,618,0,5,613
BUDAPEST,Budapest XII. kerület,013,612,408,0,408,0,0,408
BUDAPEST,Budapest XII. kerület,014,642,400,0,399,-1,1,398
BUDAPEST,Budapest XII. kerület,015,688,439,0,439,0,0,439
BUDAPEST,Budapest XII. kerület,016,668,449,0,449,0,1,448
BUDAPEST,Budapest XII. kerület,017,939,511,0,511,0,1,510
BUDAPEST,Budapest XII. kerület,018,865,530,0,530,0,0,530
BUDAPEST,Budapest XII. kerület,019,801,519,0,519,0,4,515
BUDAPEST,Budapest XII. kerület,020,750,448,0,448,0,4,444
BUDAPEST,Budapest XII. kerület,021,736,446,0,446,0,6,440
BUDAPEST,Budapest XII. kerület,022,504,344,0,344,0,1,343
BUDAPEST,Budapest XII. kerület,023,2339,1893,0,1893,0,9,1884
BUDAPEST,Budapest XII. kerület,024,578,394,0,394,0,0,394
BUDAPEST,Budapest XII. kerület,025,772,520,0,520,0,1,519
BUDAPEST,Budapest XII. kerület,026,710,492,0,492,0,1,491
BUDAPEST,Budapest XII. kerület,027,696,495,0,495,0,2,493
BUDAPEST,Budapest XII. kerület,028,988,598,0,598,0,6,592
BUDAPEST,Budapest XII. kerület,029,702,451,0,451,0,2,449
BUDAPEST,Budapest XII. kerület,030,901,596,0,596,0,1,595
BUDAPEST,Budapest XII. kerület,031,706,404,0,404,0,2,402
BUDAPEST,Budapest XII. kerület,032,781,486,0,484,-2,3,481
BUDAPEST,Budapest XII. kerület,033,941,523,0,522,-1,2,520
BUDAPEST,Budapest XII. kerület,034,842,564,0,564,0,9,555
BUDAPEST,Budapest XII. kerület,035,855,591,0,591,0,0,591
BUDAPEST,Budapest XII. kerület,036,679,450,0,450,0,0,450
BUDAPEST,Budapest XII. kerület,037,747,501,0,501,0,2,499
BUDAPEST,Budapest XII. kerület,038,953,612,0,611,-1,4,607
BUDAPEST,Budapest XII. kerület,039,942,623,0,623,0,2,621
BUDAPEST,Budapest XII. kerület,040,765,522,0,522,0,3,519
BUDAPEST,Budapest XII. kerület,041,572,354,0,354,0,3,351
BUDAPEST,Budapest XII. kerület,042,840,583,0,583,0,1,582
BUDAPEST,Budapest XII. kerület,043,898,562,0,562,0,3,559
BUDAPEST,Budapest XII. kerület,044,977,636,0,636,0,1,635
BUDAPEST,Budapest XII. kerület,045,618,365,0,365,0,2,363
BUDAPEST,Budapest XII. kerület,046,940,595,0,594,-1,0,594
BUDAPEST,Budapest XII. kerület,047,1020,645,0,645,0,0,645
BUDAPEST,Budapest XII. kerület,048,874,470,0,470,0,1,469
BUDAPEST,Budapest XII. kerület,049,850,514,0,513,-1,3,510
BUDAPEST,Budapest XII. kerület,050,778,548,0,548,0,0,548
BUDAPEST,Budapest XII. kerület,051,575,369,0,369,0,2,367
BUDAPEST,Budapest XII. kerület,052,912,601,0,601,0,2,599
BUDAPEST,Budapest XII. kerület,053,876,543,0,543,0,4,539
BUDAPEST,Budapest XII. kerület,054,701,454,0,455,1,10,445
BUDAPEST,Budapest XII. kerület,055,721,457,0,456,-1,4,452
BUDAPEST,Budapest XIII. kerület,001,1090,493,0,486,-7,2,484
BUDAPEST,Budapest XIII. kerület,002,951,506,0,506,0,1,505
BUDAPEST,Budapest XIII. kerület,003,1000,578,0,578,0,2,576
BUDAPEST,Budapest XIII. kerület,004,931,558,0,556,-2,0,556
BUDAPEST,Budapest XIII. kerület,005,940,612,0,612,0,2,610
BUDAPEST,Budapest XIII. kerület,006,1181,645,0,646,1,12,634
BUDAPEST,Budapest XIII. kerület,007,1025,532,0,532,0,2,530
BUDAPEST,Budapest XIII. kerület,008,1090,592,0,591,-1,2,589
BUDAPEST,Budapest XIII. kerület,009,1108,697,6,691,-6,4,687
BUDAPEST,Budapest XIII. kerület,010,1036,662,0,662,0,2,660
BUDAPEST,Budapest XIII. kerület,011,751,504,0,504,0,5,499
BUDAPEST,Budapest XIII. kerület,012,952,522,0,522,0,0,522
BUDAPEST,Budapest XIII. kerület,013,980,535,0,533,-2,1,532
BUDAPEST,Budapest XIII. kerület,014,1047,590,2,588,-2,1,587
BUDAPEST,Budapest XIII. kerület,015,1069,629,0,627,-2,1,626
BUDAPEST,Budapest XIII. kerület,016,850,534,0,534,0,0,534
BUDAPEST,Budapest XIII. kerület,017,1133,753,0,752,-1,5,747
BUDAPEST,Budapest XIII. kerület,018,1088,640,0,640,0,3,637
BUDAPEST,Budapest XIII. kerület,019,1139,648,0,648,0,3,645
BUDAPEST,Budapest XIII. kerület,020,1187,598,0,598,0,1,597
BUDAPEST,Budapest XIII. kerület,021,1166,690,0,689,-1,1,688
BUDAPEST,Budapest XIII. kerület,022,1208,610,0,610,0,6,604
BUDAPEST,Budapest XIII. kerület,023,1093,598,0,598,0,2,596
BUDAPEST,Budapest XIII. kerület,024,1206,632,0,630,-2,4,626
BUDAPEST,Budapest XIII. kerület,025,793,423,0,423,0,2,421
BUDAPEST,Budapest XIII. kerület,026,1000,396,0,396,0,4,392
BUDAPEST,Budapest XIII. kerület,027,1014,404,1,403,-1,1,402
BUDAPEST,Budapest XIII. kerület,028,927,522,0,522,0,6,516
BUDAPEST,Budapest XIII. kerület,029,1011,559,0,559,0,2,557
BUDAPEST,Budapest XIII. kerület,030,1010,567,0,567,0,2,565
BUDAPEST,Budapest XIII. kerület,031,978,577,0,576,-1,0,576
BUDAPEST,Budapest XIII. kerület,032,972,559,1,558,-1,1,557
BUDAPEST,Budapest XIII. kerület,033,1017,451,0,451,0,2,449
BUDAPEST,Budapest XIII. kerület,034,3972,2928,0,2927,-1,3,2924
BUDAPEST,Budapest XIII. kerület,035,1211,663,0,663,0,1,662
BUDAPEST,Budapest XIII. kerület,036,1106,501,0,501,0,0,501
BUDAPEST,Budapest XIII. kerület,037,1125,593,0,587,-6,3,584
BUDAPEST,Budapest XIII. kerület,038,1072,523,1,523,0,1,522
BUDAPEST,Budapest XIII. kerület,039,1072,569,0,569,0,2,567
BUDAPEST,Budapest XIII. kerület,040,886,144,0,144,0,1,143
BUDAPEST,Budapest XIII. kerület,041,984,409,0,409,0,3,406
BUDAPEST,Budapest XIII. kerület,042,883,400,0,400,0,2,398
BUDAPEST,Budapest XIII. kerület,043,730,258,0,258,0,2,256
BUDAPEST,Budapest XIII. kerület,044,985,525,0,525,0,0,525
BUDAPEST,Budapest XIII. kerület,045,1060,343,0,343,0,0,343
BUDAPEST,Budapest XIII. kerület,046,970,287,0,287,0,4,283
BUDAPEST,Budapest XIII. kerület,047,940,411,0,411,0,1,410
BUDAPEST,Budapest XIII. kerület,048,1183,473,0,473,0,4,469
BUDAPEST,Budapest XIII. kerület,049,1089,435,0,435,0,2,433
BUDAPEST,Budapest XIII. kerület,050,984,484,0,484,0,4,480
BUDAPEST,Budapest XIII. kerület,051,937,430,0,430,0,0,430
BUDAPEST,Budapest XIII. kerület,052,1026,404,0,403,-1,2,401
BUDAPEST,Budapest XIII. kerület,053,922,481,0,481,0,1,480
BUDAPEST,Budapest XIII. kerület,054,911,509,0,509,0,1,508
BUDAPEST,Budapest XIII. kerület,055,862,451,0,451,0,4,447
BUDAPEST,Budapest XIII. kerület,056,783,410,0,410,0,1,409
BUDAPEST,Budapest XIII. kerület,057,988,474,0,474,0,0,474
BUDAPEST,Budapest XIII. kerület,058,1126,457,0,457,0,0,457
BUDAPEST,Budapest XIII. kerület,059,1002,469,0,469,0,0,469
BUDAPEST,Budapest XIII. kerület,060,1028,534,0,534,0,2,532
BUDAPEST,Budapest XIII. kerület,061,945,494,0,494,0,3,491
BUDAPEST,Budapest XIII. kerület,062,635,347,0,347,0,2,345
BUDAPEST,Budapest XIII. kerület,063,1284,554,0,554,0,6,548
BUDAPEST,Budapest XIII. kerület,064,1007,453,0,453,0,0,453
BUDAPEST,Budapest XIII. kerület,065,860,359,0,357,-2,1,356
BUDAPEST,Budapest XIII. kerület,066,886,500,0,500,0,5,495
BUDAPEST,Budapest XIII. kerület,067,1150,606,0,605,-1,0,605
BUDAPEST,Budapest XIII. kerület,068,1186,660,0,659,-1,0,659
BUDAPEST,Budapest XIII. kerület,069,1123,627,0,627,0,1,626
BUDAPEST,Budapest XIII. kerület,070,904,439,0,437,-2,5,432
BUDAPEST,Budapest XIII. kerület,071,1186,519,0,519,0,6,513
BUDAPEST,Budapest XIII. kerület,072,770,380,0,380,0,2,378
BUDAPEST,Budapest XIII. kerület,073,1161,563,0,563,0,1,562
BUDAPEST,Budapest XIII. kerület,074,1054,468,0,468,0,0,468
BUDAPEST,Budapest XIII. kerület,075,781,382,0,382,0,1,381
BUDAPEST,Budapest XIII. kerület,076,1244,407,0,407,0,5,402
BUDAPEST,Budapest XIII. kerület,077,1132,670,0,669,-1,2,667
BUDAPEST,Budapest XIII. kerület,078,905,446,0,445,-1,1,444
BUDAPEST,Budapest XIII. kerület,079,1130,619,0,617,-2,0,617
BUDAPEST,Budapest XIII. kerület,080,943,464,0,464,0,10,454
BUDAPEST,Budapest XIII. kerület,081,806,448,0,448,0,3,445
BUDAPEST,Budapest XIII. kerület,082,1251,678,0,676,-2,2,674
BUDAPEST,Budapest XIII. kerület,083,1300,618,0,617,-1,6,611
BUDAPEST,Budapest XIII. kerület,084,1064,514,0,514,0,3,511
BUDAPEST,Budapest XIII. kerület,085,1016,417,0,417,0,1,416
BUDAPEST,Budapest XIII. kerület,086,707,320,0,320,0,2,318
BUDAPEST,Budapest XIII. kerület,087,779,443,0,443,0,0,443
BUDAPEST,Budapest XIV. kerület,001,1063,615,0,615,0,0,615
BUDAPEST,Budapest XIV. kerület,002,1089,540,0,540,0,0,540
BUDAPEST,Budapest XIV. kerület,003,1067,634,0,633,-1,5,628
BUDAPEST,Budapest XIV. kerület,004,1144,671,0,671,0,2,669
BUDAPEST,Budapest XIV. kerület,005,1396,743,0,743,0,3,740
BUDAPEST,Budapest XIV. kerület,006,1185,670,0,670,0,3,667
BUDAPEST,Budapest XIV. kerület,007,1160,596,0,595,-1,3,592
BUDAPEST,Budapest XIV. kerület,008,1130,565,0,564,-1,1,563
BUDAPEST,Budapest XIV. kerület,009,1104,508,0,508,0,3,505
BUDAPEST,Budapest XIV. kerület,010,1093,546,0,546,0,4,542
BUDAPEST,Budapest XIV. kerület,011,1227,601,0,601,0,7,594
BUDAPEST,Budapest XIV. kerület,012,1078,530,0,530,0,5,525
BUDAPEST,Budapest XIV. kerület,013,995,466,0,466,0,3,463
BUDAPEST,Budapest XIV. kerület,014,1260,460,0,459,-1,2,457
BUDAPEST,Budapest XIV. kerület,015,1072,494,0,494,0,2,492
BUDAPEST,Budapest XIV. kerület,016,1212,712,0,712,0,7,705
BUDAPEST,Budapest XIV. kerület,017,1103,650,0,651,1,10,641
BUDAPEST,Budapest XIV. kerület,018,1159,610,0,610,0,1,609
BUDAPEST,Budapest XIV. kerület,019,1191,657,0,657,0,3,654
BUDAPEST,Budapest XIV. kerület,020,1270,757,0,757,0,2,755
BUDAPEST,Budapest XIV. kerület,021,1288,739,0,740,1,9,731
BUDAPEST,Budapest XIV. kerület,022,1170,525,0,525,0,4,521
BUDAPEST,Budapest XIV. kerület,023,3971,2866,1,2865,-1,4,2861
BUDAPEST,Budapest XIV. kerület,024,1168,624,0,624,0,2,622
BUDAPEST,Budapest XIV. kerület,025,1191,676,0,676,0,0,676
BUDAPEST,Budapest XIV. kerület,026,1173,585,0,585,0,1,584
BUDAPEST,Budapest XIV. kerület,027,1169,656,1,655,-1,3,652
BUDAPEST,Budapest XIV. kerület,028,1103,514,0,513,-1,0,513
BUDAPEST,Budapest XIV. kerület,029,1199,686,0,686,0,1,685
BUDAPEST,Budapest XIV. kerület,030,1139,624,0,627,3,28,599
BUDAPEST,Budapest XIV. kerület,031,1367,610,0,610,0,5,605
BUDAPEST,Budapest XIV. kerület,032,1207,705,0,705,0,1,704
BUDAPEST,Budapest XIV. kerület,033,1163,654,0,654,0,0,654
BUDAPEST,Budapest XIV. kerület,034,1193,649,0,649,0,4,645
BUDAPEST,Budapest XIV. kerület,035,1163,735,1,733,-2,5,728
BUDAPEST,Budapest XIV. kerület,036,1172,708,0,708,0,2,706
BUDAPEST,Budapest XIV. kerület,037,1271,744,0,744,0,0,744
BUDAPEST,Budapest XIV. kerület,038,1304,802,0,802,0,1,801
BUDAPEST,Budapest XIV. kerület,039,1024,569,0,569,0,2,567
BUDAPEST,Budapest XIV. kerület,040,997,608,0,607,-1,2,605
BUDAPEST,Budapest XIV. kerület,041,1209,733,0,732,-1,2,730
BUDAPEST,Budapest XIV. kerület,042,1060,639,0,639,0,1,638
BUDAPEST,Budapest XIV. kerület,043,1204,715,0,713,-2,4,709
BUDAPEST,Budapest XIV. kerület,044,1225,705,0,705,0,3,702
BUDAPEST,Budapest XIV. kerület,045,1223,603,0,603,0,4,599
BUDAPEST,Budapest XIV. kerület,046,1163,637,0,637,0,8,629
BUDAPEST,Budapest XIV. kerület,047,1241,718,0,718,0,7,711
BUDAPEST,Budapest XIV. kerület,048,1126,517,0,517,0,1,516
BUDAPEST,Budapest XIV. kerület,049,1245,631,0,631,0,1,630
BUDAPEST,Budapest XIV. kerület,050,1107,545,0,545,0,1,544
BUDAPEST,Budapest XIV. kerület,051,1152,558,0,558,0,1,557
BUDAPEST,Budapest XIV. kerület,052,1075,512,0,512,0,0,512
BUDAPEST,Budapest XIV. kerület,053,1122,509,0,509,0,1,508
BUDAPEST,Budapest XIV. kerület,054,1155,513,1,513,0,3,510
BUDAPEST,Budapest XIV. kerület,055,1238,703,1,701,-2,0,701
BUDAPEST,Budapest XIV. kerület,056,1217,728,0,728,0,3,725
BUDAPEST,Budapest XIV. kerület,057,1285,685,0,685,0,3,682
BUDAPEST,Budapest XIV. kerület,058,1012,490,0,491,1,11,480
BUDAPEST,Budapest XIV. kerület,059,1163,564,1,563,-1,5,558
BUDAPEST,Budapest XIV. kerület,060,1222,660,0,660,0,6,654
BUDAPEST,Budapest XIV. kerület,061,1275,792,0,792,0,4,788
BUDAPEST,Budapest XIV. kerület,062,1209,723,0,723,0,2,721
BUDAPEST,Budapest XIV. kerület,063,1141,725,0,724,-1,0,724
BUDAPEST,Budapest XIV. kerület,064,1139,638,0,638,0,4,634
BUDAPEST,Budapest XIV. kerület,065,1241,785,1,784,-1,5,779
BUDAPEST,Budapest XIV. kerület,066,1250,593,0,593,0,1,592
BUDAPEST,Budapest XIV. kerület,067,1095,487,0,487,0,3,484
BUDAPEST,Budapest XIV. kerület,068,1133,636,0,636,0,2,634
BUDAPEST,Budapest XIV. kerület,069,1157,610,0,610,0,2,608
BUDAPEST,Budapest XIV. kerület,070,1117,635,0,634,-1,4,630
BUDAPEST,Budapest XIV. kerület,071,1178,605,0,605,0,2,603
BUDAPEST,Budapest XIV. kerület,072,1193,626,0,626,0,1,625
BUDAPEST,Budapest XIV. kerület,073,1196,638,0,638,0,1,637
BUDAPEST,Budapest XIV. kerület,074,1223,619,0,619,0,4,615
BUDAPEST,Budapest XIV. kerület,075,1102,648,0,648,0,3,645
BUDAPEST,Budapest XV. kerület,001,832,465,0,465,0,2,463
BUDAPEST,Budapest XV. kerület,002,853,473,0,473,0,2,471
BUDAPEST,Budapest XV. kerület,003,1118,607,0,607,0,0,607
BUDAPEST,Budapest XV. kerület,004,913,486,0,486,0,1,485
BUDAPEST,Budapest XV. kerület,005,757,442,0,442,0,2,440
BUDAPEST,Budapest XV. kerület,006,1094,613,0,613,0,2,611
BUDAPEST,Budapest XV. kerület,007,784,409,0,409,0,0,409
BUDAPEST,Budapest XV. kerület,008,777,419,0,419,0,0,419
BUDAPEST,Budapest XV. kerület,009,845,398,0,398,0,4,394
BUDAPEST,Budapest XV. kerület,010,811,380,1,379,-1,1,378
BUDAPEST,Budapest XV. kerület,011,825,394,0,394,0,4,390
BUDAPEST,Budapest XV. kerület,012,1101,525,0,525,0,2,523
BUDAPEST,Budapest XV. kerület,013,1205,525,0,524,-1,0,524
BUDAPEST,Budapest XV. kerület,014,779,379,0,379,0,2,377
BUDAPEST,Budapest XV. kerület,015,1946,1149,0,1149,0,2,1147
BUDAPEST,Budapest XV. kerület,016,1147,567,0,567,0,0,567
BUDAPEST,Budapest XV. kerület,017,759,365,0,364,-1,0,364
BUDAPEST,Budapest XV. kerület,018,770,391,0,391,0,2,389
BUDAPEST,Budapest XV. kerület,019,1017,486,0,486,0,2,484
BUDAPEST,Budapest XV. kerület,020,1121,477,0,477,0,2,475
BUDAPEST,Budapest XV. kerület,021,1032,439,0,439,0,3,436
BUDAPEST,Budapest XV. kerület,022,1075,531,0,531,0,1,530
BUDAPEST,Budapest XV. kerület,023,761,459,1,459,0,2,457
BUDAPEST,Budapest XV. kerület,024,996,482,0,482,0,1,481
BUDAPEST,Budapest XV. kerület,025,949,528,0,528,0,0,528
BUDAPEST,Budapest XV. kerület,026,822,449,0,449,0,1,448
BUDAPEST,Budapest XV. kerület,027,894,486,0,486,0,2,484
BUDAPEST,Budapest XV. kerület,028,853,413,0,413,0,1,412
BUDAPEST,Budapest XV. kerület,029,854,401,0,401,0,1,400
BUDAPEST,Budapest XV. kerület,030,703,385,0,385,0,0,385
BUDAPEST,Budapest XV. kerület,031,828,386,0,386,0,1,385
BUDAPEST,Budapest XV. kerület,032,792,401,0,401,0,1,400
BUDAPEST,Budapest XV. kerület,033,851,450,0,450,0,0,450
BUDAPEST,Budapest XV. kerület,034,701,400,0,402,2,19,383
BUDAPEST,Budapest XV. kerület,035,1094,581,0,581,0,0,581
BUDAPEST,Budapest XV. kerület,036,843,450,0,450,0,0,450
BUDAPEST,Budapest XV. kerület,037,791,441,0,441,0,2,439
BUDAPEST,Budapest XV. kerület,038,961,504,0,504,0,0,504
BUDAPEST,Budapest XV. kerület,039,902,468,0,468,0,4,464
BUDAPEST,Budapest XV. kerület,040,735,319,0,319,0,1,318
BUDAPEST,Budapest XV. kerület,041,789,328,0,327,-1,2,325
BUDAPEST,Budapest XV. kerület,042,931,409,0,409,0,0,409
BUDAPEST,Budapest XV. kerület,043,935,429,0,429,0,3,426
BUDAPEST,Budapest XV. kerület,044,893,393,0,393,0,2,391
BUDAPEST,Budapest XV. kerület,045,739,309,0,309,0,2,307
BUDAPEST,Budapest XV. kerület,046,914,397,0,397,0,1,396
BUDAPEST,Budapest XV. kerület,047,866,375,0,375,0,1,374
BUDAPEST,Budapest XV. kerület,048,741,329,0,329,0,2,327
BUDAPEST,Budapest XV. kerület,049,801,443,0,443,0,14,429
BUDAPEST,Budapest XV. kerület,050,700,302,0,302,0,1,301
BUDAPEST,Budapest XV. kerület,051,735,299,0,299,0,0,299
BUDAPEST,Budapest XV. kerület,052,872,345,0,345,0,1,344
BUDAPEST,Budapest XV. kerület,053,749,350,0,350,0,4,346
BUDAPEST,Budapest XV. kerület,054,962,360,0,360,0,4,356
BUDAPEST,Budapest XV. kerület,055,871,360,0,360,0,0,360
BUDAPEST,Budapest XV. kerület,056,877,395,0,395,0,2,393
BUDAPEST,Budapest XV. kerület,057,975,421,1,420,-1,1,419
BUDAPEST,Budapest XV. kerület,058,831,358,0,358,0,2,356
BUDAPEST,Budapest XV. kerület,059,844,327,0,327,0,1,326
BUDAPEST,Budapest XV. kerület,060,916,385,0,385,0,0,385
BUDAPEST,Budapest XV. kerület,061,1050,460,2,458,-2,0,458
BUDAPEST,Budapest XV. kerület,062,786,343,0,343,0,0,343
BUDAPEST,Budapest XV. kerület,063,1202,572,0,572,0,5,567
BUDAPEST,Budapest XV. kerület,064,963,428,0,428,0,2,426
BUDAPEST,Budapest XV. kerület,065,781,381,0,381,0,3,378
BUDAPEST,Budapest XV. kerület,066,841,452,0,451,-1,1,450
BUDAPEST,Budapest XV. kerület,067,968,425,0,425,0,1,424
BUDAPEST,Budapest XV. kerület,068,799,345,0,345,0,2,343
BUDAPEST,Budapest XV. kerület,069,830,367,0,367,0,0,367
BUDAPEST,Budapest XV. kerület,070,916,315,0,315,0,2,313
BUDAPEST,Budapest XVI. kerület,001,1048,608,0,608,0,2,606
BUDAPEST,Budapest XVI. kerület,002,971,557,0,557,0,2,555
BUDAPEST,Budapest XVI. kerület,003,998,596,0,596,0,5,591
BUDAPEST,Budapest XVI. kerület,004,870,462,0,462,0,4,458
BUDAPEST,Budapest XVI. kerület,005,863,506,0,506,0,1,505
BUDAPEST,Budapest XVI. kerület,006,1050,535,0,535,0,1,534
BUDAPEST,Budapest XVI. kerület,007,1053,556,0,556,0,0,556
BUDAPEST,Budapest XVI. kerület,008,1021,573,0,573,0,4,569
BUDAPEST,Budapest XVI. kerület,009,994,559,0,555,-4,1,554
BUDAPEST,Budapest XVI. kerület,010,966,547,0,547,0,1,546
BUDAPEST,Budapest XVI. kerület,011,994,559,0,560,1,12,548
BUDAPEST,Budapest XVI. kerület,012,1041,595,0,595,0,0,595
BUDAPEST,Budapest XVI. kerület,013,886,472,0,472,0,0,472
BUDAPEST,Budapest XVI. kerület,014,918,532,0,532,0,2,530
BUDAPEST,Budapest XVI. kerület,015,1051,624,0,624,0,1,623
BUDAPEST,Budapest XVI. kerület,016,832,466,0,466,0,0,466
BUDAPEST,Budapest XVI. kerület,017,1686,1188,0,1186,-2,3,1183
BUDAPEST,Budapest XVI. kerület,018,881,522,0,522,0,2,520
BUDAPEST,Budapest XVI. kerület,019,743,407,0,407,0,1,406
BUDAPEST,Budapest XVI. kerület,020,743,454,0,454,0,3,451
BUDAPEST,Budapest XVI. kerület,021,746,410,0,409,-1,2,407
BUDAPEST,Budapest XVI. kerület,022,774,479,0,479,0,1,478
BUDAPEST,Budapest XVI. kerület,023,903,500,0,500,0,2,498
BUDAPEST,Budapest XVI. kerület,024,859,455,0,455,0,1,454
BUDAPEST,Budapest XVI. kerület,025,853,492,0,492,0,12,480
BUDAPEST,Budapest XVI. kerület,026,995,571,0,571,0,1,570
BUDAPEST,Budapest XVI. kerület,027,986,589,0,589,0,0,589
BUDAPEST,Budapest XVI. kerület,028,769,451,0,451,0,1,450
BUDAPEST,Budapest XVI. kerület,029,828,469,0,469,0,1,468
BUDAPEST,Budapest XVI. kerület,030,969,531,0,531,0,2,529
BUDAPEST,Budapest XVI. kerület,031,851,495,1,494,-1,1,493
BUDAPEST,Budapest XVI. kerület,032,1042,613,0,613,0,0,613
BUDAPEST,Budapest XVI. kerület,033,1113,635,0,635,0,0,635
BUDAPEST,Budapest XVI. kerület,034,926,525,0,525,0,0,525
BUDAPEST,Budapest XVI. kerület,035,1088,578,1,577,-1,3,574
BUDAPEST,Budapest XVI. kerület,036,849,539,0,539,0,2,537
BUDAPEST,Budapest XVI. kerület,037,724,448,0,448,0,1,447
BUDAPEST,Budapest XVI. kerület,038,928,592,0,592,0,0,592
BUDAPEST,Budapest XVI. kerület,039,782,443,0,443,0,0,443
BUDAPEST,Budapest XVI. kerület,040,958,587,0,587,0,2,585
BUDAPEST,Budapest XVI. kerület,041,813,431,0,430,-1,6,424
BUDAPEST,Budapest XVI. kerület,042,891,541,0,541,0,2,539
BUDAPEST,Budapest XVI. kerület,043,958,609,0,609,0,1,608
BUDAPEST,Budapest XVI. kerület,044,1001,572,0,572,0,0,572
BUDAPEST,Budapest XVI. kerület,045,956,594,1,594,0,65,529
BUDAPEST,Budapest XVI. kerület,046,746,364,0,364,0,2,362
BUDAPEST,Budapest XVI. kerület,047,682,368,0,368,0,0,368
BUDAPEST,Budapest XVI. kerület,048,943,526,1,524,-2,0,524
BUDAPEST,Budapest XVI. kerület,049,986,637,0,637,0,4,633
BUDAPEST,Budapest XVI. kerület,050,824,463,0,463,0,5,458
BUDAPEST,Budapest XVI. kerület,051,1040,545,0,545,0,1,544
BUDAPEST,Budapest XVI. kerület,052,837,503,1,502,-1,1,501
BUDAPEST,Budapest XVI. kerület,053,762,453,0,453,0,4,449
BUDAPEST,Budapest XVI. kerület,054,914,558,0,558,0,1,557
BUDAPEST,Budapest XVI. kerület,055,917,526,0,526,0,4,522
BUDAPEST,Budapest XVI. kerület,056,1311,727,0,727,0,2,725
BUDAPEST,Budapest XVI. kerület,057,1308,662,0,662,0,1,661
BUDAPEST,Budapest XVI. kerület,058,791,423,0,423,0,1,422
BUDAPEST,Budapest XVI. kerület,059,895,487,0,486,-1,0,486
BUDAPEST,Budapest XVI. kerület,060,1066,563,0,562,-1,0,562
BUDAPEST,Budapest XVII. kerület,001,857,508,0,508,0,1,507
BUDAPEST,Budapest XVII. kerület,002,863,528,0,528,0,0,528
BUDAPEST,Budapest XVII. kerület,003,962,515,0,515,0,1,514
BUDAPEST,Budapest XVII. kerület,004,851,512,0,512,0,2,510
BUDAPEST,Budapest XVII. kerület,005,745,486,0,485,-1,1,484
BUDAPEST,Budapest XVII. kerület,006,858,574,0,574,0,2,572
BUDAPEST,Budapest XVII. kerület,007,969,455,0,455,0,1,454
BUDAPEST,Budapest XVII. kerület,008,1126,504,0,504,0,1,503
BUDAPEST,Budapest XVII. kerület,009,957,392,0,392,0,1,391
BUDAPEST,Budapest XVII. kerület,010,824,322,0,322,0,1,321
BUDAPEST,Budapest XVII. kerület,011,994,392,0,392,0,7,385
BUDAPEST,Budapest XVII. kerület,012,914,426,0,425,-1,1,424
BUDAPEST,Budapest XVII. kerület,013,918,327,0,327,0,0,327
BUDAPEST,Budapest XVII. kerület,014,965,406,0,406,0,0,406
BUDAPEST,Budapest XVII. kerület,015,859,393,0,393,0,2,391
BUDAPEST,Budapest XVII. kerület,016,465,159,0,159,0,1,158
BUDAPEST,Budapest XVII. kerület,017,711,289,0,288,-1,1,287
BUDAPEST,Budapest XVII. kerület,018,872,410,0,410,0,2,408
BUDAPEST,Budapest XVII. kerület,019,974,422,0,422,0,1,421
BUDAPEST,Budapest XVII. kerület,020,808,329,0,329,0,1,328
BUDAPEST,Budapest XVII. kerület,021,1613,810,1,809,-1,11,798
BUDAPEST,Budapest XVII. kerület,022,940,439,0,437,-2,3,434
BUDAPEST,Budapest XVII. kerület,023,1010,415,0,415,0,3,412
BUDAPEST,Budapest XVII. kerület,024,918,464,0,464,0,0,464
BUDAPEST,Budapest XVII. kerület,025,1038,553,0,553,0,2,551
BUDAPEST,Budapest XVII. kerület,026,898,567,0,567,0,1,566
BUDAPEST,Budapest XVII. kerület,027,641,385,0,385,0,1,384
BUDAPEST,Budapest XVII. kerület,028,700,405,0,405,0,1,404
BUDAPEST,Budapest XVII. kerület,029,931,446,0,446,0,3,443
BUDAPEST,Budapest XVII. kerület,030,938,469,0,469,0,1,468
BUDAPEST,Budapest XVII. kerület,031,894,518,0,518,0,1,517
BUDAPEST,Budapest XVII. kerület,032,828,456,0,456,0,2,454
BUDAPEST,Budapest XVII. kerület,033,898,487,0,486,-1,0,486
BUDAPEST,Budapest XVII. kerület,034,886,450,0,450,0,1,449
BUDAPEST,Budapest XVII. kerület,035,1072,436,0,436,0,3,433
BUDAPEST,Budapest XVII. kerület,036,1011,461,0,461,0,2,459
BUDAPEST,Budapest XVII. kerület,037,1048,456,0,456,0,0,456
BUDAPEST,Budapest XVII. kerület,038,1099,558,0,557,-1,3,554
BUDAPEST,Budapest XVII. kerület,039,989,554,0,554,0,1,553
BUDAPEST,Budapest XVII. kerület,040,1096,611,0,611,0,1,610
BUDAPEST,Budapest XVII. kerület,041,1074,505,0,505,0,1,504
BUDAPEST,Budapest XVII. kerület,042,1148,592,0,593,1,9,584
BUDAPEST,Budapest XVII. kerület,043,986,512,0,512,0,3,509
BUDAPEST,Budapest XVII. kerület,044,753,359,0,359,0,1,358
BUDAPEST,Budapest XVII. kerület,045,823,415,0,415,0,0,415
BUDAPEST,Budapest XVII. kerület,046,1024,578,0,577,-1,2,575
BUDAPEST,Budapest XVII. kerület,047,1082,594,0,594,0,1,593
BUDAPEST,Budapest XVII. kerület,048,816,459,0,459,0,0,459
BUDAPEST,Budapest XVII. kerület,049,905,460,0,460,0,1,459
BUDAPEST,Budapest XVII. kerület,050,774,404,0,404,0,0,404
BUDAPEST,Budapest XVII. kerület,051,1173,586,0,586,0,1,585
BUDAPEST,Budapest XVII. kerület,052,1021,556,0,556,0,5,551
BUDAPEST,Budapest XVII. kerület,053,872,435,0,435,0,3,432
BUDAPEST,Budapest XVII. kerület,054,769,422,0,421,-1,1,420
BUDAPEST,Budapest XVII. kerület,055,937,536,0,536,0,2,534
BUDAPEST,Budapest XVII. kerület,056,1036,549,0,549,0,0,549
BUDAPEST,Budapest XVII. kerület,057,811,405,0,405,0,0,405
BUDAPEST,Budapest XVII. kerület,058,940,454,0,454,0,4,450
BUDAPEST,Budapest XVII. kerület,059,1102,568,0,568,0,2,566
BUDAPEST,Budapest XVII. kerület,060,956,442,1,442,0,1,441
BUDAPEST,Budapest XVII. kerület,061,1053,469,0,469,0,1,468
BUDAPEST,Budapest XVII. kerület,062,745,357,0,357,0,0,357
BUDAPEST,Budapest XVII. kerület,063,907,446,0,446,0,3,443
BUDAPEST,Budapest XVII. kerület,064,975,538,0,538,0,0,538
BUDAPEST,Budapest XVII. kerület,065,915,479,0,479,0,2,477
BUDAPEST,Budapest XVII. kerület,066,922,515,0,515,0,2,513
BUDAPEST,Budapest XVII. kerület,067,936,527,0,527,0,1,526
BUDAPEST,Budapest XVII. kerület,068,948,509,0,509,0,1,508
BUDAPEST,Budapest XVII. kerület,069,870,470,0,470,0,0,470
BUDAPEST,Budapest XVII. kerület,070,914,515,0,515,0,6,509
BUDAPEST,Budapest XVII. kerület,071,907,486,0,486,0,0,486
BUDAPEST,Budapest XVII. kerület,072,973,607,0,607,0,1,606
BUDAPEST,Budapest XVII. kerület,073,1009,609,0,609,0,6,603
BUDAPEST,Budapest XVII. kerület,074,724,409,0,409,0,3,406
BUDAPEST,Budapest XVII. kerület,075,974,579,0,579,0,2,577
BUDAPEST,Budapest XVIII. kerület,001,1103,598,0,598,0,2,596
BUDAPEST,Budapest XVIII. kerület,002,900,470,0,470,0,1,469
BUDAPEST,Budapest XVIII. kerület,003,1106,579,0,580,1,11,569
BUDAPEST,Budapest XVIII. kerület,004,1120,588,0,588,0,6,582
BUDAPEST,Budapest XVIII. kerület,005,1150,567,0,567,0,2,565
BUDAPEST,Budapest XVIII. kerület,006,984,528,0,528,0,2,526
BUDAPEST,Budapest XVIII. kerület,007,929,478,0,478,0,0,478
BUDAPEST,Budapest XVIII. kerület,008,918,453,0,453,0,1,452
BUDAPEST,Budapest XVIII. kerület,009,829,392,0,392,0,0,392
BUDAPEST,Budapest XVIII. kerület,010,966,548,0,548,0,3,545
BUDAPEST,Budapest XVIII. kerület,011,1913,1191,2,1191,0,11,1180
BUDAPEST,Budapest XVIII. kerület,012,855,511,0,511,0,1,510
BUDAPEST,Budapest XVIII. kerület,013,1032,536,0,536,0,4,532
BUDAPEST,Budapest XVIII. kerület,014,908,523,0,523,0,2,521
BUDAPEST,Budapest XVIII. kerület,015,941,508,0,508,0,2,506
BUDAPEST,Budapest XVIII. kerület,016,845,465,0,465,0,2,463
BUDAPEST,Budapest XVIII. kerület,017,853,457,0,457,0,1,456
BUDAPEST,Budapest XVIII. kerület,018,982,536,0,536,0,6,530
BUDAPEST,Budapest XVIII. kerület,019,1087,614,0,614,0,5,609
BUDAPEST,Budapest XVIII. kerület,020,887,489,0,489,0,0,489
BUDAPEST,Budapest XVIII. kerület,021,1043,595,0,595,0,2,593
BUDAPEST,Budapest XVIII. kerület,022,853,452,0,452,0,3,449
BUDAPEST,Budapest XVIII. kerület,023,937,536,0,536,0,0,536
BUDAPEST,Budapest XVIII. kerület,024,1063,439,0,439,0,2,437
BUDAPEST,Budapest XVIII. kerület,025,985,551,1,550,-1,2,548
BUDAPEST,Budapest XVIII. kerület,026,1103,485,0,485,0,1,484
BUDAPEST,Budapest XVIII. kerület,027,1236,599,0,599,0,2,597
BUDAPEST,Budapest XVIII. kerület,028,1028,551,0,551,0,3,548
BUDAPEST,Budapest XVIII. kerület,029,1221,443,0,443,0,3,440
BUDAPEST,Budapest XVIII. kerület,030,1125,465,0,465,0,0,465
BUDAPEST,Budapest XVIII. kerület,031,1258,432,0,432,0,5,427
BUDAPEST,Budapest XVIII. kerület,032,1071,372,0,372,0,2,370
BUDAPEST,Budapest XVIII. kerület,033,1055,370,0,370,0,6,364
BUDAPEST,Budapest XVIII. kerület,034,848,341,0,341,0,1,340
BUDAPEST,Budapest XVIII. kerület,035,982,385,0,385,0,7,378
BUDAPEST,Budapest XVIII. kerület,036,1006,366,0,366,0,1,365
BUDAPEST,Budapest XVIII. kerület,037,941,396,0,396,0,0,396
BUDAPEST,Budapest XVIII. kerület,038,1086,385,0,385,0,3,382
BUDAPEST,Budapest XVIII. kerület,039,897,340,0,340,0,1,339
BUDAPEST,Budapest XVIII. kerület,040,1056,541,0,541,0,1,540
BUDAPEST,Budapest XVIII. kerület,041,1110,587,0,587,0,1,586
BUDAPEST,Budapest XVIII. kerület,042,1180,584,0,583,-1,0,583
BUDAPEST,Budapest XVIII. kerület,043,844,439,0,436,-3,1,435
BUDAPEST,Budapest XVIII. kerület,044,1221,608,0,608,0,1,607
BUDAPEST,Budapest XVIII. kerület,045,725,361,0,361,0,1,360
BUDAPEST,Budapest XVIII. kerület,046,815,449,0,449,0,2,447
BUDAPEST,Budapest XVIII. kerület,047,1055,567,0,566,-1,1,565
BUDAPEST,Budapest XVIII. kerület,048,805,432,0,426,-6,1,425
BUDAPEST,Budapest XVIII. kerület,049,1064,538,0,538,0,0,538
BUDAPEST,Budapest XVIII. kerület,050,1072,615,0,615,0,0,615
BUDAPEST,Budapest XVIII. kerület,051,947,503,0,503,0,4,499
BUDAPEST,Budapest XVIII. kerület,052,1027,647,0,647,0,1,646
BUDAPEST,Budapest XVIII. kerület,053,1174,717,0,717,0,6,711
BUDAPEST,Budapest XVIII. kerület,054,1040,616,0,616,0,2,614
BUDAPEST,Budapest XVIII. kerület,055,1139,564,0,564,0,9,555
BUDAPEST,Budapest XVIII. kerület,056,1304,679,0,679,0,19,660
BUDAPEST,Budapest XVIII. kerület,057,1115,660,0,660,0,6,654
BUDAPEST,Budapest XVIII. kerület,058,1045,546,0,546,0,3,543
BUDAPEST,Budapest XVIII. kerület,059,1315,709,0,709,0,2,707
BUDAPEST,Budapest XVIII. kerület,060,1218,535,0,535,0,1,534
BUDAPEST,Budapest XVIII. kerület,061,1358,643,0,643,0,6,637
BUDAPEST,Budapest XVIII. kerület,062,1216,564,0,564,0,3,561
BUDAPEST,Budapest XVIII. kerület,063,1175,626,0,626,0,2,624
BUDAPEST,Budapest XVIII. kerület,064,910,431,0,431,0,0,431
BUDAPEST,Budapest XVIII. kerület,065,1143,517,0,516,-1,1,515
BUDAPEST,Budapest XVIII. kerület,066,734,378,0,378,0,3,375
BUDAPEST,Budapest XVIII. kerület,067,1058,556,0,556,0,1,555
BUDAPEST,Budapest XVIII. kerület,068,923,470,0,470,0,2,468
BUDAPEST,Budapest XVIII. kerület,069,1150,583,0,583,0,1,582
BUDAPEST,Budapest XVIII. kerület,070,1052,527,0,527,0,4,523
BUDAPEST,Budapest XVIII. kerület,071,869,404,0,404,0,0,404
BUDAPEST,Budapest XVIII. kerület,072,1120,546,0,546,0,4,542
BUDAPEST,Budapest XVIII. kerület,073,1066,552,0,552,0,2,550
BUDAPEST,Budapest XVIII. kerület,074,1183,572,0,571,-1,2,569
BUDAPEST,Budapest XVIII. kerület,075,1216,611,0,611,0,2,609
BUDAPEST,Budapest XVIII. kerület,076,961,419,0,419,0,0,419
BUDAPEST,Budapest XIX. kerület,001,793,366,0,366,0,1,365
BUDAPEST,Budapest XIX. kerület,002,980,434,0,434,0,0,434
BUDAPEST,Budapest XIX. kerület,003,904,394,0,394,0,0,394
BUDAPEST,Budapest XIX. kerület,004,869,394,0,394,0,2,392
BUDAPEST,Budapest XIX. kerület,005,915,450,0,450,0,2,448
BUDAPEST,Budapest XIX. kerület,006,847,434,0,434,0,1,433
BUDAPEST,Budapest XIX. kerület,007,841,410,0,409,-1,2,407
BUDAPEST,Budapest XIX. kerület,008,899,427,1,426,-1,1,425
BUDAPEST,Budapest XIX. kerület,009,1019,537,1,534,-3,5,529
BUDAPEST,Budapest XIX. kerület,010,970,473,0,473,0,0,473
BUDAPEST,Budapest XIX. kerület,011,969,482,0,482,0,1,481
BUDAPEST,Budapest XIX. kerület,012,960,438,0,438,0,2,436
BUDAPEST,Budapest XIX. kerület,013,878,476,1,476,0,1,475
BUDAPEST,Budapest XIX. kerület,014,892,392,0,392,0,1,391
BUDAPEST,Budapest XIX. kerület,015,994,509,0,509,0,5,504
BUDAPEST,Budapest XIX. kerület,016,885,413,0,413,0,3,410
BUDAPEST,Budapest XIX. kerület,017,996,484,0,483,-1,1,482
BUDAPEST,Budapest XIX. kerület,018,828,374,1,374,0,0,374
BUDAPEST,Budapest XIX. kerület,019,795,397,1,397,0,0,397
BUDAPEST,Budapest XIX. kerület,020,871,475,0,475,0,2,473
BUDAPEST,Budapest XIX. kerület,021,786,433,0,433,0,0,433
BUDAPEST,Budapest XIX. kerület,022,771,323,0,323,0,0,323
BUDAPEST,Budapest XIX. kerület,023,1821,1138,0,1138,0,7,1131
BUDAPEST,Budapest XIX. kerület,024,902,449,0,449,0,1,448
BUDAPEST,Budapest XIX. kerület,025,833,383,0,383,0,1,382
BUDAPEST,Budapest XIX. kerület,026,834,394,0,392,-2,5,387
BUDAPEST,Budapest XIX. kerület,027,716,343,0,343,0,0,343
BUDAPEST,Budapest XIX. kerület,028,964,375,0,375,0,0,375
BUDAPEST,Budapest XIX. kerület,029,902,512,1,512,0,5,507
BUDAPEST,Budapest XIX. kerület,030,952,498,0,498,0,1,497
BUDAPEST,Budapest XIX. kerület,031,886,540,0,540,0,1,539
BUDAPEST,Budapest XIX. kerület,032,1176,711,0,711,0,3,708
BUDAPEST,Budapest XIX. kerület,033,982,579,0,578,-1,5,573
BUDAPEST,Budapest XIX. kerület,034,960,551,0,549,-2,3,546
BUDAPEST,Budapest XIX. kerület,035,1106,594,0,594,0,3,591
BUDAPEST,Budapest XIX. kerület,036,1177,584,0,584,0,5,579
BUDAPEST,Budapest XIX. kerület,037,1087,550,1,548,-2,3,545
BUDAPEST,Budapest XIX. kerület,038,1209,600,0,599,-1,3,596
BUDAPEST,Budapest XIX. kerület,039,918,483,0,483,0,2,481
BUDAPEST,Budapest XIX. kerület,040,1076,543,0,543,0,2,541
BUDAPEST,Budapest XIX. kerület,041,1195,584,0,584,0,0,584
BUDAPEST,Budapest XIX. kerület,042,1060,559,0,559,0,6,553
BUDAPEST,Budapest XIX. kerület,043,848,401,0,399,-2,1,398
BUDAPEST,Budapest XIX. kerület,044,989,497,0,497,0,4,493
BUDAPEST,Budapest XIX. kerület,045,981,403,2,403,0,2,401
BUDAPEST,Budapest XIX. kerület,046,996,545,0,545,0,1,544
BUDAPEST,Budapest XIX. kerület,047,921,539,0,538,-1,2,536
BUDAPEST,Budapest XIX. kerület,048,1249,742,0,742,0,1,741
BUDAPEST,Budapest XX. kerület,001,840,412,0,411,-1,3,408
BUDAPEST,Budapest XX. kerület,002,1079,578,1,578,0,0,578
BUDAPEST,Budapest XX. kerület,003,593,268,0,268,0,0,268
BUDAPEST,Budapest XX. kerület,004,659,263,0,263,0,1,262
BUDAPEST,Budapest XX. kerület,005,839,390,1,390,0,3,387
BUDAPEST,Budapest XX. kerület,006,929,438,0,438,0,0,438
BUDAPEST,Budapest XX. kerület,007,692,323,0,323,0,2,321
BUDAPEST,Budapest XX. kerület,008,979,472,0,470,-2,1,469
BUDAPEST,Budapest XX. kerület,009,866,359,0,359,0,1,358
BUDAPEST,Budapest XX. kerület,010,722,299,0,299,0,0,299
BUDAPEST,Budapest XX. kerület,011,1787,1048,0,1048,0,4,1044
BUDAPEST,Budapest XX. kerület,012,871,326,0,326,0,5,321
BUDAPEST,Budapest XX. kerület,013,996,462,0,462,0,2,460
BUDAPEST,Budapest XX. kerület,014,725,281,0,281,0,3,278
BUDAPEST,Budapest XX. kerület,015,755,283,0,283,0,1,282
BUDAPEST,Budapest XX. kerület,016,938,300,0,300,0,1,299
BUDAPEST,Budapest XX. kerület,017,928,335,0,335,0,0,335
BUDAPEST,Budapest XX. kerület,018,723,247,0,247,0,1,246
BUDAPEST,Budapest XX. kerület,019,1330,637,0,637,0,4,633
BUDAPEST,Budapest XX. kerület,020,1124,473,0,473,0,2,471
BUDAPEST,Budapest XX. kerület,021,834,394,0,393,-1,1,392
BUDAPEST,Budapest XX. kerület,022,870,414,0,414,0,1,413
BUDAPEST,Budapest XX. kerület,023,652,338,1,337,-1,1,336
BUDAPEST,Budapest XX. kerület,024,658,319,0,319,0,3,316
BUDAPEST,Budapest XX. kerület,025,800,385,5,380,-5,2,378
BUDAPEST,Budapest XX. kerület,026,869,423,0,423,0,0,423
BUDAPEST,Budapest XX. kerület,027,812,392,0,392,0,2,390
BUDAPEST,Budapest XX. kerület,028,766,357,0,357,0,0,357
BUDAPEST,Budapest XX. kerület,029,658,315,0,315,0,0,315
BUDAPEST,Budapest XX. kerület,030,758,370,0,370,0,3,367
BUDAPEST,Budapest XX. kerület,031,628,308,0,308,0,2,306
BUDAPEST,Budapest XX. kerület,032,601,273,0,273,0,1,272
BUDAPEST,Budapest XX. kerület,033,585,309,0,308,-1,3,305
BUDAPEST,Budapest XX. kerület,034,804,366,0,365,-1,1,364
BUDAPEST,Budapest XX. kerület,035,893,374,0,374,0,0,374
BUDAPEST,Budapest XX. kerület,036,885,348,0,348,0,1,347
BUDAPEST,Budapest XX. kerület,037,876,382,0,382,0,8,374
BUDAPEST,Budapest XX. kerület,038,708,326,0,326,0,0,326
BUDAPEST,Budapest XX. kerület,039,964,424,0,424,0,3,421
BUDAPEST,Budapest XX. kerület,040,922,423,0,423,0,0,423
BUDAPEST,Budapest XX. kerület,041,771,376,0,376,0,5,371
BUDAPEST,Budapest XX. kerület,042,968,416,0,416,0,7,409
BUDAPEST,Budapest XX. kerület,043,752,352,0,352,0,0,352
BUDAPEST,Budapest XX. kerület,044,767,323,0,323,0,0,323
BUDAPEST,Budapest XX. kerület,045,890,416,0,416,0,2,414
BUDAPEST,Budapest XX. kerület,046,628,347,0,347,0,1,346
BUDAPEST,Budapest XX. kerület,047,850,435,0,435,0,4,431
BUDAPEST,Budapest XX. kerület,048,674,322,0,322,0,2,320
BUDAPEST,Budapest XX. kerület,049,893,481,0,481,0,5,476
BUDAPEST,Budapest XX. kerület,050,1009,456,0,456,0,1,455
BUDAPEST,Budapest XX. kerület,051,734,365,3,361,-4,2,359
BUDAPEST,Budapest XX. kerület,052,810,365,0,365,0,1,364
BUDAPEST,Budapest XX. kerület,053,620,285,0,285,0,3,282
BUDAPEST,Budapest XX. kerület,054,867,402,0,402,0,2,400
BUDAPEST,Budapest XX. kerület,055,772,322,0,322,0,3,319
BUDAPEST,Budapest XX. kerület,056,944,413,0,413,0,6,407
BUDAPEST,Budapest XX. kerület,057,807,377,0,377,0,1,376
BUDAPEST,Budapest XX. kerület,058,1042,439,0,439,0,1,438
BUDAPEST,Budapest XX. kerület,059,824,422,0,422,0,1,421
BUDAPEST,Budapest XX. kerület,060,904,381,0,381,0,5,376
BUDAPEST,Budapest XX. kerület,061,660,232,0,232,0,0,232
BUDAPEST,Budapest XXI. kerület,001,843,452,0,452,0,2,450
BUDAPEST,Budapest XXI. kerület,002,840,444,1,443,-1,2,441
BUDAPEST,Budapest XXI. kerület,003,777,421,0,421,0,1,420
BUDAPEST,Budapest XXI. kerület,004,763,392,0,392,0,2,390
BUDAPEST,Budapest XXI. kerület,005,870,457,0,457,0,4,453
BUDAPEST,Budapest XXI. kerület,006,822,386,0,386,0,0,386
BUDAPEST,Budapest XXI. kerület,007,717,372,0,372,0,4,368
BUDAPEST,Budapest XXI. kerület,008,942,486,0,486,0,1,485
BUDAPEST,Budapest XXI. kerület,009,940,490,0,490,0,3,487
BUDAPEST,Budapest XXI. kerület,010,976,523,0,523,0,4,519
BUDAPEST,Budapest XXI. kerület,011,755,404,0,404,0,0,404
BUDAPEST,Budapest XXI. kerület,012,834,454,0,454,0,1,453
BUDAPEST,Budapest XXI. kerület,013,821,400,0,400,0,1,399
BUDAPEST,Budapest XXI. kerület,014,944,471,0,471,0,5,466
BUDAPEST,Budapest XXI. kerület,015,967,524,0,524,0,1,523
BUDAPEST,Budapest XXI. kerület,016,842,452,0,452,0,8,444
BUDAPEST,Budapest XXI. kerület,017,1018,566,0,566,0,1,565
BUDAPEST,Budapest XXI. kerület,018,914,498,0,498,0,2,496
BUDAPEST,Budapest XXI. kerület,019,756,409,0,409,0,4,405
BUDAPEST,Budapest XXI. kerület,020,664,393,0,393,0,0,393
BUDAPEST,Budapest XXI. kerület,021,785,402,0,400,-2,2,398
BUDAPEST,Budapest XXI. kerület,022,882,462,0,462,0,5,457
BUDAPEST,Budapest XXI. kerület,023,797,338,0,338,0,3,335
BUDAPEST,Budapest XXI. kerület,024,802,355,0,355,0,1,354
BUDAPEST,Budapest XXI. kerület,025,842,335,0,335,0,3,332
BUDAPEST,Budapest XXI. kerület,026,875,433,0,433,0,4,429
BUDAPEST,Budapest XXI. kerület,027,754,368,0,368,0,0,368
BUDAPEST,Budapest XXI. kerület,028,974,422,0,422,0,1,421
BUDAPEST,Budapest XXI. kerület,029,708,296,1,295,-1,0,295
BUDAPEST,Budapest XXI. kerület,030,729,288,0,288,0,3,285
BUDAPEST,Budapest XXI. kerület,031,762,314,0,314,0,0,314
BUDAPEST,Budapest XXI. kerület,032,998,414,0,414,0,5,409
BUDAPEST,Budapest XXI. kerület,033,839,322,0,322,0,3,319
BUDAPEST,Budapest XXI. kerület,034,738,223,0,223,0,2,221
BUDAPEST,Budapest XXI. kerület,035,752,200,0,200,0,1,199
BUDAPEST,Budapest XXI. kerület,036,821,325,0,325,0,4,321
BUDAPEST,Budapest XXI. kerület,037,843,389,0,389,0,1,388
BUDAPEST,Budapest XXI. kerület,038,1599,859,0,859,0,1,858
BUDAPEST,Budapest XXI. kerület,039,704,316,0,316,0,3,313
BUDAPEST,Budapest XXI. kerület,040,960,394,0,394,0,2,392
BUDAPEST,Budapest XXI. kerület,041,806,278,0,278,0,1,277
BUDAPEST,Budapest XXI. kerület,042,956,365,0,365,0,0,365
BUDAPEST,Budapest XXI. kerület,043,1032,433,0,433,0,3,430
BUDAPEST,Budapest XXI. kerület,044,736,315,0,315,0,2,313
BUDAPEST,Budapest XXI. kerület,045,686,297,2,295,-2,0,295
BUDAPEST,Budapest XXI. kerület,046,919,338,0,337,-1,1,336
BUDAPEST,Budapest XXI. kerület,047,724,276,0,276,0,1,275
BUDAPEST,Budapest XXI. kerület,048,815,434,0,434,0,1,433
BUDAPEST,Budapest XXI. kerület,049,779,433,0,433,0,0,433
BUDAPEST,Budapest XXI. kerület,050,812,379,4,378,-1,3,375
BUDAPEST,Budapest XXI. kerület,051,876,438,0,438,0,0,438
BUDAPEST,Budapest XXI. kerület,052,766,321,0,321,0,1,320
BUDAPEST,Budapest XXI. kerület,053,852,355,0,355,0,0,355
BUDAPEST,Budapest XXI. kerület,054,792,417,0,417,0,4,413
BUDAPEST,Budapest XXI. kerület,055,875,443,0,443,0,0,443
BUDAPEST,Budapest XXI. kerület,056,806,302,1,302,0,0,302
BUDAPEST,Budapest XXI. kerület,057,822,360,0,360,0,2,358
BUDAPEST,Budapest XXI. kerület,058,974,502,0,502,0,1,501
BUDAPEST,Budapest XXI. kerület,059,961,529,0,529,0,2,527
BUDAPEST,Budapest XXI. kerület,060,842,444,0,444,0,1,443
BUDAPEST,Budapest XXI. kerület,061,756,387,2,386,-1,0,386
BUDAPEST,Budapest XXI. kerület,062,850,374,0,373,-1,0,373
BUDAPEST,Budapest XXI. kerület,063,743,363,0,363,0,3,360
BUDAPEST,Budapest XXI. kerület,064,861,363,0,362,-1,0,362
BUDAPEST,Budapest XXI. kerület,065,1080,389,1,389,0,1,388
BUDAPEST,Budapest XXI. kerület,066,918,349,0,349,0,2,347
BUDAPEST,Budapest XXI. kerület,067,868,301,0,301,0,11,290
BUDAPEST,Budapest XXI. kerület,068,966,493,0,493,0,2,491
BUDAPEST,Budapest XXI. kerület,069,761,385,0,385,0,2,383
BUDAPEST,Budapest XXI. kerület,070,710,223,0,223,0,0,223
BUDAPEST,Budapest XXII. kerület,001,1067,688,0,688,0,0,688
BUDAPEST,Budapest XXII. kerület,002,927,596,0,595,-1,2,593
BUDAPEST,Budapest XXII. kerület,003,1176,739,0,737,-2,3,734
BUDAPEST,Budapest XXII. kerület,004,1294,763,0,763,0,2,761
BUDAPEST,Budapest XXII. kerület,005,1366,901,0,901,0,4,897
BUDAPEST,Budapest XXII. kerület,006,1327,798,0,798,0,0,798
BUDAPEST,Budapest XXII. kerület,007,951,452,0,451,-1,4,447
BUDAPEST,Budapest XXII. kerület,008,831,381,0,381,0,2,379
BUDAPEST,Budapest XXII. kerület,009,819,351,0,351,0,2,349
BUDAPEST,Budapest XXII. kerület,010,1382,899,0,899,0,1,898
BUDAPEST,Budapest XXII. kerület,011,1176,587,0,584,-3,3,581
BUDAPEST,Budapest XXII. kerület,012,1222,762,0,762,0,0,762
BUDAPEST,Budapest XXII. kerület,013,1182,620,0,621,1,11,610
BUDAPEST,Budapest XXII. kerület,014,1149,661,0,661,0,1,660
BUDAPEST,Budapest XXII. kerület,015,1051,582,0,582,0,0,582
BUDAPEST,Budapest XXII. kerület,016,1218,667,0,665,-2,4,661
BUDAPEST,Budapest XXII. kerület,017,982,517,0,517,0,1,516
BUDAPEST,Budapest XXII. kerület,018,1017,476,0,475,-1,1,474
BUDAPEST,Budapest XXII. kerület,019,1142,685,0,685,0,2,683
BUDAPEST,Budapest XXII. kerület,020,1175,745,1,744,-1,1,743
BUDAPEST,Budapest XXII. kerület,021,1141,671,0,671,0,4,667
BUDAPEST,Budapest XXII. kerület,022,992,613,0,613,0,1,612
BUDAPEST,Budapest XXII. kerület,023,1208,677,0,677,0,1,676
BUDAPEST,Budapest XXII. kerület,024,1276,743,0,743,0,4,739
BUDAPEST,Budapest XXII. kerület,025,1013,569,0,569,0,1,568
BUDAPEST,Budapest XXII. kerület,026,1174,587,0,587,0,1,586
BUDAPEST,Budapest XXII. kerület,027,1232,733,0,733,0,3,730
BUDAPEST,Budapest XXII. kerület,028,1125,666,1,665,-1,3,662
BUDAPEST,Budapest XXII. kerület,029,1307,627,1,626,-1,0,626
BUDAPEST,Budapest XXII. kerület,030,1166,590,0,590,0,2,588
BUDAPEST,Budapest XXII. kerület,031,1227,666,0,666,0,3,663
BUDAPEST,Budapest XXII. kerület,032,1186,670,0,670,0,3,667
BUDAPEST,Budapest XXII. kerület,033,1203,632,0,631,-1,1,630
BUDAPEST,Budapest XXII. kerület,034,1151,551,1,550,-1,0,550
BUDAPEST,Budapest XXII. kerület,035,1240,545,0,545,0,0,545
BUDAPEST,Budapest XXII. kerület,036,1425,648,0,648,0,3,645
BUDAPEST,Budapest XXII. kerület,037,1308,605,0,605,0,4,601
BUDAPEST,Budapest XXIII. kerület,001,652,321,0,321,0,3,318
BUDAPEST,Budapest XXIII. kerület,002,746,337,0,337,0,1,336
BUDAPEST,Budapest XXIII. kerület,003,972,465,0,465,0,0,465
BUDAPEST,Budapest XXIII. kerület,004,670,374,0,374,0,3,371
BUDAPEST,Budapest XXIII. kerület,005,609,257,0,257,0,1,256
BUDAPEST,Budapest XXIII. kerület,006,852,418,0,417,-1,1,416
BUDAPEST,Budapest XXIII. kerület,007,711,296,0,296,0,0,296
BUDAPEST,Budapest XXIII. kerület,008,628,238,0,238,0,0,238
BUDAPEST,Budapest XXIII. kerület,009,629,307,0,307,0,1,306
BUDAPEST,Budapest XXIII. kerület,010,618,265,0,265,0,1,264
BUDAPEST,Budapest XXIII. kerület,011,671,321,0,320,-1,2,318
BUDAPEST,Budapest XXIII. kerület,012,790,372,0,372,0,5,367
BUDAPEST,Budapest XXIII. kerület,013,634,324,0,324,0,1,323
BUDAPEST,Budapest XXIII. kerület,014,745,314,0,314,0,3,311
BUDAPEST,Budapest XXIII. kerület,015,681,279,0,279,0,1,278
BUDAPEST,Budapest XXIII. kerület,016,732,349,0,348,-1,1,347
BUDAPEST,Budapest XXIII. kerület,017,925,508,0,508,0,1,507
BUDAPEST,Budapest XXIII. kerület,018,699,299,0,299,0,2,297
BUDAPEST,Budapest XXIII. kerület,019,956,463,0,463,0,2,461
BUDAPEST,Budapest XXIII. kerület,020,672,283,0,283,0,1,282
BUDAPEST,Budapest XXIII. kerület,021,838,310,0,310,0,0,310
BUDAPEST,Budapest XXIII. kerület,022,894,429,0,429,0,4,425
BUDAPEST,Budapest XXIII. kerület,023,740,317,0,317,0,2,315
BUDAPEST,Budapest XXIII. kerület,024,724,359,0,359,0,4,355
BARANYA,Abaliget,001,554,223,0,223,0,0,223
BARANYA,Adorjás,001,152,40,0,40,0,1,39
BARANYA,Almamellék,001,324,144,0,144,0,1,143
BARANYA,Almáskeresztúr,001,64,41,0,41,0,0,41
BARANYA,Alsómocsolád,001,255,96,0,96,0,1,95
BARANYA,Alsószentmárton,001,816,144,0,144,0,1,143
BARANYA,Apátvarasd,001,109,60,0,60,0,1,59
BARANYA,Aranyosgadány,001,290,92,0,92,0,2,90
BARANYA,Ág,001,144,52,0,52,0,0,52
BARANYA,Áta,001,161,70,0,70,0,1,69
BARANYA,Babarc,001,586,227,0,227,0,2,225
BARANYA,Babarcszõlõs,001,86,33,0,33,0,0,33
BARANYA,Bakonya,001,289,110,0,109,-1,0,109
BARANYA,Bakóca,001,235,70,0,70,0,0,70
BARANYA,Baksa,001,640,181,0,181,0,0,181
BARANYA,Baranyahídvég,001,148,59,0,59,0,0,59
BARANYA,Baranyajenõ,001,354,128,0,128,0,2,126
BARANYA,Baranyaszentgyörgy,001,101,61,0,61,0,0,61
BARANYA,Basal,001,153,63,0,63,0,0,63
BARANYA,Bánfa,001,138,38,0,38,0,0,38
BARANYA,Bár,001,454,176,0,176,0,1,175
BARANYA,Belvárdgyula,001,326,125,0,125,0,0,125
BARANYA,Beremend,001,685,249,0,249,0,3,246
BARANYA,Beremend,002,703,253,0,253,0,1,252
BARANYA,Beremend,003,662,228,0,228,0,0,228
BARANYA,Berkesd,001,678,226,0,226,0,1,225
BARANYA,Besence,001,94,42,0,42,0,0,42
BARANYA,Bezedek,001,195,89,0,89,0,0,89
BARANYA,Bicsérd,001,833,327,0,327,0,2,325
BARANYA,Bikal,001,623,267,0,267,0,3,264
BARANYA,Birján,001,426,204,0,204,0,1,203
BARANYA,Bisse,001,199,79,0,79,0,1,78
BARANYA,Boda,001,336,129,0,129,0,2,127
BARANYA,Bodolyabér,001,183,71,0,71,0,2,69
BARANYA,Bogád,001,883,364,0,364,0,2,362
BARANYA,Bogádmindszent,001,347,123,0,123,0,0,123
BARANYA,Bogdása,001,220,79,0,79,0,0,79
BARANYA,Boldogasszonyfa,001,209,86,0,86,0,0,86
BARANYA,Boldogasszonyfa,002,36,24,0,24,0,0,24
BARANYA,Boldogasszonyfa,003,70,33,0,33,0,0,33
BARANYA,Borjád,001,318,110,0,110,0,0,110
BARANYA,Bosta,001,108,40,0,40,0,0,40
BARANYA,Botykapeterd,001,255,78,0,78,0,2,76
BARANYA,Bóly,001,709,313,0,313,0,1,312
BARANYA,Bóly,002,664,289,0,289,0,0,289
BARANYA,Bóly,003,862,443,0,443,0,2,441
BARANYA,Bóly,004,656,311,0,311,0,0,311
BARANYA,Bükkösd,001,484,178,0,178,0,2,176
BARANYA,Bükkösd,002,411,114,0,114,0,0,114
BARANYA,Bürüs,001,70,28,0,28,0,0,28
BARANYA,Csarnóta,001,117,47,0,47,0,0,47
BARANYA,Csányoszró,001,530,157,0,157,0,1,156
BARANYA,Csebény,001,71,34,0,34,0,1,33
BARANYA,Cserdi,001,291,62,0,62,0,10,52
BARANYA,Cserkút,001,503,228,0,228,0,1,227
BARANYA,Csertõ,001,319,106,0,106,0,0,106
BARANYA,Csonkamindszent,001,130,64,0,64,0,2,62
BARANYA,Cún,001,165,52,0,52,0,0,52
BARANYA,Dencsháza,001,461,133,0,133,0,0,133
BARANYA,Dinnyeberki,001,67,31,0,31,0,1,30
BARANYA,Diósviszló,001,556,175,0,174,-1,1,173
BARANYA,Drávacsehi,001,149,56,0,56,0,1,55
BARANYA,Drávacsepely,001,185,68,0,68,0,0,68
BARANYA,Drávafok,001,389,137,0,137,0,1,136
BARANYA,Drávaiványi,001,131,59,0,59,0,1,58
BARANYA,Drávakeresztúr,001,103,36,0,36,0,1,35
BARANYA,Drávapalkonya,001,209,56,0,56,0,0,56
BARANYA,Drávapiski,001,68,14,0,14,0,0,14
BARANYA,Drávaszabolcs,001,552,210,0,210,0,1,209
BARANYA,Drávaszerdahely,001,149,61,1,61,0,1,60
BARANYA,Drávasztára,001,337,112,0,112,0,0,112
BARANYA,Dunaszekcsõ,001,817,257,0,257,0,2,255
BARANYA,Dunaszekcsõ,002,746,305,0,305,0,0,305
BARANYA,Egerág,001,793,290,1,289,-1,2,287
BARANYA,Egyházasharaszti,001,244,81,0,81,0,0,81
BARANYA,Egyházaskozár,001,624,234,0,234,0,0,234
BARANYA,Ellend,001,179,87,0,87,0,0,87
BARANYA,Endrõc,001,297,103,0,103,0,1,102
BARANYA,Erdõsmárok,001,60,37,0,37,0,1,36
BARANYA,Erdõsmecske,001,290,89,0,89,0,1,88
BARANYA,Erzsébet,001,241,81,0,81,0,0,81
BARANYA,Fazekasboda,001,157,62,0,62,0,0,62
BARANYA,Feked,001,155,89,0,89,0,3,86
BARANYA,Felsõegerszeg,001,112,35,0,35,0,0,35
BARANYA,Felsõszentmárton,001,723,264,0,264,0,2,262
BARANYA,Garé,001,240,85,0,85,0,1,84
BARANYA,Gerde,001,404,142,0,142,0,0,142
BARANYA,Geresdlak,001,374,175,0,175,0,0,175
BARANYA,Geresdlak,002,256,88,0,88,0,0,88
BARANYA,Gerényes,001,162,41,0,41,0,0,41
BARANYA,Gilvánfa,001,258,56,0,56,0,0,56
BARANYA,Gordisa,001,220,58,0,58,0,2,56
BARANYA,Gödre,001,488,177,0,177,0,3,174
BARANYA,Gödre,002,184,61,0,61,0,4,57
BARANYA,Görcsöny,001,623,246,0,246,0,0,246
BARANYA,Görcsöny,002,540,193,0,193,0,0,193
BARANYA,Görcsöny,003,141,47,0,47,0,0,47
BARANYA,Görcsönydoboka,001,316,112,0,112,0,0,112
BARANYA,Gyód,001,577,225,1,224,-1,1,223
BARANYA,Gyöngyfa,001,106,43,0,43,0,0,43
BARANYA,Gyöngyösmellék,001,230,50,0,50,0,0,50
BARANYA,Harkány,001,728,332,0,332,0,3,329
BARANYA,Harkány,002,915,442,0,442,0,2,440
BARANYA,Harkány,003,1184,697,0,697,0,6,691
BARANYA,Harkány,004,1139,440,0,440,0,3,437
BARANYA,Hásságy,001,243,142,0,142,0,2,140
BARANYA,Hegyhátmaróc,001,117,59,0,59,0,1,58
BARANYA,Hegyszentmárton,001,330,119,0,119,0,0,119
BARANYA,Helesfa,001,288,98,0,98,0,1,97
BARANYA,Hetvehely,001,365,128,0,128,0,0,128
BARANYA,Hidas,001,850,314,0,314,0,3,311
BARANYA,Hidas,002,853,331,0,331,0,2,329
BARANYA,Himesháza,001,340,150,0,150,0,1,149
BARANYA,Himesháza,002,502,181,0,181,0,2,179
BARANYA,Hirics,001,177,68,0,68,0,0,68
BARANYA,Hobol,001,370,108,0,108,0,0,108
BARANYA,Hobol,002,401,147,0,147,0,0,147
BARANYA,Homorúd,001,476,199,0,199,0,3,196
BARANYA,Horváthertelend,001,45,27,0,27,0,1,26
BARANYA,Hosszúhetény,001,982,404,0,404,0,1,403
BARANYA,Hosszúhetény,002,863,389,0,389,0,2,387
BARANYA,Hosszúhetény,003,909,335,0,335,0,1,334
BARANYA,Husztót,001,52,28,0,28,0,0,28
BARANYA,Ibafa,001,175,72,0,72,0,0,72
BARANYA,Illocska,001,207,85,0,85,0,2,83
BARANYA,Ipacsfa,001,176,86,0,86,0,1,85
BARANYA,Ivánbattyán,001,101,46,0,46,0,0,46
BARANYA,Ivándárda,001,193,83,0,83,0,0,83
BARANYA,Kacsóta,001,221,75,0,75,0,1,74
BARANYA,Katádfa,001,125,50,0,50,0,1,49
BARANYA,Kákics,001,162,55,0,55,0,3,52
BARANYA,Kárász,001,272,108,0,108,0,2,106
BARANYA,Kásád,001,250,84,0,84,0,3,81
BARANYA,Kátoly,001,256,111,0,111,0,0,111
BARANYA,Kemse,001,50,32,0,32,0,2,30
BARANYA,Keszü,001,1104,477,0,476,-1,0,476
BARANYA,Kékesd,001,143,75,0,75,0,1,74
BARANYA,Kémes,001,390,161,0,161,0,1,160
BARANYA,Kétújfalu,001,571,196,0,196,0,2,194
BARANYA,Királyegyháza,001,743,199,0,199,0,0,199
BARANYA,Kisasszonyfa,001,157,57,0,57,0,0,57
BARANYA,Kisbeszterce,001,62,28,0,28,0,0,28
BARANYA,Kisbudmér,001,88,28,0,28,0,0,28
BARANYA,Kisdér,001,95,45,0,45,0,0,45
BARANYA,Kisdobsza,001,193,62,0,62,0,0,62
BARANYA,Kishajmás,001,152,53,0,53,0,1,52
BARANYA,Kisharsány,001,408,131,0,131,0,1,130
BARANYA,Kisherend,001,174,64,0,64,0,0,64
BARANYA,Kisjakabfalva,001,111,59,0,59,0,0,59
BARANYA,Kiskassa,001,201,88,0,88,0,0,88
BARANYA,Kislippó,001,247,89,0,89,0,2,87
BARANYA,Kisnyárád,001,155,65,0,65,0,2,63
BARANYA,Kisszentmárton,001,124,62,0,62,0,0,62
BARANYA,Kisszentmárton,002,76,16,0,16,0,0,16
BARANYA,Kistamási,001,101,35,0,35,0,0,35
BARANYA,Kistapolca,001,170,52,0,52,0,0,52
BARANYA,Kistótfalu,001,256,100,0,100,0,0,100
BARANYA,Kisvaszar,001,251,82,0,82,0,0,82
BARANYA,Komló,001,933,312,0,312,0,4,308
BARANYA,Komló,002,896,335,0,335,0,1,334
BARANYA,Komló,003,1099,443,0,443,0,2,441
BARANYA,Komló,004,1092,438,0,438,0,1,437
BARANYA,Komló,005,1052,352,0,351,-1,0,351
BARANYA,Komló,006,1194,397,0,397,0,1,396
BARANYA,Komló,007,862,343,1,342,-1,2,340
BARANYA,Komló,008,852,395,0,395,0,0,395
BARANYA,Komló,009,1307,506,0,506,0,2,504
BARANYA,Komló,010,726,293,0,293,0,2,291
BARANYA,Komló,011,778,333,0,333,0,0,333
BARANYA,Komló,012,1195,342,0,342,0,6,336
BARANYA,Komló,013,1195,400,0,399,-1,1,398
BARANYA,Komló,014,1154,421,0,421,0,0,421
BARANYA,Komló,015,1183,434,0,434,0,1,433
BARANYA,Komló,016,910,294,0,294,0,1,293
BARANYA,Komló,017,1325,377,0,377,0,0,377
BARANYA,Komló,018,838,365,0,365,0,3,362
BARANYA,Komló,019,752,344,0,344,0,2,342
BARANYA,Komló,020,342,158,1,157,-1,0,157
BARANYA,Komló,021,610,210,0,210,0,1,209
BARANYA,Komló,022,158,83,0,83,0,0,83
BARANYA,Kovácshida,001,209,65,0,65,0,1,64
BARANYA,Kovácsszénája,001,60,38,0,38,0,0,38
BARANYA,Kozármisleny,001,1008,404,0,404,0,0,404
BARANYA,Kozármisleny,002,882,457,0,457,0,3,454
BARANYA,Kozármisleny,003,1024,462,0,462,0,0,462
BARANYA,Kozármisleny,004,946,434,0,434,0,1,433
BARANYA,Kozármisleny,005,976,408,0,408,0,1,407
BARANYA,Kórós,001,167,59,0,59,0,2,57
BARANYA,Köblény,001,179,59,0,59,0,0,59
BARANYA,Kökény,001,562,234,0,234,0,1,233
BARANYA,Kölked,001,820,253,0,253,0,1,252
BARANYA,Kõvágószõlõs,001,584,252,0,252,0,1,251
BARANYA,Kõvágószõlõs,002,488,137,0,137,0,1,136
BARANYA,Kõvágótöttös,001,276,102,0,102,0,2,100
BARANYA,Lapáncsa,001,153,83,0,83,0,1,82
BARANYA,Lánycsók,001,1075,452,0,452,0,2,450
BARANYA,Lánycsók,002,964,333,0,333,0,1,332
BARANYA,Liget,001,320,110,0,110,0,0,110
BARANYA,Lippó,001,410,141,0,141,0,3,138
BARANYA,Liptód,001,163,59,0,59,0,0,59
BARANYA,Lothárd,001,220,73,0,73,0,0,73
BARANYA,Lovászhetény,001,236,69,0,69,0,0,69
BARANYA,Lúzsok,001,160,42,0,42,0,0,42
BARANYA,Magyarbóly,001,767,279,0,279,0,3,276
BARANYA,Magyaregregy,001,626,219,0,219,0,2,217
BARANYA,Magyarhertelend,001,439,207,0,207,0,0,207
BARANYA,Magyarhertelend,002,97,56,0,56,0,0,56
BARANYA,Magyarlukafa,001,56,30,0,30,0,0,30
BARANYA,Magyarmecske,001,237,71,0,71,0,0,71
BARANYA,Magyarsarlós,001,257,109,0,109,0,0,109
BARANYA,Magyarszék,001,827,363,0,363,0,3,360
BARANYA,Magyartelek,001,158,60,0,60,0,0,60
BARANYA,Majs,001,761,277,0,277,0,0,277
BARANYA,Maráza,001,155,70,0,70,0,3,67
BARANYA,Markóc,001,51,25,0,25,0,0,25
BARANYA,Marócsa,001,64,42,0,42,0,2,40
BARANYA,Martonfa,001,186,116,0,116,0,3,113
BARANYA,Matty,001,281,111,0,111,0,2,109
BARANYA,Mágocs,001,975,356,0,356,0,2,354
BARANYA,Mágocs,002,911,282,0,282,0,0,282
BARANYA,Mánfa,001,648,285,0,285,0,2,283
BARANYA,Márfa,001,164,71,0,71,0,1,70
BARANYA,Máriakéménd,001,412,140,0,140,0,0,140
BARANYA,Márok,001,358,163,0,163,0,1,162
BARANYA,Máza,001,710,256,0,256,0,0,256
BARANYA,Máza,002,245,112,0,112,0,2,110
BARANYA,Mecseknádasd,001,662,293,0,293,0,6,287
BARANYA,Mecseknádasd,002,659,304,0,304,0,0,304
BARANYA,Mecsekpölöske,001,355,154,0,154,0,0,154
BARANYA,Mekényes,001,226,90,0,90,0,0,90
BARANYA,Merenye,001,206,52,0,52,0,0,52
BARANYA,Mezõd,001,91,40,0,40,0,0,40
BARANYA,Mindszentgodisa,001,260,98,0,98,0,2,96
BARANYA,Mindszentgodisa,002,372,154,0,154,0,0,154
BARANYA,Mohács,001,824,386,0,386,0,2,384
BARANYA,Mohács,002,635,268,0,268,0,0,268
BARANYA,Mohács,003,586,248,0,248,0,0,248
BARANYA,Mohács,004,840,370,0,370,0,1,369
BARANYA,Mohács,005,582,256,0,256,0,1,255
BARANYA,Mohács,006,615,281,0,281,0,4,277
BARANYA,Mohács,007,848,393,0,393,0,2,391
BARANYA,Mohács,008,702,322,0,322,0,3,319
BARANYA,Mohács,009,613,160,0,160,0,2,158
BARANYA,Mohács,010,857,305,0,305,0,0,305
BARANYA,Mohács,011,807,276,0,276,0,1,275
BARANYA,Mohács,012,934,378,0,378,0,2,376
BARANYA,Mohács,013,731,353,0,353,0,1,352
BARANYA,Mohács,014,778,365,0,365,0,1,364
BARANYA,Mohács,015,810,310,0,310,0,0,310
BARANYA,Mohács,016,821,247,0,247,0,2,245
BARANYA,Mohács,017,789,219,0,219,0,1,218
BARANYA,Mohács,018,828,273,0,273,0,0,273
BARANYA,Mohács,019,743,279,0,279,0,4,275
BARANYA,Mohács,020,106,33,0,33,0,0,33
BARANYA,Mohács,021,197,82,0,82,0,1,81
BARANYA,Mohács,022,59,20,0,20,0,0,20
BARANYA,Mohács,023,481,182,0,182,0,0,182
BARANYA,Molvány,001,147,54,0,54,0,0,54
BARANYA,Monyoród,001,129,52,0,52,0,0,52
BARANYA,Mozsgó,001,453,136,0,136,0,0,136
BARANYA,Mozsgó,002,241,68,0,68,0,0,68
BARANYA,Nagybudmér,001,137,62,0,62,0,0,62
BARANYA,Nagycsány,001,110,52,0,52,0,1,51
BARANYA,Nagydobsza,001,479,122,0,122,0,1,121
BARANYA,Nagyhajmás,001,254,100,0,100,0,0,100
BARANYA,Nagyharsány,001,594,190,0,190,0,0,190
BARANYA,Nagyharsány,002,606,194,0,194,0,0,194
BARANYA,Nagykozár,001,753,347,0,347,0,2,345
BARANYA,Nagykozár,002,796,353,0,353,0,4,349
BARANYA,Nagynyárád,001,580,304,1,302,-2,0,302
BARANYA,Nagypall,001,312,136,0,136,0,2,134
BARANYA,Nagypeterd,001,552,224,0,224,0,1,223
BARANYA,Nagytótfalu,001,279,117,0,117,0,1,116
BARANYA,Nagyváty,001,255,122,0,122,0,0,122
BARANYA,Nemeske,001,100,36,0,36,0,0,36
BARANYA,Nemeske,002,94,43,0,43,0,0,43
BARANYA,Nyugotszenterzsébet,001,193,61,0,61,0,0,61
BARANYA,Okorág,001,124,53,0,53,0,0,53
BARANYA,Okorvölgy,001,62,22,0,22,0,0,22
BARANYA,Olasz,001,506,208,0,208,0,2,206
BARANYA,Old,001,235,114,0,114,0,2,112
BARANYA,Orfû,001,873,432,0,432,0,1,431
BARANYA,Oroszló,001,237,97,0,97,0,2,95
BARANYA,Óbánya,001,110,70,0,70,0,4,66
BARANYA,Ócsárd,001,340,109,0,109,0,0,109
BARANYA,Ófalu,001,288,130,0,130,0,2,128
BARANYA,Ózdfalu,001,123,56,0,56,0,0,56
BARANYA,Palé,001,72,43,0,43,0,1,42
BARANYA,Palkonya,001,225,93,0,93,0,0,93
BARANYA,Palotabozsok,001,338,166,0,166,0,1,165
BARANYA,Palotabozsok,002,373,182,0,182,0,2,180
BARANYA,Patapoklosi,001,284,93,0,93,0,0,93
BARANYA,Páprád,001,133,73,0,73,0,0,73
BARANYA,Pellérd,001,956,369,0,369,0,0,369
BARANYA,Pellérd,002,850,337,0,337,0,1,336
BARANYA,Pereked,001,133,63,0,63,0,0,63
BARANYA,Peterd,001,164,76,0,76,0,0,76
BARANYA,Pettend,001,103,48,0,48,0,0,48
BARANYA,Pécs,001,800,332,0,332,0,1,331
BARANYA,Pécs,002,585,236,0,236,0,0,236
BARANYA,Pécs,003,629,214,0,214,0,3,211
BARANYA,Pécs,004,597,211,0,211,0,0,211
BARANYA,Pécs,005,801,315,0,315,0,2,313
BARANYA,Pécs,006,862,328,0,328,0,3,325
BARANYA,Pécs,007,851,299,0,299,0,1,298
BARANYA,Pécs,008,817,276,0,276,0,1,275
BARANYA,Pécs,009,1029,400,0,400,0,3,397
BARANYA,Pécs,010,865,278,0,278,0,1,277
BARANYA,Pécs,011,721,345,0,345,0,8,337
BARANYA,Pécs,012,988,268,0,268,0,1,267
BARANYA,Pécs,013,730,324,0,324,0,0,324
BARANYA,Pécs,014,684,177,0,177,0,0,177
BARANYA,Pécs,015,599,206,0,206,0,3,203
BARANYA,Pécs,016,745,242,0,242,0,5,237
BARANYA,Pécs,017,645,219,0,219,0,1,218
BARANYA,Pécs,018,863,413,0,413,0,0,413
BARANYA,Pécs,019,858,394,0,394,0,1,393
BARANYA,Pécs,020,658,258,0,258,0,1,257
BARANYA,Pécs,021,914,422,0,421,-1,1,420
BARANYA,Pécs,022,1198,487,0,487,0,1,486
BARANYA,Pécs,023,988,480,0,480,0,11,469
BARANYA,Pécs,024,157,89,0,89,0,0,89
BARANYA,Pécs,025,723,251,0,251,0,0,251
BARANYA,Pécs,026,611,251,0,251,0,0,251
BARANYA,Pécs,027,995,536,0,536,0,1,535
BARANYA,Pécs,028,856,455,0,455,0,1,454
BARANYA,Pécs,029,724,352,0,352,0,2,350
BARANYA,Pécs,030,764,374,0,374,0,0,374
BARANYA,Pécs,031,644,267,0,267,0,1,266
BARANYA,Pécs,032,720,304,0,304,0,2,302
BARANYA,Pécs,033,803,413,0,413,0,1,412
BARANYA,Pécs,034,729,387,0,387,0,0,387
BARANYA,Pécs,035,575,268,0,268,0,1,267
BARANYA,Pécs,036,602,273,0,272,-1,0,272
BARANYA,Pécs,037,731,407,0,407,0,1,406
BARANYA,Pécs,038,916,450,0,450,0,0,450
BARANYA,Pécs,039,797,310,0,310,0,0,310
BARANYA,Pécs,040,653,223,0,223,0,0,223
BARANYA,Pécs,041,1092,504,0,504,0,3,501
BARANYA,Pécs,042,641,270,0,270,0,3,267
BARANYA,Pécs,043,596,226,0,226,0,2,224
BARANYA,Pécs,044,582,219,0,219,0,1,218
BARANYA,Pécs,045,592,284,0,284,0,1,283
BARANYA,Pécs,046,740,392,0,392,0,0,392
BARANYA,Pécs,047,2729,1481,1,1480,-1,5,1475
BARANYA,Pécs,048,591,300,0,300,0,0,300
BARANYA,Pécs,049,626,359,0,359,0,1,358
BARANYA,Pécs,050,601,349,0,348,-1,2,346
BARANYA,Pécs,051,679,352,0,352,0,4,348
BARANYA,Pécs,052,657,342,0,342,0,1,341
BARANYA,Pécs,053,774,401,2,399,-2,2,397
BARANYA,Pécs,054,918,493,0,493,0,4,489
BARANYA,Pécs,055,645,376,0,375,-1,1,374
BARANYA,Pécs,056,734,381,0,381,0,3,378
BARANYA,Pécs,057,624,306,0,306,0,1,305
BARANYA,Pécs,058,715,379,0,379,0,3,376
BARANYA,Pécs,059,667,308,0,308,0,3,305
BARANYA,Pécs,060,766,409,0,409,0,1,408
BARANYA,Pécs,061,729,359,1,358,-1,1,357
BARANYA,Pécs,062,582,305,0,305,0,1,304
BARANYA,Pécs,063,623,315,0,315,0,0,315
BARANYA,Pécs,064,656,371,0,371,0,3,368
BARANYA,Pécs,065,579,315,0,315,0,1,314
BARANYA,Pécs,066,591,363,0,363,0,6,357
BARANYA,Pécs,067,686,395,0,395,0,1,394
BARANYA,Pécs,068,583,356,0,356,0,1,355
BARANYA,Pécs,069,742,460,0,460,0,0,460
BARANYA,Pécs,070,968,571,0,571,0,4,567
BARANYA,Pécs,071,861,499,0,499,0,2,497
BARANYA,Pécs,072,622,372,0,372,0,4,368
BARANYA,Pécs,073,648,320,0,320,0,1,319
BARANYA,Pécs,074,646,278,0,278,0,0,278
BARANYA,Pécs,075,614,300,0,300,0,0,300
BARANYA,Pécs,076,867,492,0,491,-1,2,489
BARANYA,Pécs,077,925,545,0,545,0,2,543
BARANYA,Pécs,078,609,296,0,296,0,1,295
BARANYA,Pécs,079,596,280,0,280,0,2,278
BARANYA,Pécs,080,628,284,0,284,0,2,282
BARANYA,Pécs,081,589,261,0,260,-1,3,257
BARANYA,Pécs,082,598,254,0,254,0,2,252
BARANYA,Pécs,083,600,289,0,289,0,4,285
BARANYA,Pécs,084,684,301,0,301,0,2,299
BARANYA,Pécs,085,682,328,0,328,0,3,325
BARANYA,Pécs,086,598,330,0,330,0,1,329
BARANYA,Pécs,087,613,281,0,281,0,2,279
BARANYA,Pécs,088,768,401,0,400,-1,6,394
BARANYA,Pécs,089,595,276,0,276,0,0,276
BARANYA,Pécs,090,753,271,0,271,0,3,268
BARANYA,Pécs,091,650,361,0,361,0,0,361
BARANYA,Pécs,092,630,306,0,305,-1,1,304
BARANYA,Pécs,093,1086,557,0,557,0,1,556
BARANYA,Pécs,094,990,385,0,385,0,1,384
BARANYA,Pécs,095,1042,502,0,502,0,5,497
BARANYA,Pécs,096,899,433,0,433,0,3,430
BARANYA,Pécs,097,940,485,0,485,0,1,484
BARANYA,Pécs,098,916,436,0,436,0,1,435
BARANYA,Pécs,099,990,495,0,495,0,0,495
BARANYA,Pécs,100,1137,615,0,615,0,1,614
BARANYA,Pécs,101,1013,474,0,473,-1,0,473
BARANYA,Pécs,102,1122,521,0,521,0,0,521
BARANYA,Pécs,103,1002,464,0,464,0,4,460
BARANYA,Pécs,104,805,450,0,450,0,4,446
BARANYA,Pécs,105,730,379,0,379,0,0,379
BARANYA,Pécs,106,620,336,0,336,0,1,335
BARANYA,Pécs,107,762,360,2,360,0,3,357
BARANYA,Pécs,108,802,373,0,373,0,0,373
BARANYA,Pécs,109,673,252,0,252,0,4,248
BARANYA,Pécs,110,660,267,0,267,0,0,267
BARANYA,Pécs,111,824,310,0,309,-1,1,308
BARANYA,Pécs,112,732,268,0,268,0,2,266
BARANYA,Pécs,113,687,298,0,298,0,0,298
BARANYA,Pécs,114,640,291,0,291,0,2,289
BARANYA,Pécs,115,765,290,0,290,0,2,288
BARANYA,Pécs,116,836,394,0,394,0,1,393
BARANYA,Pécs,117,669,291,0,291,0,0,291
BARANYA,Pécs,118,725,286,0,286,0,0,286
BARANYA,Pécs,119,795,312,0,311,-1,0,311
BARANYA,Pécs,120,616,269,0,269,0,2,267
BARANYA,Pécs,121,640,222,0,222,0,1,221
BARANYA,Pécs,122,635,260,0,260,0,0,260
BARANYA,Pécs,123,811,315,0,315,0,0,315
BARANYA,Pécs,124,1099,477,0,477,0,1,476
BARANYA,Pécs,125,910,462,1,460,-2,0,460
BARANYA,Pécs,126,655,247,4,243,-4,1,242
BARANYA,Pécs,127,606,254,0,254,0,0,254
BARANYA,Pécs,128,801,316,0,316,0,1,315
BARANYA,Pécs,129,888,329,0,329,0,0,329
BARANYA,Pécs,130,916,343,0,343,0,1,342
BARANYA,Pécs,131,911,362,0,362,0,0,362
BARANYA,Pécs,132,599,232,0,232,0,0,232
BARANYA,Pécs,133,968,411,0,411,0,6,405
BARANYA,Pécs,134,817,360,1,359,-1,0,359
BARANYA,Pécs,135,674,286,0,286,0,2,284
BARANYA,Pécs,136,995,404,0,402,-2,0,402
BARANYA,Pécs,137,1008,421,0,421,0,1,420
BARANYA,Pécs,138,1351,607,0,607,0,2,605
BARANYA,Pécs,139,910,367,0,367,0,1,366
BARANYA,Pécs,140,1254,440,0,440,0,0,440
BARANYA,Pécs,141,775,291,0,291,0,1,290
BARANYA,Pécs,142,979,410,0,410,0,2,408
BARANYA,Pécs,143,989,403,0,403,0,0,403
BARANYA,Pécs,144,878,407,0,407,0,0,407
BARANYA,Pécs,145,960,360,0,360,0,0,360
BARANYA,Pécs,146,1092,498,0,498,0,1,497
BARANYA,Pécs,147,832,327,0,327,0,2,325
BARANYA,Pécs,148,801,381,0,381,0,1,380
BARANYA,Pécs,149,707,261,0,261,0,6,255
BARANYA,Pécsbagota,001,87,34,0,34,0,0,34
BARANYA,Pécsdevecser,001,92,44,0,44,0,1,43
BARANYA,Pécsudvard,001,644,302,0,302,0,1,301
BARANYA,Pécsvárad,001,1113,541,0,541,0,1,540
BARANYA,Pécsvárad,002,1111,521,0,521,0,1,520
BARANYA,Pécsvárad,003,1004,405,0,405,0,4,401
BARANYA,Piskó,001,177,109,0,109,0,0,109
BARANYA,Pogány,001,1014,464,0,464,0,1,463
BARANYA,Pócsa,001,143,50,0,50,0,2,48
BARANYA,Rádfalva,001,164,67,0,67,0,1,66
BARANYA,Regenye,001,139,33,0,33,0,1,32
BARANYA,Romonya,001,429,184,0,184,0,1,183
BARANYA,Rózsafa,001,270,90,0,90,0,0,90
BARANYA,Sámod,001,166,82,0,82,0,0,82
BARANYA,Sárok,001,105,40,0,40,0,0,40
BARANYA,Sásd,001,659,205,0,205,0,1,204
BARANYA,Sásd,002,563,226,0,226,0,1,225
BARANYA,Sásd,003,762,298,0,298,0,1,297
BARANYA,Sásd,004,556,203,0,203,0,2,201
BARANYA,Sátorhely,001,517,190,0,190,0,2,188
BARANYA,Sellye,001,679,249,0,249,0,0,249
BARANYA,Sellye,002,781,257,0,257,0,5,252
BARANYA,Sellye,003,810,279,0,279,0,0,279
BARANYA,Siklós,001,663,284,0,284,0,1,283
BARANYA,Siklós,002,587,254,0,253,-1,0,253
BARANYA,Siklós,003,897,310,0,310,0,2,308
BARANYA,Siklós,004,939,373,0,373,0,0,373
BARANYA,Siklós,005,997,414,0,414,0,0,414
BARANYA,Siklós,006,985,412,0,412,0,1,411
BARANYA,Siklós,007,991,358,0,358,0,0,358
BARANYA,Siklós,008,851,356,0,356,0,0,356
BARANYA,Siklós,009,1051,350,0,350,0,1,349
BARANYA,Siklósbodony,001,115,45,0,45,0,4,41
BARANYA,Siklósnagyfalu,001,310,80,0,80,0,0,80
BARANYA,Somberek,001,661,254,0,254,0,1,253
BARANYA,Somberek,002,587,258,0,258,0,3,255
BARANYA,Somogyapáti,001,382,148,0,148,0,1,147
BARANYA,Somogyhatvan,001,262,58,0,58,0,0,58
BARANYA,Somogyhárságy,001,205,74,0,74,0,0,74
BARANYA,Somogyhárságy,002,128,46,0,46,0,0,46
BARANYA,Somogyviszló,001,180,61,0,61,0,0,61
BARANYA,Sósvertike,001,140,68,0,68,0,0,68
BARANYA,Sumony,001,274,65,0,65,0,1,64
BARANYA,Sumony,002,71,31,0,31,0,0,31
BARANYA,Szabadszentkirály,001,655,269,0,269,0,1,268
BARANYA,Szajk,001,646,310,0,310,0,1,309
BARANYA,Szalatnak,001,265,100,0,100,0,0,100
BARANYA,Szalánta,001,765,302,0,302,0,1,301
BARANYA,Szalánta,002,173,77,0,77,0,0,77
BARANYA,Szaporca,001,181,85,0,85,0,1,84
BARANYA,Szava,001,255,85,0,85,0,0,85
BARANYA,Szágy,001,93,52,0,52,0,0,52
BARANYA,Szárász,001,35,16,0,16,0,0,16
BARANYA,Szászvár,001,986,339,0,339,0,2,337
BARANYA,Szászvár,002,934,343,0,343,0,3,340
BARANYA,Szebény,001,291,127,0,127,0,0,127
BARANYA,Szederkény,001,743,289,0,289,0,3,286
BARANYA,Szederkény,002,704,211,0,211,0,1,210
BARANYA,Szellõ,001,118,48,0,48,0,0,48
BARANYA,Szemely,001,393,156,0,156,0,0,156
BARANYA,Szentdénes,001,244,78,0,78,0,0,78
BARANYA,Szentegát,001,295,102,0,102,0,0,102
BARANYA,Szentkatalin,001,77,36,0,36,0,1,35
BARANYA,Szentlászló,001,404,129,0,129,0,2,127
BARANYA,Szentlászló,002,256,92,0,92,0,0,92
BARANYA,Szentlõrinc,001,927,337,1,336,-1,0,336
BARANYA,Szentlõrinc,002,583,188,0,188,0,0,188
BARANYA,Szentlõrinc,003,667,256,0,256,0,0,256
BARANYA,Szentlõrinc,004,736,296,0,296,0,1,295
BARANYA,Szentlõrinc,005,793,257,1,256,-1,3,253
BARANYA,Szentlõrinc,006,763,255,0,255,0,3,252
BARANYA,Szentlõrinc,007,655,250,0,250,0,0,250
BARANYA,Szentlõrinc,008,172,50,0,50,0,0,50
BARANYA,Székelyszabar,001,463,189,0,189,0,0,189
BARANYA,Szigetvár,001,1019,400,0,400,0,2,398
BARANYA,Szigetvár,002,1095,439,0,439,0,3,436
BARANYA,Szigetvár,003,1015,393,0,393,0,4,389
BARANYA,Szigetvár,004,702,297,0,297,0,2,295
BARANYA,Szigetvár,005,589,245,0,245,0,1,244
BARANYA,Szigetvár,006,1057,355,0,355,0,1,354
BARANYA,Szigetvár,007,1030,417,0,417,0,1,416
BARANYA,Szigetvár,008,666,250,0,250,0,0,250
BARANYA,Szigetvár,009,587,218,0,218,0,1,217
BARANYA,Szigetvár,010,255,75,0,75,0,2,73
BARANYA,Szigetvár,011,532,149,0,149,0,1,148
BARANYA,Szilágy,001,229,96,0,96,0,0,96
BARANYA,Szilvás,001,116,50,0,50,0,0,50
BARANYA,Szörény,001,55,24,0,24,0,0,24
BARANYA,Szõke,001,99,40,0,40,0,0,40
BARANYA,Szõkéd,001,305,105,0,105,0,2,103
BARANYA,Szulimán,001,190,71,0,71,0,1,70
BARANYA,Szûr,001,222,90,0,90,0,0,90
BARANYA,Tarrós,001,71,32,0,32,0,0,32
BARANYA,Teklafalu,001,251,65,0,65,0,0,65
BARANYA,Tengeri,001,44,26,0,26,0,0,26
BARANYA,Tékes,001,194,58,0,58,0,1,57
BARANYA,Tésenfa,001,157,52,0,52,0,0,52
BARANYA,Téseny,001,245,70,0,70,0,0,70
BARANYA,Tormás,001,222,83,0,83,0,0,83
BARANYA,Tófû,001,95,50,0,50,0,0,50
BARANYA,Tótszentgyörgy,001,120,57,0,57,0,0,57
BARANYA,Töttös,001,433,131,0,131,0,2,129
BARANYA,Túrony,001,220,103,0,103,0,1,102
BARANYA,Udvar,001,124,65,0,65,0,0,65
BARANYA,Újpetre,001,828,276,0,276,0,2,274
BARANYA,Vajszló,001,729,278,0,278,0,0,278
BARANYA,Vajszló,002,705,218,0,218,0,1,217
BARANYA,Varga,001,64,41,0,41,0,0,41
BARANYA,Várad,001,98,36,0,36,0,0,36
BARANYA,Vásárosbéc,001,162,46,0,46,0,0,46
BARANYA,Vásárosdombó,001,904,273,0,273,0,5,268
BARANYA,Vázsnok,001,109,44,0,44,0,0,44
BARANYA,Vejti,001,128,53,0,53,0,0,53
BARANYA,Velény,001,104,34,0,34,0,0,34
BARANYA,Versend,001,682,150,0,150,0,1,149
BARANYA,Vékény,001,117,49,0,49,0,1,48
BARANYA,Véménd,001,648,278,0,278,0,2,276
BARANYA,Véménd,002,505,171,0,171,0,1,170
BARANYA,Villány,001,928,420,1,419,-1,2,417
BARANYA,Villány,002,839,384,0,384,0,0,384
BARANYA,Villány,003,167,77,0,77,0,1,76
BARANYA,Villánykövesd,001,223,132,0,132,0,0,132
BARANYA,Vokány,001,668,261,0,261,0,1,260
BARANYA,Zaláta,001,199,86,0,86,0,0,86
BARANYA,Zádor,001,266,91,0,91,0,0,91
BARANYA,Zengõvárkony,001,358,185,0,185,0,0,185
BARANYA,Zók,001,237,73,0,73,0,0,73
BÁCS-KISKUN,Akasztó,001,1401,565,0,565,0,3,562
BÁCS-KISKUN,Akasztó,002,1321,481,1,480,-1,3,477
BÁCS-KISKUN,Apostag,001,839,299,0,299,0,0,299
BÁCS-KISKUN,Apostag,002,828,274,0,274,0,1,273
BÁCS-KISKUN,Ágasegyháza,001,799,289,0,289,0,7,282
BÁCS-KISKUN,Ágasegyháza,002,745,283,0,283,0,3,280
BÁCS-KISKUN,Baja,001,976,415,0,415,0,3,412
BÁCS-KISKUN,Baja,002,1234,519,0,519,0,1,518
BÁCS-KISKUN,Baja,003,871,403,0,403,0,0,403
BÁCS-KISKUN,Baja,004,1008,427,0,427,0,0,427
BÁCS-KISKUN,Baja,005,1000,495,0,495,0,4,491
BÁCS-KISKUN,Baja,006,1119,518,0,518,0,0,518
BÁCS-KISKUN,Baja,007,917,471,0,471,0,2,469
BÁCS-KISKUN,Baja,008,778,351,0,351,0,2,349
BÁCS-KISKUN,Baja,009,923,438,0,438,0,7,431
BÁCS-KISKUN,Baja,010,1057,478,0,478,0,1,477
BÁCS-KISKUN,Baja,011,798,388,0,387,-1,2,385
BÁCS-KISKUN,Baja,012,958,496,0,496,0,5,491
BÁCS-KISKUN,Baja,013,861,413,0,413,0,2,411
BÁCS-KISKUN,Baja,014,1033,438,0,437,-1,3,434
BÁCS-KISKUN,Baja,015,1103,465,0,465,0,3,462
BÁCS-KISKUN,Baja,016,1186,452,0,452,0,1,451
BÁCS-KISKUN,Baja,017,930,423,0,423,0,1,422
BÁCS-KISKUN,Baja,018,920,414,0,414,0,4,410
BÁCS-KISKUN,Baja,019,648,335,1,335,0,1,334
BÁCS-KISKUN,Baja,020,1241,584,0,583,-1,1,582
BÁCS-KISKUN,Baja,021,1127,508,0,507,-1,1,506
BÁCS-KISKUN,Baja,022,973,361,0,361,0,1,360
BÁCS-KISKUN,Baja,023,989,405,0,405,0,2,403
BÁCS-KISKUN,Baja,024,1079,443,0,442,-1,1,441
BÁCS-KISKUN,Baja,025,912,353,0,353,0,4,349
BÁCS-KISKUN,Baja,026,814,356,0,356,0,0,356
BÁCS-KISKUN,Baja,027,991,435,0,435,0,2,433
BÁCS-KISKUN,Baja,028,708,306,0,306,0,0,306
BÁCS-KISKUN,Baja,029,1100,376,0,376,0,1,375
BÁCS-KISKUN,Baja,030,221,60,0,60,0,0,60
BÁCS-KISKUN,Baja,031,374,116,0,116,0,0,116
BÁCS-KISKUN,Baja,032,486,153,0,153,0,0,153
BÁCS-KISKUN,Ballószög,001,747,357,0,357,0,0,357
BÁCS-KISKUN,Ballószög,002,988,284,0,284,0,4,280
BÁCS-KISKUN,Ballószög,003,1097,440,0,440,0,5,435
BÁCS-KISKUN,Balotaszállás,001,1069,341,0,341,0,1,340
BÁCS-KISKUN,Balotaszállás,002,142,41,0,41,0,0,41
BÁCS-KISKUN,Bácsalmás,001,932,315,0,315,0,1,314
BÁCS-KISKUN,Bácsalmás,002,925,296,2,296,0,1,295
BÁCS-KISKUN,Bácsalmás,003,819,317,0,317,0,6,311
BÁCS-KISKUN,Bácsalmás,004,936,335,0,335,0,8,327
BÁCS-KISKUN,Bácsalmás,005,882,343,0,342,-1,0,342
BÁCS-KISKUN,Bácsalmás,006,928,416,0,416,0,4,412
BÁCS-KISKUN,Bácsbokod,001,1096,350,0,350,0,5,345
BÁCS-KISKUN,Bácsbokod,002,1080,362,0,362,0,7,355
BÁCS-KISKUN,Bácsborsód,001,935,309,0,309,0,1,308
BÁCS-KISKUN,Bácsszentgyörgy,001,137,72,0,72,0,0,72
BÁCS-KISKUN,Bácsszõlõs,001,273,101,0,101,0,1,100
BÁCS-KISKUN,Bátmonostor,001,652,257,0,257,0,2,255
BÁCS-KISKUN,Bátmonostor,002,639,247,0,247,0,2,245
BÁCS-KISKUN,Bátya,001,842,321,0,321,0,0,321
BÁCS-KISKUN,Bátya,002,850,351,0,351,0,0,351
BÁCS-KISKUN,Borota,001,1062,366,0,366,0,3,363
BÁCS-KISKUN,Bócsa,001,756,281,0,281,0,2,279
BÁCS-KISKUN,Bócsa,002,730,300,0,300,0,3,297
BÁCS-KISKUN,Bugac,001,947,342,0,342,0,1,341
BÁCS-KISKUN,Bugac,002,893,350,0,350,0,2,348
BÁCS-KISKUN,Bugac,003,326,129,0,129,0,0,129
BÁCS-KISKUN,Bugacpusztaháza,001,219,87,0,87,0,0,87
BÁCS-KISKUN,Császártöltés,001,654,248,0,248,0,1,247
BÁCS-KISKUN,Császártöltés,002,623,278,0,278,0,1,277
BÁCS-KISKUN,Császártöltés,003,641,279,0,279,0,4,275
BÁCS-KISKUN,Csátalja,001,582,255,0,255,0,1,254
BÁCS-KISKUN,Csátalja,002,629,224,0,224,0,5,219
BÁCS-KISKUN,Csávoly,001,622,238,0,238,0,0,238
BÁCS-KISKUN,Csávoly,002,836,282,0,282,0,4,278
BÁCS-KISKUN,Csengõd,001,845,365,0,365,0,5,360
BÁCS-KISKUN,Csengõd,002,854,326,0,326,0,4,322
BÁCS-KISKUN,Csikéria,001,658,233,0,233,0,1,232
BÁCS-KISKUN,Csólyospálos,001,682,242,0,242,0,1,241
BÁCS-KISKUN,Csólyospálos,002,587,233,0,233,0,4,229
BÁCS-KISKUN,Dávod,001,781,299,0,299,0,6,293
BÁCS-KISKUN,Dávod,002,750,322,0,322,0,1,321
BÁCS-KISKUN,Dávod,003,169,59,0,59,0,0,59
BÁCS-KISKUN,Drágszél,001,275,119,0,119,0,1,118
BÁCS-KISKUN,Dunaegyháza,001,625,192,0,192,0,0,192
BÁCS-KISKUN,Dunaegyháza,002,583,172,0,172,0,0,172
BÁCS-KISKUN,Dunafalva,001,752,304,0,304,0,5,299
BÁCS-KISKUN,Dunapataj,001,908,317,0,317,0,5,312
BÁCS-KISKUN,Dunapataj,002,845,379,0,379,0,3,376
BÁCS-KISKUN,Dunapataj,003,940,303,0,302,-1,1,301
BÁCS-KISKUN,Dunaszentbenedek,001,672,254,0,254,0,4,250
BÁCS-KISKUN,Dunatetétlen,001,467,140,0,140,0,2,138
BÁCS-KISKUN,Dunavecse,001,780,280,0,280,0,5,275
BÁCS-KISKUN,Dunavecse,002,814,279,0,279,0,1,278
BÁCS-KISKUN,Dunavecse,003,782,240,0,240,0,1,239
BÁCS-KISKUN,Dunavecse,004,767,198,0,198,0,0,198
BÁCS-KISKUN,Dusnok,001,784,326,0,326,0,1,325
BÁCS-KISKUN,Dusnok,002,863,302,0,302,0,0,302
BÁCS-KISKUN,Dusnok,003,823,325,0,325,0,0,325
BÁCS-KISKUN,Érsekcsanád,001,1112,403,0,403,0,0,403
BÁCS-KISKUN,Érsekcsanád,002,1210,404,0,404,0,2,402
BÁCS-KISKUN,Érsekhalma,001,508,180,0,180,0,0,180
BÁCS-KISKUN,Fajsz,001,768,273,0,273,0,2,271
BÁCS-KISKUN,Fajsz,002,613,232,0,232,0,0,232
BÁCS-KISKUN,Felsõlajos,001,785,304,0,304,0,0,304
BÁCS-KISKUN,Felsõszentiván,001,958,346,0,346,0,1,345
BÁCS-KISKUN,Felsõszentiván,002,593,236,0,236,0,1,235
BÁCS-KISKUN,Foktõ,001,701,267,0,267,0,3,264
BÁCS-KISKUN,Foktõ,002,608,218,0,218,0,0,218
BÁCS-KISKUN,Fülöpháza,001,724,316,0,316,0,2,314
BÁCS-KISKUN,Fülöpjakab,001,929,393,0,393,0,1,392
BÁCS-KISKUN,Fülöpszállás,001,914,284,1,283,-1,6,277
BÁCS-KISKUN,Fülöpszállás,002,910,350,0,350,0,2,348
BÁCS-KISKUN,Gara,001,740,257,0,257,0,1,256
BÁCS-KISKUN,Gara,002,921,290,0,290,0,2,288
BÁCS-KISKUN,Gátér,001,782,341,0,341,0,5,336
BÁCS-KISKUN,Géderlak,001,799,309,0,309,0,2,307
BÁCS-KISKUN,Hajós,001,854,357,0,357,0,3,354
BÁCS-KISKUN,Hajós,002,851,337,0,337,0,2,335
BÁCS-KISKUN,Hajós,003,737,299,0,299,0,0,299
BÁCS-KISKUN,Harkakötöny,001,704,317,0,317,0,3,314
BÁCS-KISKUN,Harta,001,887,462,0,462,0,3,459
BÁCS-KISKUN,Harta,002,930,406,0,406,0,1,405
BÁCS-KISKUN,Harta,003,941,425,0,425,0,0,425
BÁCS-KISKUN,Harta,004,57,28,0,28,0,1,27
BÁCS-KISKUN,Harta,005,77,16,0,16,0,0,16
BÁCS-KISKUN,Helvécia,001,1382,511,0,511,0,3,508
BÁCS-KISKUN,Helvécia,002,1241,469,0,469,0,0,469
BÁCS-KISKUN,Helvécia,003,1087,350,0,350,0,3,347
BÁCS-KISKUN,Hercegszántó,001,867,326,0,326,0,1,325
BÁCS-KISKUN,Hercegszántó,002,770,242,0,242,0,3,239
BÁCS-KISKUN,Homokmégy,001,658,279,0,279,0,3,276
BÁCS-KISKUN,Homokmégy,002,188,95,0,95,0,0,95
BÁCS-KISKUN,Homokmégy,003,123,39,0,39,0,0,39
BÁCS-KISKUN,Homokmégy,004,136,65,0,65,0,1,64
BÁCS-KISKUN,Imrehegy,001,539,194,0,194,0,0,194
BÁCS-KISKUN,Izsák,001,803,313,0,313,0,4,309
BÁCS-KISKUN,Izsák,002,1006,402,0,402,0,4,398
BÁCS-KISKUN,Izsák,003,838,330,0,330,0,1,329
BÁCS-KISKUN,Izsák,004,880,252,0,252,0,5,247
BÁCS-KISKUN,Izsák,005,971,370,0,370,0,0,370
BÁCS-KISKUN,Izsák,006,254,87,0,87,0,0,87
BÁCS-KISKUN,Jakabszállás,001,1136,447,0,447,0,7,440
BÁCS-KISKUN,Jakabszállás,002,1033,406,0,406,0,4,402
BÁCS-KISKUN,Jánoshalma,001,834,255,0,253,-2,2,251
BÁCS-KISKUN,Jánoshalma,002,914,409,0,409,0,3,406
BÁCS-KISKUN,Jánoshalma,003,945,384,1,383,-1,3,380
BÁCS-KISKUN,Jánoshalma,004,848,262,4,269,7,53,216
BÁCS-KISKUN,Jánoshalma,005,854,307,0,307,0,2,305
BÁCS-KISKUN,Jánoshalma,006,804,351,0,351,0,4,347
BÁCS-KISKUN,Jánoshalma,007,813,309,0,309,0,2,307
BÁCS-KISKUN,Jánoshalma,008,931,343,0,343,0,4,339
BÁCS-KISKUN,Jászszentlászló,001,1096,420,0,420,0,2,418
BÁCS-KISKUN,Jászszentlászló,002,950,388,0,388,0,1,387
BÁCS-KISKUN,Kalocsa,001,904,436,0,436,0,1,435
BÁCS-KISKUN,Kalocsa,002,938,449,0,449,0,0,449
BÁCS-KISKUN,Kalocsa,003,883,451,0,451,0,0,451
BÁCS-KISKUN,Kalocsa,004,765,308,0,308,0,5,303
BÁCS-KISKUN,Kalocsa,005,752,353,0,353,0,7,346
BÁCS-KISKUN,Kalocsa,006,961,375,0,375,0,1,374
BÁCS-KISKUN,Kalocsa,007,731,304,0,304,0,4,300
BÁCS-KISKUN,Kalocsa,008,852,318,0,318,0,3,315
BÁCS-KISKUN,Kalocsa,009,170,70,0,70,0,1,69
BÁCS-KISKUN,Kalocsa,010,775,262,0,262,0,2,260
BÁCS-KISKUN,Kalocsa,011,793,303,0,303,0,0,303
BÁCS-KISKUN,Kalocsa,012,648,347,0,347,0,7,340
BÁCS-KISKUN,Kalocsa,013,929,479,0,479,0,1,478
BÁCS-KISKUN,Kalocsa,014,725,336,0,336,0,0,336
BÁCS-KISKUN,Kalocsa,015,796,433,0,433,0,3,430
BÁCS-KISKUN,Kalocsa,016,825,416,0,416,0,1,415
BÁCS-KISKUN,Kalocsa,017,772,310,0,310,0,0,310
BÁCS-KISKUN,Kaskantyú,001,815,319,0,319,0,5,314
BÁCS-KISKUN,Katymár,001,732,214,0,214,0,4,210
BÁCS-KISKUN,Katymár,002,754,212,0,212,0,1,211
BÁCS-KISKUN,Kecel,001,1031,339,0,339,0,0,339
BÁCS-KISKUN,Kecel,002,996,351,0,351,0,1,350
BÁCS-KISKUN,Kecel,003,803,392,0,392,0,2,390
BÁCS-KISKUN,Kecel,004,774,373,0,373,0,1,372
BÁCS-KISKUN,Kecel,005,915,379,0,379,0,3,376
BÁCS-KISKUN,Kecel,006,950,336,0,336,0,1,335
BÁCS-KISKUN,Kecel,007,601,155,0,155,0,14,141
BÁCS-KISKUN,Kecel,008,790,323,0,323,0,2,321
BÁCS-KISKUN,Kecskemét,001,812,434,0,434,0,0,434
BÁCS-KISKUN,Kecskemét,002,1123,605,0,605,0,2,603
BÁCS-KISKUN,Kecskemét,003,829,420,0,420,0,3,417
BÁCS-KISKUN,Kecskemét,004,912,513,0,512,-1,0,512
BÁCS-KISKUN,Kecskemét,005,583,306,0,306,0,0,306
BÁCS-KISKUN,Kecskemét,006,993,345,0,345,0,5,340
BÁCS-KISKUN,Kecskemét,007,1033,402,0,402,0,0,402
BÁCS-KISKUN,Kecskemét,008,1231,430,0,430,0,4,426
BÁCS-KISKUN,Kecskemét,009,960,439,0,439,0,6,433
BÁCS-KISKUN,Kecskemét,010,871,441,0,441,0,0,441
BÁCS-KISKUN,Kecskemét,011,1096,499,0,499,0,0,499
BÁCS-KISKUN,Kecskemét,012,819,360,0,360,0,1,359
BÁCS-KISKUN,Kecskemét,013,771,388,0,388,0,4,384
BÁCS-KISKUN,Kecskemét,014,860,401,0,401,0,4,397
BÁCS-KISKUN,Kecskemét,015,872,453,0,453,0,2,451
BÁCS-KISKUN,Kecskemét,016,883,506,0,506,0,3,503
BÁCS-KISKUN,Kecskemét,017,774,412,0,412,0,2,410
BÁCS-KISKUN,Kecskemét,018,712,277,0,277,0,1,276
BÁCS-KISKUN,Kecskemét,019,1169,538,0,538,0,5,533
BÁCS-KISKUN,Kecskemét,020,832,339,0,339,0,2,337
BÁCS-KISKUN,Kecskemét,021,868,380,0,380,0,6,374
BÁCS-KISKUN,Kecskemét,022,951,356,0,356,0,2,354
BÁCS-KISKUN,Kecskemét,023,894,361,2,358,-3,2,356
BÁCS-KISKUN,Kecskemét,024,1040,337,0,337,0,0,337
BÁCS-KISKUN,Kecskemét,025,580,184,0,184,0,0,184
BÁCS-KISKUN,Kecskemét,026,1009,355,0,355,0,1,354
BÁCS-KISKUN,Kecskemét,027,818,464,0,464,0,6,458
BÁCS-KISKUN,Kecskemét,028,1048,403,0,403,0,1,402
BÁCS-KISKUN,Kecskemét,029,1104,434,0,434,0,2,432
BÁCS-KISKUN,Kecskemét,030,832,362,4,358,-4,0,358
BÁCS-KISKUN,Kecskemét,031,723,346,0,346,0,1,345
BÁCS-KISKUN,Kecskemét,032,919,372,0,372,0,1,371
BÁCS-KISKUN,Kecskemét,033,633,277,0,277,0,2,275
BÁCS-KISKUN,Kecskemét,034,1113,452,0,452,0,0,452
BÁCS-KISKUN,Kecskemét,035,853,373,0,372,-1,2,370
BÁCS-KISKUN,Kecskemét,036,981,406,0,406,0,1,405
BÁCS-KISKUN,Kecskemét,037,1058,397,2,397,0,2,395
BÁCS-KISKUN,Kecskemét,038,828,333,0,333,0,1,332
BÁCS-KISKUN,Kecskemét,039,657,355,0,355,0,1,354
BÁCS-KISKUN,Kecskemét,040,939,578,0,578,0,1,577
BÁCS-KISKUN,Kecskemét,041,1022,521,0,521,0,2,519
BÁCS-KISKUN,Kecskemét,042,809,455,0,456,1,16,440
BÁCS-KISKUN,Kecskemét,043,1087,467,0,467,0,4,463
BÁCS-KISKUN,Kecskemét,044,1018,442,0,441,-1,3,438
BÁCS-KISKUN,Kecskemét,045,621,358,0,358,0,3,355
BÁCS-KISKUN,Kecskemét,046,1033,491,0,491,0,2,489
BÁCS-KISKUN,Kecskemét,047,1447,949,0,949,0,3,946
BÁCS-KISKUN,Kecskemét,048,1092,566,0,566,0,2,564
BÁCS-KISKUN,Kecskemét,049,1040,480,0,480,0,4,476
BÁCS-KISKUN,Kecskemét,050,512,289,0,288,-1,0,288
BÁCS-KISKUN,Kecskemét,051,758,322,0,322,0,4,318
BÁCS-KISKUN,Kecskemét,052,1018,461,0,461,0,1,460
BÁCS-KISKUN,Kecskemét,053,1067,502,0,502,0,2,500
BÁCS-KISKUN,Kecskemét,054,871,386,0,386,0,0,386
BÁCS-KISKUN,Kecskemét,055,800,139,0,139,0,0,139
BÁCS-KISKUN,Kecskemét,056,708,146,0,146,0,3,143
BÁCS-KISKUN,Kecskemét,057,871,390,2,387,-3,0,387
BÁCS-KISKUN,Kecskemét,058,1151,593,0,593,0,1,592
BÁCS-KISKUN,Kecskemét,059,1058,497,0,497,0,4,493
BÁCS-KISKUN,Kecskemét,060,598,292,0,292,0,1,291
BÁCS-KISKUN,Kecskemét,061,565,246,0,246,0,0,246
BÁCS-KISKUN,Kecskemét,062,878,413,0,413,0,1,412
BÁCS-KISKUN,Kecskemét,063,757,316,0,316,0,0,316
BÁCS-KISKUN,Kecskemét,064,1063,519,0,519,0,3,516
BÁCS-KISKUN,Kecskemét,065,918,420,0,420,0,1,419
BÁCS-KISKUN,Kecskemét,066,925,382,0,381,-1,3,378
BÁCS-KISKUN,Kecskemét,067,1006,466,0,466,0,2,464
BÁCS-KISKUN,Kecskemét,068,599,192,0,192,0,0,192
BÁCS-KISKUN,Kecskemét,069,978,415,0,415,0,1,414
BÁCS-KISKUN,Kecskemét,070,1046,430,0,430,0,0,430
BÁCS-KISKUN,Kecskemét,071,700,164,0,164,0,0,164
BÁCS-KISKUN,Kecskemét,072,801,264,0,264,0,1,263
BÁCS-KISKUN,Kecskemét,073,1186,347,0,347,0,1,346
BÁCS-KISKUN,Kecskemét,074,1054,520,0,520,0,0,520
BÁCS-KISKUN,Kecskemét,075,1154,487,0,487,0,3,484
BÁCS-KISKUN,Kecskemét,076,845,273,0,273,0,3,270
BÁCS-KISKUN,Kecskemét,077,699,248,0,248,0,0,248
BÁCS-KISKUN,Kecskemét,078,588,204,0,204,0,2,202
BÁCS-KISKUN,Kecskemét,079,937,440,0,439,-1,3,436
BÁCS-KISKUN,Kecskemét,080,723,305,0,305,0,2,303
BÁCS-KISKUN,Kecskemét,081,878,410,0,410,0,3,407
BÁCS-KISKUN,Kecskemét,082,1099,478,0,478,0,0,478
BÁCS-KISKUN,Kecskemét,083,750,221,0,221,0,0,221
BÁCS-KISKUN,Kecskemét,084,630,281,0,281,0,1,280
BÁCS-KISKUN,Kecskemét,085,1172,369,0,369,0,0,369
BÁCS-KISKUN,Kecskemét,086,1355,426,0,426,0,0,426
BÁCS-KISKUN,Kecskemét,087,1194,492,0,492,0,2,490
BÁCS-KISKUN,Kecskemét,088,1235,532,0,531,-1,0,531
BÁCS-KISKUN,Kecskemét,089,1185,357,0,357,0,2,355
BÁCS-KISKUN,Kecskemét,090,1025,367,0,367,0,0,367
BÁCS-KISKUN,Kecskemét,091,572,161,0,161,0,2,159
BÁCS-KISKUN,Kecskemét,092,1012,463,0,463,0,2,461
BÁCS-KISKUN,Kecskemét,093,771,305,0,304,-1,1,303
BÁCS-KISKUN,Kecskemét,094,884,404,0,404,0,0,404
BÁCS-KISKUN,Kecskemét,095,663,173,0,173,0,0,173
BÁCS-KISKUN,Kecskemét,096,584,153,0,153,0,0,153
BÁCS-KISKUN,Kelebia,001,623,247,0,247,0,0,247
BÁCS-KISKUN,Kelebia,002,666,232,0,232,0,0,232
BÁCS-KISKUN,Kelebia,003,704,228,0,228,0,1,227
BÁCS-KISKUN,Kelebia,004,102,31,0,31,0,0,31
BÁCS-KISKUN,Kerekegyháza,001,1022,361,0,361,0,2,359
BÁCS-KISKUN,Kerekegyháza,002,1017,377,0,377,0,0,377
BÁCS-KISKUN,Kerekegyháza,003,985,409,0,409,0,1,408
BÁCS-KISKUN,Kerekegyháza,004,958,381,0,381,0,0,381
BÁCS-KISKUN,Kerekegyháza,005,1145,407,0,407,0,3,404
BÁCS-KISKUN,Kéleshalom,001,357,126,0,126,0,1,125
BÁCS-KISKUN,Kiskõrös,001,751,363,0,361,-2,6,355
BÁCS-KISKUN,Kiskõrös,002,630,308,0,308,0,0,308
BÁCS-KISKUN,Kiskõrös,003,702,347,0,347,0,2,345
BÁCS-KISKUN,Kiskõrös,004,682,305,0,304,-1,0,304
BÁCS-KISKUN,Kiskõrös,005,675,330,0,330,0,2,328
BÁCS-KISKUN,Kiskõrös,006,720,335,0,335,0,4,331
BÁCS-KISKUN,Kiskõrös,007,708,364,0,364,0,2,362
BÁCS-KISKUN,Kiskõrös,008,823,335,0,335,0,2,333
BÁCS-KISKUN,Kiskõrös,009,693,320,0,320,0,1,319
BÁCS-KISKUN,Kiskõrös,010,711,333,0,333,0,2,331
BÁCS-KISKUN,Kiskõrös,011,751,378,0,378,0,0,378
BÁCS-KISKUN,Kiskõrös,012,707,276,0,276,0,0,276
BÁCS-KISKUN,Kiskõrös,013,759,262,0,262,0,2,260
BÁCS-KISKUN,Kiskõrös,014,755,378,0,378,0,0,378
BÁCS-KISKUN,Kiskõrös,015,665,336,0,336,0,0,336
BÁCS-KISKUN,Kiskõrös,016,755,359,0,359,0,4,355
BÁCS-KISKUN,Kiskunfélegyháza,001,936,434,0,434,0,2,432
BÁCS-KISKUN,Kiskunfélegyháza,002,605,312,0,312,0,2,310
BÁCS-KISKUN,Kiskunfélegyháza,003,862,397,0,397,0,2,395
BÁCS-KISKUN,Kiskunfélegyháza,004,754,301,0,301,0,0,301
BÁCS-KISKUN,Kiskunfélegyháza,005,810,353,0,353,0,1,352
BÁCS-KISKUN,Kiskunfélegyháza,006,803,362,0,362,0,4,358
BÁCS-KISKUN,Kiskunfélegyháza,007,897,450,0,450,0,0,450
BÁCS-KISKUN,Kiskunfélegyháza,008,702,333,0,333,0,2,331
BÁCS-KISKUN,Kiskunfélegyháza,009,709,311,1,309,-2,0,309
BÁCS-KISKUN,Kiskunfélegyháza,010,834,424,0,424,0,1,423
BÁCS-KISKUN,Kiskunfélegyháza,011,875,397,0,397,0,4,393
BÁCS-KISKUN,Kiskunfélegyháza,012,934,412,0,411,-1,4,407
BÁCS-KISKUN,Kiskunfélegyháza,013,684,283,0,282,-1,1,281
BÁCS-KISKUN,Kiskunfélegyháza,014,996,405,0,405,0,1,404
BÁCS-KISKUN,Kiskunfélegyháza,015,863,329,2,329,0,1,328
BÁCS-KISKUN,Kiskunfélegyháza,016,1043,390,0,390,0,3,387
BÁCS-KISKUN,Kiskunfélegyháza,017,954,396,0,396,0,2,394
BÁCS-KISKUN,Kiskunfélegyháza,018,210,62,0,62,0,0,62
BÁCS-KISKUN,Kiskunfélegyháza,019,303,98,0,98,0,0,98
BÁCS-KISKUN,Kiskunfélegyháza,020,869,264,0,264,0,0,264
BÁCS-KISKUN,Kiskunfélegyháza,021,1056,360,0,360,0,2,358
BÁCS-KISKUN,Kiskunfélegyháza,022,413,158,0,158,0,0,158
BÁCS-KISKUN,Kiskunfélegyháza,023,611,217,0,217,0,2,215
BÁCS-KISKUN,Kiskunfélegyháza,024,762,285,0,285,0,3,282
BÁCS-KISKUN,Kiskunfélegyháza,025,941,356,0,356,0,3,353
BÁCS-KISKUN,Kiskunfélegyháza,026,842,391,0,387,-4,2,385
BÁCS-KISKUN,Kiskunfélegyháza,027,802,368,0,368,0,2,366
BÁCS-KISKUN,Kiskunfélegyháza,028,852,413,0,413,0,4,409
BÁCS-KISKUN,Kiskunfélegyháza,029,607,178,0,178,0,1,177
BÁCS-KISKUN,Kiskunfélegyháza,030,729,278,0,278,0,2,276
BÁCS-KISKUN,Kiskunfélegyháza,031,1092,360,0,360,0,0,360
BÁCS-KISKUN,Kiskunhalas,001,771,418,0,418,0,0,418
BÁCS-KISKUN,Kiskunhalas,002,567,254,0,254,0,4,250
BÁCS-KISKUN,Kiskunhalas,003,823,307,0,307,0,5,302
BÁCS-KISKUN,Kiskunhalas,004,1069,219,0,219,0,2,217
BÁCS-KISKUN,Kiskunhalas,005,864,437,0,437,0,1,436
BÁCS-KISKUN,Kiskunhalas,006,752,338,0,338,0,1,337
BÁCS-KISKUN,Kiskunhalas,007,647,307,0,307,0,1,306
BÁCS-KISKUN,Kiskunhalas,008,746,348,0,348,0,0,348
BÁCS-KISKUN,Kiskunhalas,009,830,380,0,380,0,4,376
BÁCS-KISKUN,Kiskunhalas,010,1142,261,0,261,0,4,257
BÁCS-KISKUN,Kiskunhalas,011,802,276,0,276,0,0,276
BÁCS-KISKUN,Kiskunhalas,012,732,280,0,280,0,2,278
BÁCS-KISKUN,Kiskunhalas,013,865,372,0,372,0,1,371
BÁCS-KISKUN,Kiskunhalas,014,677,197,0,197,0,0,197
BÁCS-KISKUN,Kiskunhalas,015,746,337,0,337,0,1,336
BÁCS-KISKUN,Kiskunhalas,016,680,317,0,317,0,1,316
BÁCS-KISKUN,Kiskunhalas,017,641,294,0,293,-1,1,292
BÁCS-KISKUN,Kiskunhalas,018,881,351,0,351,0,0,351
BÁCS-KISKUN,Kiskunhalas,019,658,238,0,238,0,0,238
BÁCS-KISKUN,Kiskunhalas,020,715,272,0,272,0,2,270
BÁCS-KISKUN,Kiskunhalas,021,706,274,0,274,0,0,274
BÁCS-KISKUN,Kiskunhalas,022,687,354,0,354,0,1,353
BÁCS-KISKUN,Kiskunhalas,023,623,255,0,255,0,0,255
BÁCS-KISKUN,Kiskunhalas,024,696,248,0,248,0,0,248
BÁCS-KISKUN,Kiskunhalas,025,692,298,0,298,0,5,293
BÁCS-KISKUN,Kiskunhalas,026,645,308,0,307,-1,2,305
BÁCS-KISKUN,Kiskunhalas,027,718,285,0,285,0,1,284
BÁCS-KISKUN,Kiskunhalas,028,625,245,0,245,0,0,245
BÁCS-KISKUN,Kiskunhalas,029,850,308,0,308,0,5,303
BÁCS-KISKUN,Kiskunhalas,030,768,238,0,238,0,1,237
BÁCS-KISKUN,Kiskunmajsa,001,862,320,0,320,0,0,320
BÁCS-KISKUN,Kiskunmajsa,002,823,337,0,337,0,3,334
BÁCS-KISKUN,Kiskunmajsa,003,1023,425,0,425,0,2,423
BÁCS-KISKUN,Kiskunmajsa,004,1049,454,0,454,0,2,452
BÁCS-KISKUN,Kiskunmajsa,005,1157,468,0,468,0,0,468
BÁCS-KISKUN,Kiskunmajsa,006,1154,364,0,364,0,2,362
BÁCS-KISKUN,Kiskunmajsa,007,1152,336,0,336,0,1,335
BÁCS-KISKUN,Kiskunmajsa,008,1152,353,0,353,0,1,352
BÁCS-KISKUN,Kiskunmajsa,009,230,81,0,81,0,0,81
BÁCS-KISKUN,Kiskunmajsa,010,418,210,0,210,0,0,210
BÁCS-KISKUN,Kisszállás,001,244,73,0,73,0,0,73
BÁCS-KISKUN,Kisszállás,002,917,327,0,327,0,3,324
BÁCS-KISKUN,Kisszállás,003,852,259,0,259,0,3,256
BÁCS-KISKUN,Kömpöc,001,557,246,0,246,0,3,243
BÁCS-KISKUN,Kunadacs,001,1224,380,0,380,0,3,377
BÁCS-KISKUN,Kunbaja,001,595,184,0,184,0,1,183
BÁCS-KISKUN,Kunbaja,002,653,240,0,240,0,0,240
BÁCS-KISKUN,Kunbaracs,001,512,163,0,163,0,1,162
BÁCS-KISKUN,Kunfehértó,001,952,395,0,395,0,0,395
BÁCS-KISKUN,Kunfehértó,002,770,327,0,327,0,2,325
BÁCS-KISKUN,Kunfehértó,003,118,45,0,45,0,1,44
BÁCS-KISKUN,Kunpeszér,001,579,243,0,243,0,1,242
BÁCS-KISKUN,Kunszállás,001,1371,545,0,545,0,6,539
BÁCS-KISKUN,Kunszentmiklós,001,796,339,0,339,0,5,334
BÁCS-KISKUN,Kunszentmiklós,002,1008,368,0,368,0,2,366
BÁCS-KISKUN,Kunszentmiklós,003,756,204,0,204,0,0,204
BÁCS-KISKUN,Kunszentmiklós,004,827,327,0,327,0,3,324
BÁCS-KISKUN,Kunszentmiklós,005,904,432,0,427,-5,1,426
BÁCS-KISKUN,Kunszentmiklós,006,1002,382,0,382,0,2,380
BÁCS-KISKUN,Kunszentmiklós,007,1116,402,0,402,0,3,399
BÁCS-KISKUN,Kunszentmiklós,008,308,102,0,102,0,1,101
BÁCS-KISKUN,Ladánybene,001,1378,516,0,516,0,15,501
BÁCS-KISKUN,Lajosmizse,001,1081,466,0,466,0,3,463
BÁCS-KISKUN,Lajosmizse,002,1015,481,0,480,-1,1,479
BÁCS-KISKUN,Lajosmizse,003,1153,525,0,525,0,0,525
BÁCS-KISKUN,Lajosmizse,004,1151,304,0,304,0,1,303
BÁCS-KISKUN,Lajosmizse,005,1213,321,0,321,0,2,319
BÁCS-KISKUN,Lajosmizse,006,1169,392,0,392,0,0,392
BÁCS-KISKUN,Lajosmizse,007,1258,354,0,354,0,1,353
BÁCS-KISKUN,Lajosmizse,008,580,170,0,170,0,5,165
BÁCS-KISKUN,Lajosmizse,009,597,206,0,206,0,0,206
BÁCS-KISKUN,Lakitelek,001,800,324,0,324,0,0,324
BÁCS-KISKUN,Lakitelek,002,622,262,0,262,0,1,261
BÁCS-KISKUN,Lakitelek,003,945,372,0,372,0,0,372
BÁCS-KISKUN,Lakitelek,004,1106,437,0,437,0,9,428
BÁCS-KISKUN,Lakitelek,005,368,117,0,117,0,0,117
BÁCS-KISKUN,Madaras,001,789,271,0,271,0,2,269
BÁCS-KISKUN,Madaras,002,780,278,0,278,0,2,276
BÁCS-KISKUN,Madaras,003,742,173,0,173,0,1,172
BÁCS-KISKUN,Mátételke,001,411,139,0,139,0,1,138
BÁCS-KISKUN,Mélykút,001,784,303,0,303,0,0,303
BÁCS-KISKUN,Mélykút,002,827,344,0,344,0,1,343
BÁCS-KISKUN,Mélykút,003,786,317,0,317,0,1,316
BÁCS-KISKUN,Mélykút,004,818,273,0,273,0,0,273
BÁCS-KISKUN,Mélykút,005,832,228,0,228,0,5,223
BÁCS-KISKUN,Mélykút,006,96,49,0,49,0,2,47
BÁCS-KISKUN,Miske,001,687,300,0,300,0,2,298
BÁCS-KISKUN,Miske,002,699,349,0,349,0,1,348
BÁCS-KISKUN,Móricgát,001,370,192,0,192,0,2,190
BÁCS-KISKUN,Nagybaracska,001,996,316,0,316,0,4,312
BÁCS-KISKUN,Nagybaracska,002,902,288,0,288,0,3,285
BÁCS-KISKUN,Nemesnádudvar,001,871,267,0,267,0,5,262
BÁCS-KISKUN,Nemesnádudvar,002,627,260,0,260,0,0,260
BÁCS-KISKUN,Nyárlõrinc,001,956,355,2,353,-2,2,351
BÁCS-KISKUN,Nyárlõrinc,002,921,328,0,328,0,2,326
BÁCS-KISKUN,Ordas,001,378,179,0,179,0,2,177
BÁCS-KISKUN,Orgovány,001,944,284,0,284,0,2,282
BÁCS-KISKUN,Orgovány,002,890,297,0,297,0,0,297
BÁCS-KISKUN,Orgovány,003,838,281,0,281,0,4,277
BÁCS-KISKUN,Öregcsertõ,001,644,223,0,223,0,3,220
BÁCS-KISKUN,Páhi,001,949,347,0,347,0,2,345
BÁCS-KISKUN,Pálmonostora,001,738,292,0,292,0,3,289
BÁCS-KISKUN,Pálmonostora,002,693,251,0,251,0,6,245
BÁCS-KISKUN,Petõfiszállás,001,627,281,0,281,0,0,281
BÁCS-KISKUN,Petõfiszállás,002,614,201,0,202,1,10,192
BÁCS-KISKUN,Pirtó,001,785,274,0,274,0,5,269
BÁCS-KISKUN,Rém,001,1023,326,0,326,0,3,323
BÁCS-KISKUN,Solt,001,759,330,0,329,-1,0,329
BÁCS-KISKUN,Solt,002,961,355,0,355,0,1,354
BÁCS-KISKUN,Solt,003,697,308,0,308,0,0,308
BÁCS-KISKUN,Solt,004,857,340,0,340,0,4,336
BÁCS-KISKUN,Solt,005,963,339,0,339,0,0,339
BÁCS-KISKUN,Solt,006,1014,342,0,340,-2,3,337
BÁCS-KISKUN,Soltszentimre,001,1054,375,0,375,0,4,371
BÁCS-KISKUN,Soltvadkert,001,1139,527,0,527,0,2,525
BÁCS-KISKUN,Soltvadkert,002,1159,470,0,470,0,1,469
BÁCS-KISKUN,Soltvadkert,003,965,429,0,429,0,2,427
BÁCS-KISKUN,Soltvadkert,004,939,299,0,299,0,1,298
BÁCS-KISKUN,Soltvadkert,005,829,326,0,326,0,0,326
BÁCS-KISKUN,Soltvadkert,006,836,322,0,322,0,1,321
BÁCS-KISKUN,Sükösd,001,1019,400,0,400,0,6,394
BÁCS-KISKUN,Sükösd,002,930,388,0,388,0,2,386
BÁCS-KISKUN,Sükösd,003,1013,366,0,366,0,3,363
BÁCS-KISKUN,Szabadszállás,001,653,180,0,180,0,0,180
BÁCS-KISKUN,Szabadszállás,002,711,233,1,232,-1,4,228
BÁCS-KISKUN,Szabadszállás,003,694,265,0,265,0,1,264
BÁCS-KISKUN,Szabadszállás,004,660,216,0,216,0,2,214
BÁCS-KISKUN,Szabadszállás,005,655,200,0,200,0,3,197
BÁCS-KISKUN,Szabadszállás,006,689,233,0,232,-1,0,232
BÁCS-KISKUN,Szabadszállás,007,710,221,0,221,0,1,220
BÁCS-KISKUN,Szabadszállás,008,288,83,0,83,0,0,83
BÁCS-KISKUN,Szakmár,001,995,417,0,417,0,7,410
BÁCS-KISKUN,Szalkszentmárton,001,756,243,0,243,0,0,243
BÁCS-KISKUN,Szalkszentmárton,002,846,270,0,270,0,1,269
BÁCS-KISKUN,Szalkszentmárton,003,716,250,0,250,0,3,247
BÁCS-KISKUN,Szank,001,989,388,0,388,0,1,387
BÁCS-KISKUN,Szank,002,951,433,0,433,0,3,430
BÁCS-KISKUN,Szentkirály,001,618,215,0,215,0,0,215
BÁCS-KISKUN,Szentkirály,002,885,435,0,435,0,1,434
BÁCS-KISKUN,Szeremle,001,1150,431,0,431,0,0,431
BÁCS-KISKUN,Tabdi,001,906,348,0,348,0,1,347
BÁCS-KISKUN,Tass,001,1155,452,0,452,0,3,449
BÁCS-KISKUN,Tass,002,1196,339,0,338,-1,2,336
BÁCS-KISKUN,Tataháza,001,968,343,0,343,0,2,341
BÁCS-KISKUN,Tázlár,001,694,315,0,315,0,2,313
BÁCS-KISKUN,Tázlár,002,691,251,0,252,1,10,242
BÁCS-KISKUN,Tiszaalpár,001,757,250,0,250,0,0,250
BÁCS-KISKUN,Tiszaalpár,002,689,212,0,212,0,2,210
BÁCS-KISKUN,Tiszaalpár,003,612,222,0,222,0,3,219
BÁCS-KISKUN,Tiszaalpár,004,640,202,0,202,0,2,200
BÁCS-KISKUN,Tiszaalpár,005,621,255,0,255,0,2,253
BÁCS-KISKUN,Tiszaalpár,006,659,242,0,242,0,1,241
BÁCS-KISKUN,Tiszakécske,001,1217,472,0,472,0,1,471
BÁCS-KISKUN,Tiszakécske,002,1372,696,0,695,-1,8,687
BÁCS-KISKUN,Tiszakécske,003,1232,579,0,577,-2,1,576
BÁCS-KISKUN,Tiszakécske,004,1253,499,0,499,0,0,499
BÁCS-KISKUN,Tiszakécske,005,1216,453,0,453,0,0,453
BÁCS-KISKUN,Tiszakécske,006,1193,422,0,422,0,0,422
BÁCS-KISKUN,Tiszakécske,007,673,177,0,177,0,1,176
BÁCS-KISKUN,Tiszakécske,008,384,148,0,148,0,0,148
BÁCS-KISKUN,Tiszakécske,009,433,160,0,160,0,0,160
BÁCS-KISKUN,Tiszakécske,010,320,79,0,79,0,1,78
BÁCS-KISKUN,Tiszaug,001,666,260,0,260,0,6,254
BÁCS-KISKUN,Tompa,001,596,185,0,185,0,3,182
BÁCS-KISKUN,Tompa,002,805,288,0,288,0,1,287
BÁCS-KISKUN,Tompa,003,726,246,0,246,0,0,246
BÁCS-KISKUN,Tompa,004,801,236,0,236,0,2,234
BÁCS-KISKUN,Tompa,005,790,217,0,217,0,2,215
BÁCS-KISKUN,Uszód,001,778,310,0,310,0,4,306
BÁCS-KISKUN,Újsolt,001,165,77,0,77,0,0,77
BÁCS-KISKUN,Újtelek,001,316,171,0,171,0,3,168
BÁCS-KISKUN,Vaskút,001,938,369,0,369,0,0,369
BÁCS-KISKUN,Vaskút,002,992,397,0,397,0,1,396
BÁCS-KISKUN,Vaskút,003,897,362,0,362,0,0,362
BÁCS-KISKUN,Városföld,001,985,406,0,406,0,0,406
BÁCS-KISKUN,Városföld,002,839,318,0,318,0,2,316
BÁCS-KISKUN,Zsana,001,627,232,0,232,0,0,232
BÉKÉS,Almáskamarás,001,689,222,0,222,0,3,219
BÉKÉS,Battonya,001,690,205,0,205,0,4,201
BÉKÉS,Battonya,002,689,250,0,250,0,0,250
BÉKÉS,Battonya,003,585,157,0,157,0,1,156
BÉKÉS,Battonya,004,833,246,0,246,0,0,246
BÉKÉS,Battonya,005,927,318,0,318,0,1,317
BÉKÉS,Battonya,006,813,225,0,225,0,1,224
BÉKÉS,Békés,001,1093,378,0,378,0,8,370
BÉKÉS,Békés,002,1025,350,0,350,0,2,348
BÉKÉS,Békés,003,1074,465,0,464,-1,4,460
BÉKÉS,Békés,004,1073,450,0,450,0,1,449
BÉKÉS,Békés,005,1065,475,0,475,0,5,470
BÉKÉS,Békés,006,1147,514,0,514,0,0,514
BÉKÉS,Békés,007,933,406,0,406,0,3,403
BÉKÉS,Békés,008,912,374,0,374,0,3,371
BÉKÉS,Békés,009,946,416,0,416,0,0,416
BÉKÉS,Békés,010,976,268,0,268,0,1,267
BÉKÉS,Békés,011,845,289,0,289,0,3,286
BÉKÉS,Békés,012,957,251,0,251,0,0,251
BÉKÉS,Békés,013,905,341,0,341,0,2,339
BÉKÉS,Békés,014,915,346,0,346,0,0,346
BÉKÉS,Békés,015,882,301,0,301,0,3,298
BÉKÉS,Békés,016,910,190,0,190,0,2,188
BÉKÉS,Békéscsaba,001,655,315,0,315,0,4,311
BÉKÉS,Békéscsaba,002,605,319,0,319,0,1,318
BÉKÉS,Békéscsaba,003,598,330,0,329,-1,0,329
BÉKÉS,Békéscsaba,004,894,459,0,459,0,1,458
BÉKÉS,Békéscsaba,005,854,496,0,496,0,1,495
BÉKÉS,Békéscsaba,006,548,289,0,289,0,3,286
BÉKÉS,Békéscsaba,007,842,380,0,380,0,0,380
BÉKÉS,Békéscsaba,008,643,231,0,231,0,0,231
BÉKÉS,Békéscsaba,009,922,379,0,379,0,3,376
BÉKÉS,Békéscsaba,010,776,318,0,318,0,0,318
BÉKÉS,Békéscsaba,011,937,483,3,480,-3,5,475
BÉKÉS,Békéscsaba,012,612,237,0,237,0,0,237
BÉKÉS,Békéscsaba,013,485,236,0,236,0,1,235
BÉKÉS,Békéscsaba,014,667,329,0,329,0,1,328
BÉKÉS,Békéscsaba,015,773,421,1,420,-1,2,418
BÉKÉS,Békéscsaba,016,772,291,0,291,0,1,290
BÉKÉS,Békéscsaba,017,832,385,0,385,0,2,383
BÉKÉS,Békéscsaba,018,567,285,0,285,0,5,280
BÉKÉS,Békéscsaba,019,930,476,0,476,0,3,473
BÉKÉS,Békéscsaba,020,831,384,0,384,0,0,384
BÉKÉS,Békéscsaba,021,717,337,0,337,0,3,334
BÉKÉS,Békéscsaba,022,709,310,0,310,0,3,307
BÉKÉS,Békéscsaba,023,667,244,0,242,-2,2,240
BÉKÉS,Békéscsaba,024,569,205,0,205,0,0,205
BÉKÉS,Békéscsaba,025,493,192,0,192,0,0,192
BÉKÉS,Békéscsaba,026,567,244,1,244,0,2,242
BÉKÉS,Békéscsaba,027,687,266,0,266,0,1,265
BÉKÉS,Békéscsaba,028,882,417,0,416,-1,0,416
BÉKÉS,Békéscsaba,029,1127,691,0,690,-1,5,685
BÉKÉS,Békéscsaba,030,943,506,0,505,-1,4,501
BÉKÉS,Békéscsaba,031,618,275,0,275,0,0,275
BÉKÉS,Békéscsaba,032,697,261,0,261,0,1,260
BÉKÉS,Békéscsaba,033,662,295,0,295,0,0,295
BÉKÉS,Békéscsaba,034,628,297,0,297,0,2,295
BÉKÉS,Békéscsaba,035,764,265,0,265,0,0,265
BÉKÉS,Békéscsaba,036,694,316,0,316,0,4,312
BÉKÉS,Békéscsaba,037,675,265,1,263,-2,1,262
BÉKÉS,Békéscsaba,038,660,351,0,351,0,0,351
BÉKÉS,Békéscsaba,039,732,299,0,299,0,3,296
BÉKÉS,Békéscsaba,040,601,233,0,233,0,0,233
BÉKÉS,Békéscsaba,041,1012,385,0,385,0,3,382
BÉKÉS,Békéscsaba,042,758,342,0,342,0,0,342
BÉKÉS,Békéscsaba,043,582,276,0,276,0,1,275
BÉKÉS,Békéscsaba,044,788,333,0,333,0,1,332
BÉKÉS,Békéscsaba,045,563,226,0,226,0,1,225
BÉKÉS,Békéscsaba,046,848,344,0,344,0,0,344
BÉKÉS,Békéscsaba,047,940,407,0,407,0,0,407
BÉKÉS,Békéscsaba,048,952,406,0,406,0,0,406
BÉKÉS,Békéscsaba,049,800,344,0,344,0,2,342
BÉKÉS,Békéscsaba,050,864,403,0,403,0,1,402
BÉKÉS,Békéscsaba,051,964,411,0,411,0,1,410
BÉKÉS,Békéscsaba,052,835,299,1,298,-1,3,295
BÉKÉS,Békéscsaba,053,535,300,0,300,0,2,298
BÉKÉS,Békéscsaba,054,166,57,0,57,0,0,57
BÉKÉS,Békéscsaba,055,232,72,0,72,0,0,72
BÉKÉS,Békéscsaba,056,752,359,0,360,1,10,350
BÉKÉS,Békéscsaba,057,834,360,0,360,0,1,359
BÉKÉS,Békéscsaba,058,608,256,0,256,0,0,256
BÉKÉS,Békéscsaba,059,607,199,0,196,-3,1,195
BÉKÉS,Békéscsaba,060,817,366,0,366,0,3,363
BÉKÉS,Békéscsaba,061,263,103,0,103,0,1,102
BÉKÉS,Békéscsaba,062,1097,444,0,444,0,2,442
BÉKÉS,Békéscsaba,063,646,284,0,284,0,0,284
BÉKÉS,Békéscsaba,064,786,350,0,350,0,1,349
BÉKÉS,Békéscsaba,065,614,292,0,292,0,3,289
BÉKÉS,Békéscsaba,066,499,210,0,210,0,2,208
BÉKÉS,Békéscsaba,067,755,258,0,257,-1,1,256
BÉKÉS,Békéscsaba,068,784,277,0,277,0,4,273
BÉKÉS,Békéssámson,001,607,236,0,236,0,0,236
BÉKÉS,Békéssámson,002,651,234,0,234,0,0,234
BÉKÉS,Békéssámson,003,662,214,0,214,0,4,210
BÉKÉS,Békésszentandrás,001,535,282,0,282,0,1,281
BÉKÉS,Békésszentandrás,002,428,173,0,173,0,2,171
BÉKÉS,Békésszentandrás,003,452,153,0,153,0,2,151
BÉKÉS,Békésszentandrás,004,455,224,0,224,0,0,224
BÉKÉS,Békésszentandrás,005,674,285,0,285,0,3,282
BÉKÉS,Békésszentandrás,006,508,224,0,224,0,3,221
BÉKÉS,Békésszentandrás,007,43,25,0,25,0,1,24
BÉKÉS,Bélmegyer,001,810,287,0,287,0,5,282
BÉKÉS,Biharugra,001,789,372,0,371,-1,2,369
BÉKÉS,Bucsa,001,899,257,0,257,0,2,255
BÉKÉS,Bucsa,002,904,279,0,279,0,0,279
BÉKÉS,Csabacsûd,001,679,290,0,290,0,0,290
BÉKÉS,Csabacsûd,002,698,262,0,262,0,0,262
BÉKÉS,Csabacsûd,003,86,24,0,24,0,0,24
BÉKÉS,Csabaszabadi,001,252,110,0,110,0,0,110
BÉKÉS,Csanádapáca,001,1007,414,0,414,0,1,413
BÉKÉS,Csanádapáca,002,1067,320,0,320,0,1,319
BÉKÉS,Csárdaszállás,001,357,170,0,170,0,1,169
BÉKÉS,Csorvás,001,824,323,0,321,-2,2,319
BÉKÉS,Csorvás,002,826,239,0,239,0,0,239
BÉKÉS,Csorvás,003,833,285,0,285,0,1,284
BÉKÉS,Csorvás,004,750,249,0,249,0,3,246
BÉKÉS,Csorvás,005,816,308,0,308,0,0,308
BÉKÉS,Dévaványa,001,781,190,0,190,0,6,184
BÉKÉS,Dévaványa,002,761,266,0,266,0,1,265
BÉKÉS,Dévaványa,003,864,240,0,240,0,0,240
BÉKÉS,Dévaványa,004,698,250,0,250,0,2,248
BÉKÉS,Dévaványa,005,689,238,0,238,0,0,238
BÉKÉS,Dévaványa,006,697,216,0,216,0,1,215
BÉKÉS,Dévaványa,007,819,256,0,256,0,0,256
BÉKÉS,Dévaványa,008,795,231,0,231,0,2,229
BÉKÉS,Doboz,001,834,235,0,234,-1,3,231
BÉKÉS,Doboz,002,637,224,0,224,0,0,224
BÉKÉS,Doboz,003,688,233,0,233,0,2,231
BÉKÉS,Doboz,004,620,221,0,221,0,5,216
BÉKÉS,Doboz,005,653,210,0,210,0,2,208
BÉKÉS,Dombegyház,001,660,245,0,245,0,2,243
BÉKÉS,Dombegyház,002,594,217,0,217,0,1,216
BÉKÉS,Dombegyház,003,442,139,0,139,0,2,137
BÉKÉS,Dombiratos,001,483,214,0,214,0,2,212
BÉKÉS,Ecsegfalva,001,1021,274,0,274,0,1,273
BÉKÉS,Elek,001,478,142,0,142,0,2,140
BÉKÉS,Elek,002,613,247,1,246,-1,5,241
BÉKÉS,Elek,003,659,207,0,207,0,2,205
BÉKÉS,Elek,004,597,209,0,209,0,2,207
BÉKÉS,Elek,005,692,273,0,273,0,2,271
BÉKÉS,Elek,006,702,172,0,172,0,2,170
BÉKÉS,Füzesgyarmat,001,899,346,0,346,0,3,343
BÉKÉS,Füzesgyarmat,002,843,346,0,346,0,6,340
BÉKÉS,Füzesgyarmat,003,881,284,0,284,0,4,280
BÉKÉS,Füzesgyarmat,004,1006,339,0,339,0,3,336
BÉKÉS,Füzesgyarmat,005,987,368,0,368,0,5,363
BÉKÉS,Gádoros,001,944,271,0,271,0,2,269
BÉKÉS,Gádoros,002,992,382,0,382,0,3,379
BÉKÉS,Gádoros,003,1022,313,0,313,0,2,311
BÉKÉS,Gerendás,001,560,245,0,245,0,1,244
BÉKÉS,Gerendás,002,475,239,0,239,0,1,238
BÉKÉS,Geszt,001,584,173,0,173,0,0,173
BÉKÉS,Gyomaendrõd,001,683,306,0,306,0,3,303
BÉKÉS,Gyomaendrõd,002,697,307,0,307,0,1,306
BÉKÉS,Gyomaendrõd,003,700,236,0,236,0,0,236
BÉKÉS,Gyomaendrõd,004,730,282,0,282,0,1,281
BÉKÉS,Gyomaendrõd,005,647,295,0,295,0,3,292
BÉKÉS,Gyomaendrõd,006,668,270,0,270,0,0,270
BÉKÉS,Gyomaendrõd,007,728,200,0,200,0,2,198
BÉKÉS,Gyomaendrõd,008,637,180,0,180,0,0,180
BÉKÉS,Gyomaendrõd,009,666,222,0,222,0,0,222
BÉKÉS,Gyomaendrõd,010,638,278,0,278,0,0,278
BÉKÉS,Gyomaendrõd,011,779,261,0,261,0,0,261
BÉKÉS,Gyomaendrõd,012,717,236,0,236,0,2,234
BÉKÉS,Gyomaendrõd,013,635,145,0,145,0,3,142
BÉKÉS,Gyomaendrõd,014,592,205,0,205,0,3,202
BÉKÉS,Gyomaendrõd,015,122,48,0,48,0,3,45
BÉKÉS,Gyomaendrõd,016,789,307,0,307,0,1,306
BÉKÉS,Gyomaendrõd,017,555,110,0,110,0,0,110
BÉKÉS,Gyula,001,1138,527,0,527,0,2,525
BÉKÉS,Gyula,002,1054,526,0,526,0,0,526
BÉKÉS,Gyula,003,1132,584,0,584,0,3,581
BÉKÉS,Gyula,004,834,391,0,391,0,3,388
BÉKÉS,Gyula,005,805,320,1,318,-2,2,316
BÉKÉS,Gyula,006,814,366,0,366,0,2,364
BÉKÉS,Gyula,007,1028,372,1,371,-1,1,370
BÉKÉS,Gyula,008,942,455,0,455,0,3,452
BÉKÉS,Gyula,009,718,346,0,346,0,2,344
BÉKÉS,Gyula,010,809,405,0,404,-1,1,403
BÉKÉS,Gyula,011,735,291,0,291,0,1,290
BÉKÉS,Gyula,012,726,270,0,270,0,0,270
BÉKÉS,Gyula,013,679,255,0,255,0,0,255
BÉKÉS,Gyula,014,1030,351,0,351,0,5,346
BÉKÉS,Gyula,015,802,395,0,394,-1,3,391
BÉKÉS,Gyula,016,933,456,0,456,0,2,454
BÉKÉS,Gyula,017,728,284,0,284,0,0,284
BÉKÉS,Gyula,018,701,280,0,280,0,0,280
BÉKÉS,Gyula,019,1191,434,0,434,0,6,428
BÉKÉS,Gyula,020,766,368,0,368,0,3,365
BÉKÉS,Gyula,021,903,402,0,402,0,2,400
BÉKÉS,Gyula,022,850,383,0,383,0,2,381
BÉKÉS,Gyula,023,1050,479,0,479,0,5,474
BÉKÉS,Gyula,024,748,292,1,291,-1,2,289
BÉKÉS,Gyula,025,930,437,0,437,0,3,434
BÉKÉS,Gyula,026,805,307,0,307,0,3,304
BÉKÉS,Gyula,027,636,238,0,238,0,0,238
BÉKÉS,Gyula,028,607,256,0,256,0,1,255
BÉKÉS,Gyula,029,661,258,0,258,0,2,256
BÉKÉS,Gyula,030,148,50,0,50,0,1,49
BÉKÉS,Hunya,001,537,233,0,233,0,1,232
BÉKÉS,Kamut,001,487,214,1,213,-1,2,211
BÉKÉS,Kamut,002,389,172,0,172,0,5,167
BÉKÉS,Kardos,001,483,234,0,234,0,3,231
BÉKÉS,Kardoskút,001,688,244,0,244,0,0,244
BÉKÉS,Kaszaper,001,709,286,0,286,0,3,283
BÉKÉS,Kaszaper,002,682,252,0,252,0,1,251
BÉKÉS,Kaszaper,003,119,47,0,47,0,0,47
BÉKÉS,Kertészsziget,001,309,104,0,104,0,1,103
BÉKÉS,Kevermes,001,745,262,0,262,0,3,259
BÉKÉS,Kevermes,002,721,262,0,262,0,1,261
BÉKÉS,Kétegyháza,001,754,234,0,234,0,1,233
BÉKÉS,Kétegyháza,002,729,241,0,241,0,1,240
BÉKÉS,Kétegyháza,003,825,267,0,267,0,2,265
BÉKÉS,Kétegyháza,004,638,191,1,190,-1,2,188
BÉKÉS,Kétsoprony,001,793,434,0,434,0,6,428
BÉKÉS,Kétsoprony,002,325,115,0,115,0,0,115
BÉKÉS,Kisdombegyház,001,398,151,0,151,0,3,148
BÉKÉS,Kondoros,001,613,230,0,230,0,1,229
BÉKÉS,Kondoros,002,642,281,0,281,0,2,279
BÉKÉS,Kondoros,003,660,255,1,254,-1,1,253
BÉKÉS,Kondoros,004,585,219,0,219,0,4,215
BÉKÉS,Kondoros,005,619,242,0,242,0,1,241
BÉKÉS,Kondoros,006,589,251,0,251,0,1,250
BÉKÉS,Kondoros,007,447,160,0,160,0,1,159
BÉKÉS,Körösladány,001,817,254,0,254,0,2,252
BÉKÉS,Körösladány,002,950,214,0,214,0,4,210
BÉKÉS,Körösladány,003,890,261,0,261,0,0,261
BÉKÉS,Körösladány,004,917,346,0,346,0,1,345
BÉKÉS,Körösnagyharsány,001,492,186,0,186,0,3,183
BÉKÉS,Köröstarcsa,001,676,234,0,234,0,1,233
BÉKÉS,Köröstarcsa,002,688,216,0,216,0,2,214
BÉKÉS,Köröstarcsa,003,684,220,0,220,0,2,218
BÉKÉS,Körösújfalu,001,404,129,0,129,0,0,129
BÉKÉS,Kötegyán,001,568,220,0,220,0,2,218
BÉKÉS,Kötegyán,002,631,209,0,209,0,6,203
BÉKÉS,Kunágota,001,686,216,0,216,0,1,215
BÉKÉS,Kunágota,002,645,210,0,211,1,9,202
BÉKÉS,Kunágota,003,811,228,0,228,0,3,225
BÉKÉS,Lõkösháza,001,782,283,0,283,0,0,283
BÉKÉS,Lõkösháza,002,654,238,0,236,-2,3,233
BÉKÉS,Magyarbánhegyes,001,608,215,0,215,0,2,213
BÉKÉS,Magyarbánhegyes,002,489,156,0,156,0,0,156
BÉKÉS,Magyarbánhegyes,003,586,179,0,179,0,2,177
BÉKÉS,Magyardombegyház,001,184,73,0,73,0,0,73
BÉKÉS,Medgyesbodzás,001,529,196,0,196,0,1,195
BÉKÉS,Medgyesbodzás,002,269,104,0,104,0,0,104
BÉKÉS,Medgyesegyháza,001,953,370,0,370,0,3,367
BÉKÉS,Medgyesegyháza,002,811,374,0,372,-2,3,369
BÉKÉS,Medgyesegyháza,003,823,353,0,353,0,6,347
BÉKÉS,Medgyesegyháza,004,277,93,0,93,0,1,92
BÉKÉS,Mezõberény,001,1055,271,0,271,0,1,270
BÉKÉS,Mezõberény,002,1014,382,0,382,0,3,379
BÉKÉS,Mezõberény,003,1048,420,0,420,0,1,419
BÉKÉS,Mezõberény,004,1035,374,0,374,0,3,371
BÉKÉS,Mezõberény,005,907,395,0,395,0,3,392
BÉKÉS,Mezõberény,006,1128,288,0,288,0,3,285
BÉKÉS,Mezõberény,007,1066,419,0,419,0,2,417
BÉKÉS,Mezõberény,008,968,358,0,357,-1,1,356
BÉKÉS,Mezõgyán,001,775,253,0,253,0,1,252
BÉKÉS,Mezõgyán,002,83,42,0,42,0,0,42
BÉKÉS,Mezõhegyes,001,703,238,0,238,0,1,237
BÉKÉS,Mezõhegyes,002,597,248,0,248,0,1,247
BÉKÉS,Mezõhegyes,003,697,258,0,258,0,0,258
BÉKÉS,Mezõhegyes,004,736,360,0,360,0,2,358
BÉKÉS,Mezõhegyes,005,802,293,0,293,0,1,292
BÉKÉS,Mezõhegyes,006,727,217,0,217,0,2,215
BÉKÉS,Mezõkovácsháza,001,835,364,0,363,-1,2,361
BÉKÉS,Mezõkovácsháza,002,920,365,0,365,0,2,363
BÉKÉS,Mezõkovácsháza,003,1012,375,0,375,0,2,373
BÉKÉS,Mezõkovácsháza,004,1057,390,0,390,0,0,390
BÉKÉS,Mezõkovácsháza,005,951,321,0,321,0,1,320
BÉKÉS,Méhkerék,001,852,282,0,282,0,5,277
BÉKÉS,Méhkerék,002,885,321,0,321,0,3,318
BÉKÉS,Murony,001,490,163,0,163,0,0,163
BÉKÉS,Murony,002,541,169,0,169,0,0,169
BÉKÉS,Nagybánhegyes,001,1058,465,0,465,0,2,463
BÉKÉS,Nagykamarás,001,376,109,0,109,0,0,109
BÉKÉS,Nagykamarás,002,321,113,0,113,0,0,113
BÉKÉS,Nagykamarás,003,373,121,0,121,0,0,121
BÉKÉS,Nagyszénás,001,907,323,0,323,0,1,322
BÉKÉS,Nagyszénás,002,1138,489,0,488,-1,5,483
BÉKÉS,Nagyszénás,003,947,365,0,365,0,1,364
BÉKÉS,Nagyszénás,004,1117,422,0,422,0,0,422
BÉKÉS,Okány,001,960,277,0,277,0,3,274
BÉKÉS,Okány,002,926,272,0,272,0,1,271
BÉKÉS,Orosháza,001,742,400,0,399,-1,1,398
BÉKÉS,Orosháza,002,689,290,0,290,0,2,288
BÉKÉS,Orosháza,003,678,255,0,255,0,0,255
BÉKÉS,Orosháza,004,784,298,0,298,0,3,295
BÉKÉS,Orosháza,005,611,266,0,266,0,0,266
BÉKÉS,Orosháza,006,882,372,0,372,0,1,371
BÉKÉS,Orosháza,007,430,217,0,217,0,1,216
BÉKÉS,Orosháza,008,536,260,0,260,0,0,260
BÉKÉS,Orosháza,009,486,241,0,241,0,0,241
BÉKÉS,Orosháza,010,775,338,0,338,0,5,333
BÉKÉS,Orosháza,011,612,285,0,285,0,4,281
BÉKÉS,Orosháza,012,697,299,0,299,0,1,298
BÉKÉS,Orosháza,013,592,270,0,270,0,2,268
BÉKÉS,Orosháza,014,558,240,0,240,0,0,240
BÉKÉS,Orosháza,015,508,209,0,209,0,2,207
BÉKÉS,Orosháza,016,126,46,0,46,0,0,46
BÉKÉS,Orosháza,017,652,255,0,255,0,1,254
BÉKÉS,Orosháza,018,522,242,0,242,0,2,240
BÉKÉS,Orosháza,019,733,370,0,370,0,1,369
BÉKÉS,Orosháza,020,936,368,0,366,-2,0,366
BÉKÉS,Orosháza,021,721,332,0,332,0,2,330
BÉKÉS,Orosháza,022,747,266,0,266,0,0,266
BÉKÉS,Orosháza,023,1040,463,0,463,0,4,459
BÉKÉS,Orosháza,024,976,458,0,458,0,0,458
BÉKÉS,Orosháza,025,913,383,0,383,0,5,378
BÉKÉS,Orosháza,026,837,347,0,347,0,1,346
BÉKÉS,Orosháza,027,792,320,0,320,0,0,320
BÉKÉS,Orosháza,028,405,206,0,206,0,0,206
BÉKÉS,Orosháza,029,373,132,0,132,0,2,130
BÉKÉS,Orosháza,030,867,258,0,258,0,1,257
BÉKÉS,Orosháza,031,862,323,0,323,0,1,322
BÉKÉS,Orosháza,032,620,178,1,177,-1,0,177
BÉKÉS,Orosháza,033,683,242,0,242,0,1,241
BÉKÉS,Orosháza,034,164,55,0,55,0,0,55
BÉKÉS,Orosháza,035,151,58,0,58,0,0,58
BÉKÉS,Orosháza,036,658,289,0,289,0,0,289
BÉKÉS,Orosháza,037,85,35,0,35,0,0,35
BÉKÉS,Örménykút,001,309,136,0,136,0,0,136
BÉKÉS,Pusztaföldvár,001,759,276,0,276,0,3,273
BÉKÉS,Pusztaföldvár,002,552,193,0,193,0,1,192
BÉKÉS,Pusztaottlaka,001,232,127,0,127,0,3,124
BÉKÉS,Pusztaottlaka,002,68,31,0,31,0,0,31
BÉKÉS,Sarkad,001,985,346,0,346,0,3,343
BÉKÉS,Sarkad,002,991,311,0,311,0,1,310
BÉKÉS,Sarkad,003,1005,296,0,296,0,3,293
BÉKÉS,Sarkad,004,1021,366,0,366,0,2,364
BÉKÉS,Sarkad,005,1012,224,0,224,0,2,222
BÉKÉS,Sarkad,006,892,288,0,288,0,3,285
BÉKÉS,Sarkad,007,1116,424,0,424,0,1,423
BÉKÉS,Sarkad,008,923,280,0,280,0,2,278
BÉKÉS,Sarkadkeresztúr,001,565,180,0,180,0,3,177
BÉKÉS,Sarkadkeresztúr,002,547,212,0,212,0,0,212
BÉKÉS,Sarkadkeresztúr,003,126,49,0,49,0,0,49
BÉKÉS,Sarkadkeresztúr,004,60,30,0,30,0,0,30
BÉKÉS,Szabadkígyós,001,659,257,0,257,0,0,257
BÉKÉS,Szabadkígyós,002,798,303,0,303,0,0,303
BÉKÉS,Szabadkígyós,003,723,270,0,270,0,2,268
BÉKÉS,Szarvas,001,994,560,0,560,0,1,559
BÉKÉS,Szarvas,002,959,371,0,371,0,4,367
BÉKÉS,Szarvas,003,761,322,0,322,0,4,318
BÉKÉS,Szarvas,004,638,294,0,294,0,0,294
BÉKÉS,Szarvas,005,779,390,0,390,0,2,388
BÉKÉS,Szarvas,006,693,271,0,271,0,0,271
BÉKÉS,Szarvas,007,607,228,0,228,0,2,226
BÉKÉS,Szarvas,008,952,377,0,377,0,4,373
BÉKÉS,Szarvas,009,223,74,0,74,0,0,74
BÉKÉS,Szarvas,010,1123,635,0,635,0,3,632
BÉKÉS,Szarvas,011,864,347,0,347,0,3,344
BÉKÉS,Szarvas,012,905,371,0,371,0,0,371
BÉKÉS,Szarvas,013,781,294,0,294,0,0,294
BÉKÉS,Szarvas,014,895,292,0,292,0,0,292
BÉKÉS,Szarvas,015,775,284,0,284,0,3,281
BÉKÉS,Szarvas,016,232,79,0,79,0,0,79
BÉKÉS,Szarvas,017,400,140,0,140,0,1,139
BÉKÉS,Szarvas,018,470,166,0,166,0,0,166
BÉKÉS,Szeghalom,001,1045,341,0,341,0,6,335
BÉKÉS,Szeghalom,002,1065,427,0,427,0,2,425
BÉKÉS,Szeghalom,003,952,345,0,345,0,1,344
BÉKÉS,Szeghalom,004,1061,392,0,392,0,1,391
BÉKÉS,Szeghalom,005,1039,318,0,318,0,0,318
BÉKÉS,Szeghalom,006,1067,394,0,394,0,0,394
BÉKÉS,Szeghalom,007,1117,230,0,230,0,2,228
BÉKÉS,Tarhos,001,677,261,0,261,0,3,258
BÉKÉS,Telekgerendás,001,587,248,0,248,0,1,247
BÉKÉS,Telekgerendás,002,707,283,1,282,-1,1,281
BÉKÉS,Tótkomlós,001,484,214,0,214,0,0,214
BÉKÉS,Tótkomlós,002,677,269,0,269,0,1,268
BÉKÉS,Tótkomlós,003,498,251,0,251,0,0,251
BÉKÉS,Tótkomlós,004,501,226,0,226,0,2,224
BÉKÉS,Tótkomlós,005,533,195,0,195,0,4,191
BÉKÉS,Tótkomlós,006,542,264,0,264,0,2,262
BÉKÉS,Tótkomlós,007,751,361,0,361,0,2,359
BÉKÉS,Tótkomlós,008,782,315,0,315,0,3,312
BÉKÉS,Újkígyós,001,776,240,0,240,0,1,239
BÉKÉS,Újkígyós,002,626,234,0,234,0,0,234
BÉKÉS,Újkígyós,003,744,258,0,258,0,3,255
BÉKÉS,Újkígyós,004,745,297,0,297,0,2,295
BÉKÉS,Újkígyós,005,719,272,0,272,0,1,271
BÉKÉS,Újkígyós,006,592,192,0,192,0,2,190
BÉKÉS,Újszalonta,001,84,35,0,35,0,0,35
BÉKÉS,Végegyháza,001,929,324,0,324,0,2,322
BÉKÉS,Végegyháza,002,119,54,0,54,0,0,54
BÉKÉS,Vésztõ,001,701,190,0,190,0,1,189
BÉKÉS,Vésztõ,002,654,219,0,219,0,0,219
BÉKÉS,Vésztõ,003,719,272,0,272,0,2,270
BÉKÉS,Vésztõ,004,685,298,0,298,0,2,296
BÉKÉS,Vésztõ,005,959,251,0,251,0,1,250
BÉKÉS,Vésztõ,006,866,198,0,198,0,4,194
BÉKÉS,Vésztõ,007,841,156,0,156,0,0,156
BÉKÉS,Zsadány,001,641,231,0,231,0,2,229
BÉKÉS,Zsadány,002,608,208,0,208,0,2,206
BORSOD-ABAÚJ-ZEMPLÉN,Abaújalpár,001,62,25,0,25,0,0,25
BORSOD-ABAÚJ-ZEMPLÉN,Abaújkér,001,408,141,0,140,-1,0,140
BORSOD-ABAÚJ-ZEMPLÉN,Abaújkér,002,78,25,0,25,0,0,25
BORSOD-ABAÚJ-ZEMPLÉN,Abaújlak,001,85,38,0,38,0,0,38
BORSOD-ABAÚJ-ZEMPLÉN,Abaújszántó,001,827,228,0,228,0,1,227
BORSOD-ABAÚJ-ZEMPLÉN,Abaújszántó,002,832,272,0,272,0,0,272
BORSOD-ABAÚJ-ZEMPLÉN,Abaújszántó,003,761,293,0,293,0,0,293
BORSOD-ABAÚJ-ZEMPLÉN,Abaújszolnok,001,110,38,0,38,0,0,38
BORSOD-ABAÚJ-ZEMPLÉN,Abaújvár,001,139,52,0,52,0,0,52
BORSOD-ABAÚJ-ZEMPLÉN,Abod,001,144,64,0,64,0,0,64
BORSOD-ABAÚJ-ZEMPLÉN,Aggtelek,001,454,226,0,226,0,1,225
BORSOD-ABAÚJ-ZEMPLÉN,Alacska,001,624,163,0,163,0,0,163
BORSOD-ABAÚJ-ZEMPLÉN,Alsóberecki,001,612,208,0,208,0,0,208
BORSOD-ABAÚJ-ZEMPLÉN,Alsódobsza,001,254,117,0,117,0,1,116
BORSOD-ABAÚJ-ZEMPLÉN,Alsógagy,001,71,43,0,43,0,0,43
BORSOD-ABAÚJ-ZEMPLÉN,Alsóregmec,001,159,86,0,86,0,1,85
BORSOD-ABAÚJ-ZEMPLÉN,Alsószuha,001,348,153,0,153,0,2,151
BORSOD-ABAÚJ-ZEMPLÉN,Alsótelekes,001,110,61,0,61,0,0,61
BORSOD-ABAÚJ-ZEMPLÉN,Alsóvadász,001,1108,299,0,299,0,1,298
BORSOD-ABAÚJ-ZEMPLÉN,Alsózsolca,001,727,344,0,344,0,0,344
BORSOD-ABAÚJ-ZEMPLÉN,Alsózsolca,002,744,292,0,292,0,3,289
BORSOD-ABAÚJ-ZEMPLÉN,Alsózsolca,003,1000,225,0,224,-1,3,221
BORSOD-ABAÚJ-ZEMPLÉN,Alsózsolca,004,839,330,0,330,0,1,329
BORSOD-ABAÚJ-ZEMPLÉN,Alsózsolca,005,986,295,0,295,0,4,291
BORSOD-ABAÚJ-ZEMPLÉN,Arka,001,70,48,0,48,0,0,48
BORSOD-ABAÚJ-ZEMPLÉN,Arló,001,877,101,0,101,0,0,101
BORSOD-ABAÚJ-ZEMPLÉN,Arló,002,889,186,0,186,0,1,185
BORSOD-ABAÚJ-ZEMPLÉN,Arló,003,874,160,0,160,0,1,159
BORSOD-ABAÚJ-ZEMPLÉN,Arnót,001,861,388,0,388,0,1,387
BORSOD-ABAÚJ-ZEMPLÉN,Arnót,002,1083,508,0,508,0,2,506
BORSOD-ABAÚJ-ZEMPLÉN,Aszaló,001,704,281,0,281,0,2,279
BORSOD-ABAÚJ-ZEMPLÉN,Aszaló,002,691,218,0,218,0,0,218
BORSOD-ABAÚJ-ZEMPLÉN,Ároktõ,001,829,311,0,311,0,2,309
BORSOD-ABAÚJ-ZEMPLÉN,Baktakék,001,551,170,1,169,-1,1,168
BORSOD-ABAÚJ-ZEMPLÉN,Balajt,001,339,102,0,102,0,4,98
BORSOD-ABAÚJ-ZEMPLÉN,Baskó,001,147,86,0,86,0,0,86
BORSOD-ABAÚJ-ZEMPLÉN,Bánhorváti,001,568,224,0,224,0,1,223
BORSOD-ABAÚJ-ZEMPLÉN,Bánhorváti,002,570,215,0,215,0,0,215
BORSOD-ABAÚJ-ZEMPLÉN,Bánréve,001,992,348,0,348,0,2,346
BORSOD-ABAÚJ-ZEMPLÉN,Becskeháza,001,32,27,0,27,0,0,27
BORSOD-ABAÚJ-ZEMPLÉN,Bekecs,001,969,365,0,365,0,0,365
BORSOD-ABAÚJ-ZEMPLÉN,Bekecs,002,1035,428,0,428,0,2,426
BORSOD-ABAÚJ-ZEMPLÉN,Berente,001,942,282,0,282,0,1,281
BORSOD-ABAÚJ-ZEMPLÉN,Beret,001,205,49,0,49,0,0,49
BORSOD-ABAÚJ-ZEMPLÉN,Berzék,001,764,215,1,214,-1,3,211
BORSOD-ABAÚJ-ZEMPLÉN,Bodroghalom,001,1037,240,0,240,0,0,240
BORSOD-ABAÚJ-ZEMPLÉN,Bodrogkeresztúr,001,911,406,0,406,0,4,402
BORSOD-ABAÚJ-ZEMPLÉN,Bodrogkisfalud,001,724,261,0,261,0,1,260
BORSOD-ABAÚJ-ZEMPLÉN,Bodrogolaszi,001,717,227,0,227,0,1,226
BORSOD-ABAÚJ-ZEMPLÉN,Bogács,001,784,342,0,342,0,2,340
BORSOD-ABAÚJ-ZEMPLÉN,Bogács,002,865,343,0,343,0,3,340
BORSOD-ABAÚJ-ZEMPLÉN,Boldogkõújfalu,001,379,78,0,78,0,2,76
BORSOD-ABAÚJ-ZEMPLÉN,Boldogkõváralja,001,768,294,0,294,0,1,293
BORSOD-ABAÚJ-ZEMPLÉN,Boldva,001,973,223,0,223,0,1,222
BORSOD-ABAÚJ-ZEMPLÉN,Boldva,002,822,300,0,300,0,1,299
BORSOD-ABAÚJ-ZEMPLÉN,Borsodbóta,001,634,158,0,158,0,3,155
BORSOD-ABAÚJ-ZEMPLÉN,Borsodgeszt,001,243,116,0,116,0,1,115
BORSOD-ABAÚJ-ZEMPLÉN,Borsodivánka,001,435,217,0,217,0,0,217
BORSOD-ABAÚJ-ZEMPLÉN,Borsodnádasd,001,595,164,0,164,0,1,163
BORSOD-ABAÚJ-ZEMPLÉN,Borsodnádasd,002,577,172,0,172,0,0,172
BORSOD-ABAÚJ-ZEMPLÉN,Borsodnádasd,003,589,195,0,195,0,3,192
BORSOD-ABAÚJ-ZEMPLÉN,Borsodnádasd,004,673,269,0,269,0,2,267
BORSOD-ABAÚJ-ZEMPLÉN,Borsodszentgyörgy,001,981,309,0,309,0,2,307
BORSOD-ABAÚJ-ZEMPLÉN,Borsodszirák,001,921,226,0,226,0,1,225
BORSOD-ABAÚJ-ZEMPLÉN,Bódvalenke,001,147,62,0,62,0,0,62
BORSOD-ABAÚJ-ZEMPLÉN,Bódvarákó,001,77,41,0,41,0,1,40
BORSOD-ABAÚJ-ZEMPLÉN,Bódvaszilas,001,842,411,0,411,0,1,410
BORSOD-ABAÚJ-ZEMPLÉN,Bózsva,001,162,86,0,86,0,1,85
BORSOD-ABAÚJ-ZEMPLÉN,Bõcs,001,816,268,0,268,0,0,268
BORSOD-ABAÚJ-ZEMPLÉN,Bõcs,002,624,234,0,234,0,2,232
BORSOD-ABAÚJ-ZEMPLÉN,Bõcs,003,698,307,0,307,0,2,305
BORSOD-ABAÚJ-ZEMPLÉN,Bükkaranyos,001,1212,430,0,430,0,2,428
BORSOD-ABAÚJ-ZEMPLÉN,Bükkábrány,001,617,288,0,288,0,1,287
BORSOD-ABAÚJ-ZEMPLÉN,Bükkábrány,002,742,310,0,310,0,0,310
BORSOD-ABAÚJ-ZEMPLÉN,Bükkmogyorósd,001,124,76,0,76,0,1,75
BORSOD-ABAÚJ-ZEMPLÉN,Bükkszentkereszt,001,1018,460,0,460,0,1,459
BORSOD-ABAÚJ-ZEMPLÉN,Bükkzsérc,001,841,362,0,362,0,2,360
BORSOD-ABAÚJ-ZEMPLÉN,Büttös,001,162,68,0,68,0,1,67
BORSOD-ABAÚJ-ZEMPLÉN,Cigánd,001,842,194,0,194,0,3,191
BORSOD-ABAÚJ-ZEMPLÉN,Cigánd,002,729,180,0,180,0,0,180
BORSOD-ABAÚJ-ZEMPLÉN,Cigánd,003,751,176,0,176,0,1,175
BORSOD-ABAÚJ-ZEMPLÉN,Csenyéte,001,260,58,0,58,0,1,57
BORSOD-ABAÚJ-ZEMPLÉN,Cserépfalu,001,833,403,0,403,0,1,402
BORSOD-ABAÚJ-ZEMPLÉN,Cserépváralja,001,358,182,0,182,0,4,178
BORSOD-ABAÚJ-ZEMPLÉN,Csernely,001,551,173,0,173,0,1,172
BORSOD-ABAÚJ-ZEMPLÉN,Csincse,001,464,206,0,206,0,5,201
BORSOD-ABAÚJ-ZEMPLÉN,Csobaj,001,552,165,0,165,0,1,164
BORSOD-ABAÚJ-ZEMPLÉN,Csobád,001,542,217,0,217,0,6,211
BORSOD-ABAÚJ-ZEMPLÉN,Csokvaomány,001,632,226,0,226,0,1,225
BORSOD-ABAÚJ-ZEMPLÉN,Damak,001,194,87,0,87,0,0,87
BORSOD-ABAÚJ-ZEMPLÉN,Dámóc,001,268,84,0,84,0,1,83
BORSOD-ABAÚJ-ZEMPLÉN,Debréte,001,19,11,0,11,0,0,11
BORSOD-ABAÚJ-ZEMPLÉN,Detek,001,214,71,0,71,0,0,71
BORSOD-ABAÚJ-ZEMPLÉN,Dédestapolcsány,001,1228,391,0,391,0,0,391
BORSOD-ABAÚJ-ZEMPLÉN,Domaháza,001,595,177,0,177,0,3,174
BORSOD-ABAÚJ-ZEMPLÉN,Dövény,001,222,100,0,100,0,3,97
BORSOD-ABAÚJ-ZEMPLÉN,Dubicsány,001,242,115,0,115,0,0,115
BORSOD-ABAÚJ-ZEMPLÉN,Edelény,001,951,361,0,360,-1,3,357
BORSOD-ABAÚJ-ZEMPLÉN,Edelény,002,1053,509,0,509,0,2,507
BORSOD-ABAÚJ-ZEMPLÉN,Edelény,003,1094,412,0,412,0,2,410
BORSOD-ABAÚJ-ZEMPLÉN,Edelény,004,891,387,0,387,0,0,387
BORSOD-ABAÚJ-ZEMPLÉN,Edelény,005,874,443,0,443,0,3,440
BORSOD-ABAÚJ-ZEMPLÉN,Edelény,006,796,364,0,364,0,1,363
BORSOD-ABAÚJ-ZEMPLÉN,Edelény,007,1059,418,0,418,0,4,414
BORSOD-ABAÚJ-ZEMPLÉN,Edelény,008,977,302,0,302,0,4,298
BORSOD-ABAÚJ-ZEMPLÉN,Egerlövõ,001,455,241,0,241,0,2,239
BORSOD-ABAÚJ-ZEMPLÉN,Emõd,001,741,228,0,228,0,1,227
BORSOD-ABAÚJ-ZEMPLÉN,Emõd,002,761,278,0,278,0,2,276
BORSOD-ABAÚJ-ZEMPLÉN,Emõd,003,788,261,0,261,0,0,261
BORSOD-ABAÚJ-ZEMPLÉN,Emõd,004,860,276,0,276,0,3,273
BORSOD-ABAÚJ-ZEMPLÉN,Emõd,005,828,257,0,257,0,0,257
BORSOD-ABAÚJ-ZEMPLÉN,Encs,001,799,396,0,396,0,2,394
BORSOD-ABAÚJ-ZEMPLÉN,Encs,002,884,330,0,330,0,2,328
BORSOD-ABAÚJ-ZEMPLÉN,Encs,003,642,124,1,123,-1,1,122
BORSOD-ABAÚJ-ZEMPLÉN,Encs,004,782,284,0,284,0,2,282
BORSOD-ABAÚJ-ZEMPLÉN,Encs,005,739,372,0,372,0,1,371
BORSOD-ABAÚJ-ZEMPLÉN,Encs,006,608,191,0,191,0,0,191
BORSOD-ABAÚJ-ZEMPLÉN,Encs,007,453,82,0,82,0,0,82
BORSOD-ABAÚJ-ZEMPLÉN,Erdõbénye,001,943,348,0,348,0,2,346
BORSOD-ABAÚJ-ZEMPLÉN,Erdõhorváti,001,479,201,0,201,0,3,198
BORSOD-ABAÚJ-ZEMPLÉN,Égerszög,001,54,40,0,40,0,1,39
BORSOD-ABAÚJ-ZEMPLÉN,Fancsal,001,277,111,0,111,0,0,111
BORSOD-ABAÚJ-ZEMPLÉN,Farkaslyuk,001,699,205,0,205,0,0,205
BORSOD-ABAÚJ-ZEMPLÉN,Farkaslyuk,002,521,91,0,91,0,2,89
BORSOD-ABAÚJ-ZEMPLÉN,Fáj,001,267,124,0,124,0,0,124
BORSOD-ABAÚJ-ZEMPLÉN,Felsõberecki,001,222,71,0,71,0,0,71
BORSOD-ABAÚJ-ZEMPLÉN,Felsõdobsza,001,706,189,0,189,0,3,186
BORSOD-ABAÚJ-ZEMPLÉN,Felsõgagy,001,136,39,0,39,0,0,39
BORSOD-ABAÚJ-ZEMPLÉN,Felsõkelecsény,001,289,90,0,90,0,1,89
BORSOD-ABAÚJ-ZEMPLÉN,Felsõnyárád,001,793,296,0,296,0,3,293
BORSOD-ABAÚJ-ZEMPLÉN,Felsõregmec,001,201,59,0,59,0,4,55
BORSOD-ABAÚJ-ZEMPLÉN,Felsõtelekes,001,567,170,0,170,0,1,169
BORSOD-ABAÚJ-ZEMPLÉN,Felsõvadász,001,361,85,0,85,0,0,85
BORSOD-ABAÚJ-ZEMPLÉN,Felsõzsolca,001,720,351,0,349,-2,2,347
BORSOD-ABAÚJ-ZEMPLÉN,Felsõzsolca,002,887,437,0,437,0,1,436
BORSOD-ABAÚJ-ZEMPLÉN,Felsõzsolca,003,1107,480,0,480,0,6,474
BORSOD-ABAÚJ-ZEMPLÉN,Felsõzsolca,004,646,327,0,327,0,1,326
BORSOD-ABAÚJ-ZEMPLÉN,Felsõzsolca,005,909,372,0,372,0,2,370
BORSOD-ABAÚJ-ZEMPLÉN,Felsõzsolca,006,974,393,0,393,0,2,391
BORSOD-ABAÚJ-ZEMPLÉN,Filkeháza,001,87,42,0,42,0,1,41
BORSOD-ABAÚJ-ZEMPLÉN,Fony,001,265,90,0,90,0,1,89
BORSOD-ABAÚJ-ZEMPLÉN,Forró,001,1008,318,0,318,0,1,317
BORSOD-ABAÚJ-ZEMPLÉN,Forró,002,976,346,0,346,0,3,343
BORSOD-ABAÚJ-ZEMPLÉN,Fulókércs,001,270,54,0,54,0,0,54
BORSOD-ABAÚJ-ZEMPLÉN,Füzér,001,338,197,0,197,0,3,194
BORSOD-ABAÚJ-ZEMPLÉN,Füzérkajata,001,93,47,0,47,0,0,47
BORSOD-ABAÚJ-ZEMPLÉN,Füzérkomlós,001,240,129,0,129,0,4,125
BORSOD-ABAÚJ-ZEMPLÉN,Füzérradvány,001,250,75,0,75,0,1,74
BORSOD-ABAÚJ-ZEMPLÉN,Gadna,001,163,79,0,79,0,0,79
BORSOD-ABAÚJ-ZEMPLÉN,Gagyapáti,001,27,13,0,13,0,0,13
BORSOD-ABAÚJ-ZEMPLÉN,Gagybátor,001,134,44,0,44,0,0,44
BORSOD-ABAÚJ-ZEMPLÉN,Gagyvendégi,001,153,70,0,70,0,0,70
BORSOD-ABAÚJ-ZEMPLÉN,Galvács,001,75,51,0,51,0,1,50
BORSOD-ABAÚJ-ZEMPLÉN,Garadna,001,300,136,0,136,0,1,135
BORSOD-ABAÚJ-ZEMPLÉN,Gelej,001,470,288,0,288,0,3,285
BORSOD-ABAÚJ-ZEMPLÉN,Gesztely,001,616,212,0,212,0,0,212
BORSOD-ABAÚJ-ZEMPLÉN,Gesztely,002,567,237,0,237,0,1,236
BORSOD-ABAÚJ-ZEMPLÉN,Gesztely,003,659,231,0,231,0,2,229
BORSOD-ABAÚJ-ZEMPLÉN,Gesztely,004,221,76,0,76,0,0,76
BORSOD-ABAÚJ-ZEMPLÉN,Girincs,001,624,219,0,219,0,8,211
BORSOD-ABAÚJ-ZEMPLÉN,Golop,001,465,205,0,205,0,1,204
BORSOD-ABAÚJ-ZEMPLÉN,Gömörszõlõs,001,73,37,0,37,0,0,37
BORSOD-ABAÚJ-ZEMPLÉN,Gönc,001,791,339,0,339,0,0,339
BORSOD-ABAÚJ-ZEMPLÉN,Gönc,002,760,212,0,212,0,2,210
BORSOD-ABAÚJ-ZEMPLÉN,Göncruszka,001,468,138,0,138,0,0,138
BORSOD-ABAÚJ-ZEMPLÉN,Györgytarló,001,453,92,0,92,0,0,92
BORSOD-ABAÚJ-ZEMPLÉN,Halmaj,001,654,268,0,268,0,2,266
BORSOD-ABAÚJ-ZEMPLÉN,Halmaj,002,699,245,1,244,-1,5,239
BORSOD-ABAÚJ-ZEMPLÉN,Hangács,001,462,199,0,199,0,0,199
BORSOD-ABAÚJ-ZEMPLÉN,Hangony,001,650,197,0,197,0,1,196
BORSOD-ABAÚJ-ZEMPLÉN,Hangony,002,597,183,0,183,0,0,183
BORSOD-ABAÚJ-ZEMPLÉN,Harsány,001,790,318,0,318,0,1,317
BORSOD-ABAÚJ-ZEMPLÉN,Harsány,002,831,344,0,344,0,1,343
BORSOD-ABAÚJ-ZEMPLÉN,Háromhuta,001,126,82,0,82,0,1,81
BORSOD-ABAÚJ-ZEMPLÉN,Hegymeg,001,90,66,0,66,0,0,66
BORSOD-ABAÚJ-ZEMPLÉN,Hejce,001,179,102,0,102,0,0,102
BORSOD-ABAÚJ-ZEMPLÉN,Hejõbába,001,603,230,0,230,0,2,228
BORSOD-ABAÚJ-ZEMPLÉN,Hejõbába,002,616,232,0,232,0,3,229
BORSOD-ABAÚJ-ZEMPLÉN,Hejõkeresztúr,001,829,336,0,336,0,2,334
BORSOD-ABAÚJ-ZEMPLÉN,Hejõkürt,001,238,103,0,103,0,2,101
BORSOD-ABAÚJ-ZEMPLÉN,Hejõpapi,001,845,311,0,311,0,2,309
BORSOD-ABAÚJ-ZEMPLÉN,Hejõszalonta,001,557,299,0,299,0,1,298
BORSOD-ABAÚJ-ZEMPLÉN,Hercegkút,001,551,294,0,294,0,3,291
BORSOD-ABAÚJ-ZEMPLÉN,Hernádbûd,001,105,57,0,57,0,1,56
BORSOD-ABAÚJ-ZEMPLÉN,Hernádcéce,001,159,54,0,54,0,0,54
BORSOD-ABAÚJ-ZEMPLÉN,Hernádkak,001,124,54,0,54,0,0,54
BORSOD-ABAÚJ-ZEMPLÉN,Hernádkak,002,1109,464,0,464,0,2,462
BORSOD-ABAÚJ-ZEMPLÉN,Hernádkércs,001,251,107,0,107,0,0,107
BORSOD-ABAÚJ-ZEMPLÉN,Hernádnémeti,001,939,318,0,318,0,4,314
BORSOD-ABAÚJ-ZEMPLÉN,Hernádnémeti,002,895,320,0,320,0,2,318
BORSOD-ABAÚJ-ZEMPLÉN,Hernádnémeti,003,925,348,0,348,0,3,345
BORSOD-ABAÚJ-ZEMPLÉN,Hernádpetri,001,157,48,0,48,0,0,48
BORSOD-ABAÚJ-ZEMPLÉN,Hernádszentandrás,001,311,81,0,81,0,3,78
BORSOD-ABAÚJ-ZEMPLÉN,Hernádszurdok,001,131,67,0,67,0,1,66
BORSOD-ABAÚJ-ZEMPLÉN,Hernádvécse,001,683,181,0,181,0,0,181
BORSOD-ABAÚJ-ZEMPLÉN,Hét,001,403,130,0,130,0,0,130
BORSOD-ABAÚJ-ZEMPLÉN,Hidasnémeti,001,776,304,0,304,0,2,302
BORSOD-ABAÚJ-ZEMPLÉN,Hidvégardó,001,460,215,0,215,0,2,213
BORSOD-ABAÚJ-ZEMPLÉN,Hollóháza,001,709,286,0,284,-2,2,282
BORSOD-ABAÚJ-ZEMPLÉN,Homrogd,001,704,212,0,212,0,0,212
BORSOD-ABAÚJ-ZEMPLÉN,Igrici,001,889,336,0,336,0,4,332
BORSOD-ABAÚJ-ZEMPLÉN,Imola,001,95,54,0,54,0,1,53
BORSOD-ABAÚJ-ZEMPLÉN,Ináncs,001,936,319,0,319,0,2,317
BORSOD-ABAÚJ-ZEMPLÉN,Irota,001,69,51,0,51,0,0,51
BORSOD-ABAÚJ-ZEMPLÉN,Izsófalva,001,671,213,0,213,0,3,210
BORSOD-ABAÚJ-ZEMPLÉN,Izsófalva,002,630,202,0,202,0,1,201
BORSOD-ABAÚJ-ZEMPLÉN,Jákfalva,001,384,131,0,131,0,1,130
BORSOD-ABAÚJ-ZEMPLÉN,Járdánháza,001,742,213,0,212,-1,1,211
BORSOD-ABAÚJ-ZEMPLÉN,Járdánháza,002,619,174,0,174,0,0,174
BORSOD-ABAÚJ-ZEMPLÉN,Jósvafõ,001,224,101,0,101,0,0,101
BORSOD-ABAÚJ-ZEMPLÉN,Karcsa,001,714,171,0,171,0,1,170
BORSOD-ABAÚJ-ZEMPLÉN,Karcsa,002,705,239,0,239,0,0,239
BORSOD-ABAÚJ-ZEMPLÉN,Karos,001,399,111,0,111,0,0,111
BORSOD-ABAÚJ-ZEMPLÉN,Kazincbarcika,001,682,341,0,341,0,1,340
BORSOD-ABAÚJ-ZEMPLÉN,Kazincbarcika,002,687,322,0,322,0,2,320
BORSOD-ABAÚJ-ZEMPLÉN,Kazincbarcika,003,756,213,0,213,0,1,212
BORSOD-ABAÚJ-ZEMPLÉN,Kazincbarcika,004,607,225,0,225,0,1,224
BORSOD-ABAÚJ-ZEMPLÉN,Kazincbarcika,005,942,443,1,441,-2,1,440
BORSOD-ABAÚJ-ZEMPLÉN,Kazincbarcika,006,778,302,0,302,0,1,301
BORSOD-ABAÚJ-ZEMPLÉN,Kazincbarcika,007,722,199,0,199,0,0,199
BORSOD-ABAÚJ-ZEMPLÉN,Kazincbarcika,008,554,137,0,137,0,1,136
BORSOD-ABAÚJ-ZEMPLÉN,Kazincbarcika,009,754,166,0,166,0,2,164
BORSOD-ABAÚJ-ZEMPLÉN,Kazincbarcika,010,1028,287,0,287,0,2,285
BORSOD-ABAÚJ-ZEMPLÉN,Kazincbarcika,011,629,286,0,286,0,0,286
BORSOD-ABAÚJ-ZEMPLÉN,Kazincbarcika,012,581,213,0,212,-1,0,212
BORSOD-ABAÚJ-ZEMPLÉN,Kazincbarcika,013,793,321,0,321,0,1,320
BORSOD-ABAÚJ-ZEMPLÉN,Kazincbarcika,014,566,261,0,261,0,3,258
BORSOD-ABAÚJ-ZEMPLÉN,Kazincbarcika,015,787,322,0,322,0,0,322
BORSOD-ABAÚJ-ZEMPLÉN,Kazincbarcika,016,979,346,0,346,0,2,344
BORSOD-ABAÚJ-ZEMPLÉN,Kazincbarcika,017,750,240,0,240,0,4,236
BORSOD-ABAÚJ-ZEMPLÉN,Kazincbarcika,018,934,302,0,303,1,10,293
BORSOD-ABAÚJ-ZEMPLÉN,Kazincbarcika,019,851,308,0,308,0,1,307
BORSOD-ABAÚJ-ZEMPLÉN,Kazincbarcika,020,783,265,0,265,0,0,265
BORSOD-ABAÚJ-ZEMPLÉN,Kazincbarcika,021,629,212,0,212,0,1,211
BORSOD-ABAÚJ-ZEMPLÉN,Kazincbarcika,022,559,187,0,187,0,0,187
BORSOD-ABAÚJ-ZEMPLÉN,Kazincbarcika,023,979,313,0,313,0,0,313
BORSOD-ABAÚJ-ZEMPLÉN,Kazincbarcika,024,944,307,3,304,-3,3,301
BORSOD-ABAÚJ-ZEMPLÉN,Kazincbarcika,025,873,315,1,315,0,1,314
BORSOD-ABAÚJ-ZEMPLÉN,Kazincbarcika,026,729,273,0,273,0,1,272
BORSOD-ABAÚJ-ZEMPLÉN,Kazincbarcika,027,575,212,0,212,0,1,211
BORSOD-ABAÚJ-ZEMPLÉN,Kazincbarcika,028,657,256,0,256,0,1,255
BORSOD-ABAÚJ-ZEMPLÉN,Kazincbarcika,029,675,250,0,250,0,2,248
BORSOD-ABAÚJ-ZEMPLÉN,Kazincbarcika,030,796,253,0,253,0,1,252
BORSOD-ABAÚJ-ZEMPLÉN,Kács,001,433,216,0,216,0,2,214
BORSOD-ABAÚJ-ZEMPLÉN,Kánó,001,142,83,0,83,0,1,82
BORSOD-ABAÚJ-ZEMPLÉN,Kány,001,49,18,0,18,0,0,18
BORSOD-ABAÚJ-ZEMPLÉN,Kázsmárk,001,710,199,0,199,0,1,198
BORSOD-ABAÚJ-ZEMPLÉN,Kelemér,001,361,123,0,123,0,0,123
BORSOD-ABAÚJ-ZEMPLÉN,Kenézlõ,001,982,277,0,277,0,3,274
BORSOD-ABAÚJ-ZEMPLÉN,Keresztéte,001,28,14,0,14,0,0,14
BORSOD-ABAÚJ-ZEMPLÉN,Kesznyéten,001,622,219,0,218,-1,0,218
BORSOD-ABAÚJ-ZEMPLÉN,Kesznyéten,002,655,212,0,212,0,3,209
BORSOD-ABAÚJ-ZEMPLÉN,Kéked,001,131,56,0,56,0,1,55
BORSOD-ABAÚJ-ZEMPLÉN,Királd,001,143,54,0,54,0,0,54
BORSOD-ABAÚJ-ZEMPLÉN,Királd,002,513,161,0,161,0,0,161
BORSOD-ABAÚJ-ZEMPLÉN,Kiscsécs,001,138,74,0,74,0,0,74
BORSOD-ABAÚJ-ZEMPLÉN,Kisgyõr,001,648,261,1,261,0,3,258
BORSOD-ABAÚJ-ZEMPLÉN,Kisgyõr,002,630,223,0,223,0,2,221
BORSOD-ABAÚJ-ZEMPLÉN,Kishuta,001,272,121,0,121,0,3,118
BORSOD-ABAÚJ-ZEMPLÉN,Kiskinizs,001,268,137,0,137,0,2,135
BORSOD-ABAÚJ-ZEMPLÉN,Kisrozvágy,001,156,66,0,66,0,3,63
BORSOD-ABAÚJ-ZEMPLÉN,Kissikátor,001,249,132,0,132,0,2,130
BORSOD-ABAÚJ-ZEMPLÉN,Kistokaj,001,848,336,0,336,0,0,336
BORSOD-ABAÚJ-ZEMPLÉN,Kistokaj,002,885,345,0,344,-1,0,344
BORSOD-ABAÚJ-ZEMPLÉN,Komjáti,001,173,81,0,81,0,2,79
BORSOD-ABAÚJ-ZEMPLÉN,Komlóska,001,223,121,0,121,0,1,120
BORSOD-ABAÚJ-ZEMPLÉN,Kondó,001,495,183,0,183,0,1,182
BORSOD-ABAÚJ-ZEMPLÉN,Korlát,001,242,119,0,119,0,2,117
BORSOD-ABAÚJ-ZEMPLÉN,Kovácsvágás,001,476,109,0,109,0,0,109
BORSOD-ABAÚJ-ZEMPLÉN,Köröm,001,921,424,0,424,0,8,416
BORSOD-ABAÚJ-ZEMPLÉN,Krasznokvajda,001,375,118,0,118,0,0,118
BORSOD-ABAÚJ-ZEMPLÉN,Kupa,001,135,78,0,78,0,1,77
BORSOD-ABAÚJ-ZEMPLÉN,Kurityán,001,524,167,0,167,0,0,167
BORSOD-ABAÚJ-ZEMPLÉN,Kurityán,002,731,254,0,254,0,1,253
BORSOD-ABAÚJ-ZEMPLÉN,Lak,001,455,249,1,248,-1,0,248
BORSOD-ABAÚJ-ZEMPLÉN,Lácacséke,001,201,43,0,43,0,1,42
BORSOD-ABAÚJ-ZEMPLÉN,Ládbesenyõ,001,212,94,0,94,0,0,94
BORSOD-ABAÚJ-ZEMPLÉN,Legyesbénye,001,1199,403,0,403,0,5,398
BORSOD-ABAÚJ-ZEMPLÉN,Léh,001,353,124,0,124,0,0,124
BORSOD-ABAÚJ-ZEMPLÉN,Lénárddaróc,001,223,97,0,97,0,0,97
BORSOD-ABAÚJ-ZEMPLÉN,Litka,001,42,25,0,25,0,2,23
BORSOD-ABAÚJ-ZEMPLÉN,Makkoshotyka,001,681,169,0,169,0,2,167
BORSOD-ABAÚJ-ZEMPLÉN,Martonyi,001,324,115,0,115,0,0,115
BORSOD-ABAÚJ-ZEMPLÉN,Mád,001,966,448,0,448,0,4,444
BORSOD-ABAÚJ-ZEMPLÉN,Mád,002,837,357,0,357,0,0,357
BORSOD-ABAÚJ-ZEMPLÉN,Mályi,001,806,255,0,255,0,0,255
BORSOD-ABAÚJ-ZEMPLÉN,Mályi,002,740,276,0,275,-1,0,275
BORSOD-ABAÚJ-ZEMPLÉN,Mályi,003,665,287,0,287,0,0,287
BORSOD-ABAÚJ-ZEMPLÉN,Mályi,004,646,298,0,298,0,2,296
BORSOD-ABAÚJ-ZEMPLÉN,Mályi,005,628,268,0,269,1,9,260
BORSOD-ABAÚJ-ZEMPLÉN,Mályinka,001,406,164,0,164,0,2,162
BORSOD-ABAÚJ-ZEMPLÉN,Megyaszó,001,649,164,0,164,0,2,162
BORSOD-ABAÚJ-ZEMPLÉN,Megyaszó,002,630,210,0,210,0,1,209
BORSOD-ABAÚJ-ZEMPLÉN,Megyaszó,003,660,229,0,229,0,1,228
BORSOD-ABAÚJ-ZEMPLÉN,Meszes,001,143,78,0,78,0,0,78
BORSOD-ABAÚJ-ZEMPLÉN,Mezõcsát,001,987,327,0,327,0,2,325
BORSOD-ABAÚJ-ZEMPLÉN,Mezõcsát,002,912,355,0,355,0,3,352
BORSOD-ABAÚJ-ZEMPLÉN,Mezõcsát,003,986,351,0,351,0,1,350
BORSOD-ABAÚJ-ZEMPLÉN,Mezõcsát,004,842,289,1,288,-1,3,285
BORSOD-ABAÚJ-ZEMPLÉN,Mezõcsát,005,955,342,0,342,0,2,340
BORSOD-ABAÚJ-ZEMPLÉN,Mezõkeresztes,001,599,191,0,191,0,2,189
BORSOD-ABAÚJ-ZEMPLÉN,Mezõkeresztes,002,579,218,0,218,0,2,216
BORSOD-ABAÚJ-ZEMPLÉN,Mezõkeresztes,003,598,232,0,232,0,1,231
BORSOD-ABAÚJ-ZEMPLÉN,Mezõkeresztes,004,573,181,0,181,0,3,178
BORSOD-ABAÚJ-ZEMPLÉN,Mezõkeresztes,005,625,188,0,188,0,1,187
BORSOD-ABAÚJ-ZEMPLÉN,Mezõkövesd,001,925,490,0,490,0,4,486
BORSOD-ABAÚJ-ZEMPLÉN,Mezõkövesd,002,836,424,0,424,0,6,418
BORSOD-ABAÚJ-ZEMPLÉN,Mezõkövesd,003,841,421,0,421,0,0,421
BORSOD-ABAÚJ-ZEMPLÉN,Mezõkövesd,004,1009,452,0,451,-1,1,450
BORSOD-ABAÚJ-ZEMPLÉN,Mezõkövesd,005,908,259,0,259,0,1,258
BORSOD-ABAÚJ-ZEMPLÉN,Mezõkövesd,006,829,296,0,296,0,0,296
BORSOD-ABAÚJ-ZEMPLÉN,Mezõkövesd,007,779,365,0,365,0,2,363
BORSOD-ABAÚJ-ZEMPLÉN,Mezõkövesd,008,807,402,0,402,0,5,397
BORSOD-ABAÚJ-ZEMPLÉN,Mezõkövesd,009,771,413,0,413,0,1,412
BORSOD-ABAÚJ-ZEMPLÉN,Mezõkövesd,010,1024,466,0,466,0,2,464
BORSOD-ABAÚJ-ZEMPLÉN,Mezõkövesd,011,921,356,0,356,0,1,355
BORSOD-ABAÚJ-ZEMPLÉN,Mezõkövesd,012,723,343,0,343,0,1,342
BORSOD-ABAÚJ-ZEMPLÉN,Mezõkövesd,013,827,373,0,373,0,1,372
BORSOD-ABAÚJ-ZEMPLÉN,Mezõkövesd,014,657,297,0,297,0,0,297
BORSOD-ABAÚJ-ZEMPLÉN,Mezõkövesd,015,790,407,0,407,0,3,404
BORSOD-ABAÚJ-ZEMPLÉN,Mezõkövesd,016,771,369,0,369,0,4,365
BORSOD-ABAÚJ-ZEMPLÉN,Mezõnagymihály,001,843,351,0,351,0,5,346
BORSOD-ABAÚJ-ZEMPLÉN,Mezõnyárád,001,686,276,0,276,0,1,275
BORSOD-ABAÚJ-ZEMPLÉN,Mezõnyárád,002,632,237,1,236,-1,3,233
BORSOD-ABAÚJ-ZEMPLÉN,Mezõzombor,001,952,293,0,293,0,5,288
BORSOD-ABAÚJ-ZEMPLÉN,Mezõzombor,002,821,225,0,225,0,0,225
BORSOD-ABAÚJ-ZEMPLÉN,Méra,001,623,144,0,144,0,2,142
BORSOD-ABAÚJ-ZEMPLÉN,Méra,002,628,200,0,200,0,0,200
BORSOD-ABAÚJ-ZEMPLÉN,Mikóháza,001,431,197,0,197,0,0,197
BORSOD-ABAÚJ-ZEMPLÉN,Miskolc,001,623,152,0,152,0,0,152
BORSOD-ABAÚJ-ZEMPLÉN,Miskolc,002,635,157,0,158,1,10,148
BORSOD-ABAÚJ-ZEMPLÉN,Miskolc,003,623,294,0,294,0,2,292
BORSOD-ABAÚJ-ZEMPLÉN,Miskolc,004,605,260,0,260,0,0,260
BORSOD-ABAÚJ-ZEMPLÉN,Miskolc,005,575,240,0,240,0,0,240
BORSOD-ABAÚJ-ZEMPLÉN,Miskolc,006,638,328,0,328,0,1,327
BORSOD-ABAÚJ-ZEMPLÉN,Miskolc,007,692,351,0,351,0,2,349
BORSOD-ABAÚJ-ZEMPLÉN,Miskolc,008,814,426,0,426,0,1,425
BORSOD-ABAÚJ-ZEMPLÉN,Miskolc,009,742,245,0,245,0,2,243
BORSOD-ABAÚJ-ZEMPLÉN,Miskolc,010,701,380,1,379,-1,1,378
BORSOD-ABAÚJ-ZEMPLÉN,Miskolc,011,915,415,0,415,0,1,414
BORSOD-ABAÚJ-ZEMPLÉN,Miskolc,012,704,338,0,338,0,2,336
BORSOD-ABAÚJ-ZEMPLÉN,Miskolc,013,797,308,0,308,0,1,307
BORSOD-ABAÚJ-ZEMPLÉN,Miskolc,014,927,440,0,440,0,3,437
BORSOD-ABAÚJ-ZEMPLÉN,Miskolc,015,933,522,0,522,0,0,522
BORSOD-ABAÚJ-ZEMPLÉN,Miskolc,016,1023,454,0,454,0,1,453
BORSOD-ABAÚJ-ZEMPLÉN,Miskolc,017,1089,569,0,566,-3,2,564
BORSOD-ABAÚJ-ZEMPLÉN,Miskolc,018,1127,503,0,503,0,2,501
BORSOD-ABAÚJ-ZEMPLÉN,Miskolc,019,683,244,0,244,0,3,241
BORSOD-ABAÚJ-ZEMPLÉN,Miskolc,020,908,409,0,408,-1,2,406
BORSOD-ABAÚJ-ZEMPLÉN,Miskolc,021,832,391,0,391,0,0,391
BORSOD-ABAÚJ-ZEMPLÉN,Miskolc,022,753,424,0,424,0,2,422
BORSOD-ABAÚJ-ZEMPLÉN,Miskolc,023,780,352,0,352,0,1,351
BORSOD-ABAÚJ-ZEMPLÉN,Miskolc,024,825,418,0,418,0,2,416
BORSOD-ABAÚJ-ZEMPLÉN,Miskolc,025,660,287,0,287,0,0,287
BORSOD-ABAÚJ-ZEMPLÉN,Miskolc,026,1034,570,0,570,0,1,569
BORSOD-ABAÚJ-ZEMPLÉN,Miskolc,027,1163,605,0,605,0,2,603
BORSOD-ABAÚJ-ZEMPLÉN,Miskolc,028,819,407,0,407,0,0,407
BORSOD-ABAÚJ-ZEMPLÉN,Miskolc,029,633,357,0,357,0,1,356
BORSOD-ABAÚJ-ZEMPLÉN,Miskolc,030,709,310,0,310,0,2,308
BORSOD-ABAÚJ-ZEMPLÉN,Miskolc,031,521,148,0,148,0,2,146
BORSOD-ABAÚJ-ZEMPLÉN,Miskolc,032,984,476,0,476,0,3,473
BORSOD-ABAÚJ-ZEMPLÉN,Miskolc,033,774,267,0,267,0,0,267
BORSOD-ABAÚJ-ZEMPLÉN,Miskolc,034,882,305,0,305,0,1,304
BORSOD-ABAÚJ-ZEMPLÉN,Miskolc,035,1008,304,0,304,0,2,302
BORSOD-ABAÚJ-ZEMPLÉN,Miskolc,036,983,382,0,382,0,2,380
BORSOD-ABAÚJ-ZEMPLÉN,Miskolc,037,901,341,0,341,0,1,340
BORSOD-ABAÚJ-ZEMPLÉN,Miskolc,038,773,276,0,276,0,0,276
BORSOD-ABAÚJ-ZEMPLÉN,Miskolc,039,951,328,0,328,0,4,324
BORSOD-ABAÚJ-ZEMPLÉN,Miskolc,040,915,332,0,332,0,0,332
BORSOD-ABAÚJ-ZEMPLÉN,Miskolc,041,774,214,0,214,0,0,214
BORSOD-ABAÚJ-ZEMPLÉN,Miskolc,042,891,308,0,308,0,0,308
BORSOD-ABAÚJ-ZEMPLÉN,Miskolc,043,792,286,0,286,0,0,286
BORSOD-ABAÚJ-ZEMPLÉN,Miskolc,044,949,289,0,289,0,2,287
BORSOD-ABAÚJ-ZEMPLÉN,Miskolc,045,875,282,0,282,0,4,278
BORSOD-ABAÚJ-ZEMPLÉN,Miskolc,046,1048,343,0,343,0,1,342
BORSOD-ABAÚJ-ZEMPLÉN,Miskolc,047,936,337,0,337,0,3,334
BORSOD-ABAÚJ-ZEMPLÉN,Miskolc,048,846,352,0,352,0,1,351
BORSOD-ABAÚJ-ZEMPLÉN,Miskolc,049,892,307,0,307,0,2,305
BORSOD-ABAÚJ-ZEMPLÉN,Miskolc,050,758,355,0,355,0,1,354
BORSOD-ABAÚJ-ZEMPLÉN,Miskolc,051,669,281,0,281,0,0,281
BORSOD-ABAÚJ-ZEMPLÉN,Miskolc,052,658,243,0,243,0,1,242
BORSOD-ABAÚJ-ZEMPLÉN,Miskolc,053,907,397,0,397,0,3,394
BORSOD-ABAÚJ-ZEMPLÉN,Miskolc,054,928,411,0,411,0,0,411
BORSOD-ABAÚJ-ZEMPLÉN,Miskolc,055,648,427,0,427,0,0,427
BORSOD-ABAÚJ-ZEMPLÉN,Miskolc,056,633,394,0,394,0,0,394
BORSOD-ABAÚJ-ZEMPLÉN,Miskolc,057,905,350,0,350,0,0,350
BORSOD-ABAÚJ-ZEMPLÉN,Miskolc,058,697,250,0,250,0,1,249
BORSOD-ABAÚJ-ZEMPLÉN,Miskolc,059,615,334,0,334,0,1,333
BORSOD-ABAÚJ-ZEMPLÉN,Miskolc,060,646,409,0,409,0,0,409
BORSOD-ABAÚJ-ZEMPLÉN,Miskolc,061,594,378,0,378,0,0,378
BORSOD-ABAÚJ-ZEMPLÉN,Miskolc,062,761,378,0,378,0,6,372
BORSOD-ABAÚJ-ZEMPLÉN,Miskolc,063,721,291,0,291,0,0,291
BORSOD-ABAÚJ-ZEMPLÉN,Miskolc,064,881,409,0,409,0,1,408
BORSOD-ABAÚJ-ZEMPLÉN,Miskolc,065,793,307,0,307,0,1,306
BORSOD-ABAÚJ-ZEMPLÉN,Miskolc,066,813,327,0,327,0,1,326
BORSOD-ABAÚJ-ZEMPLÉN,Miskolc,067,636,277,0,277,0,0,277
BORSOD-ABAÚJ-ZEMPLÉN,Miskolc,068,779,317,0,317,0,0,317
BORSOD-ABAÚJ-ZEMPLÉN,Miskolc,069,749,379,0,379,0,0,379
BORSOD-ABAÚJ-ZEMPLÉN,Miskolc,070,722,373,0,373,0,1,372
BORSOD-ABAÚJ-ZEMPLÉN,Miskolc,071,627,271,0,271,0,0,271
BORSOD-ABAÚJ-ZEMPLÉN,Miskolc,072,735,355,0,355,0,3,352
BORSOD-ABAÚJ-ZEMPLÉN,Miskolc,073,679,340,1,339,-1,2,337
BORSOD-ABAÚJ-ZEMPLÉN,Miskolc,074,876,324,0,324,0,5,319
BORSOD-ABAÚJ-ZEMPLÉN,Miskolc,075,752,281,0,281,0,0,281
BORSOD-ABAÚJ-ZEMPLÉN,Miskolc,076,822,451,0,451,0,0,451
BORSOD-ABAÚJ-ZEMPLÉN,Miskolc,077,704,300,0,300,0,1,299
BORSOD-ABAÚJ-ZEMPLÉN,Miskolc,078,618,358,0,358,0,3,355
BORSOD-ABAÚJ-ZEMPLÉN,Miskolc,079,562,257,0,257,0,0,257
BORSOD-ABAÚJ-ZEMPLÉN,Miskolc,080,665,256,0,256,0,1,255
BORSOD-ABAÚJ-ZEMPLÉN,Miskolc,081,918,402,0,402,0,2,400
BORSOD-ABAÚJ-ZEMPLÉN,Miskolc,082,941,468,0,468,0,1,467
BORSOD-ABAÚJ-ZEMPLÉN,Miskolc,083,624,366,1,365,-1,2,363
BORSOD-ABAÚJ-ZEMPLÉN,Miskolc,084,752,353,0,353,0,2,351
BORSOD-ABAÚJ-ZEMPLÉN,Miskolc,085,669,337,0,337,0,1,336
BORSOD-ABAÚJ-ZEMPLÉN,Miskolc,086,1099,546,0,547,1,11,536
BORSOD-ABAÚJ-ZEMPLÉN,Miskolc,087,613,281,0,281,0,2,279
BORSOD-ABAÚJ-ZEMPLÉN,Miskolc,088,697,354,0,354,0,1,353
BORSOD-ABAÚJ-ZEMPLÉN,Miskolc,089,844,436,1,435,-1,2,433
BORSOD-ABAÚJ-ZEMPLÉN,Miskolc,090,629,211,0,211,0,3,208
BORSOD-ABAÚJ-ZEMPLÉN,Miskolc,091,881,447,0,447,0,1,446
BORSOD-ABAÚJ-ZEMPLÉN,Miskolc,092,626,235,0,235,0,6,229
BORSOD-ABAÚJ-ZEMPLÉN,Miskolc,093,555,253,0,253,0,2,251
BORSOD-ABAÚJ-ZEMPLÉN,Miskolc,094,678,215,0,215,0,0,215
BORSOD-ABAÚJ-ZEMPLÉN,Miskolc,095,609,207,0,207,0,0,207
BORSOD-ABAÚJ-ZEMPLÉN,Miskolc,096,1897,1072,0,1073,1,13,1060
BORSOD-ABAÚJ-ZEMPLÉN,Miskolc,097,662,281,0,281,0,2,279
BORSOD-ABAÚJ-ZEMPLÉN,Miskolc,098,718,301,0,301,0,1,300
BORSOD-ABAÚJ-ZEMPLÉN,Miskolc,099,660,312,0,312,0,2,310
BORSOD-ABAÚJ-ZEMPLÉN,Miskolc,100,620,247,0,247,0,0,247
BORSOD-ABAÚJ-ZEMPLÉN,Miskolc,101,806,361,0,361,0,0,361
BORSOD-ABAÚJ-ZEMPLÉN,Miskolc,102,671,290,0,290,0,0,290
BORSOD-ABAÚJ-ZEMPLÉN,Miskolc,103,885,360,0,360,0,0,360
BORSOD-ABAÚJ-ZEMPLÉN,Miskolc,104,940,414,0,414,0,1,413
BORSOD-ABAÚJ-ZEMPLÉN,Miskolc,105,1134,546,0,546,0,3,543
BORSOD-ABAÚJ-ZEMPLÉN,Miskolc,106,1085,533,0,533,0,4,529
BORSOD-ABAÚJ-ZEMPLÉN,Miskolc,107,898,418,0,418,0,1,417
BORSOD-ABAÚJ-ZEMPLÉN,Miskolc,108,722,293,0,293,0,1,292
BORSOD-ABAÚJ-ZEMPLÉN,Miskolc,109,646,259,0,259,0,1,258
BORSOD-ABAÚJ-ZEMPLÉN,Miskolc,110,697,314,0,313,-1,4,309
BORSOD-ABAÚJ-ZEMPLÉN,Miskolc,111,725,361,0,361,0,2,359
BORSOD-ABAÚJ-ZEMPLÉN,Miskolc,112,723,369,0,369,0,1,368
BORSOD-ABAÚJ-ZEMPLÉN,Miskolc,113,620,336,0,336,0,0,336
BORSOD-ABAÚJ-ZEMPLÉN,Miskolc,114,619,309,0,309,0,1,308
BORSOD-ABAÚJ-ZEMPLÉN,Miskolc,115,709,339,0,339,0,1,338
BORSOD-ABAÚJ-ZEMPLÉN,Miskolc,116,620,292,0,292,0,0,292
BORSOD-ABAÚJ-ZEMPLÉN,Miskolc,117,960,366,1,361,-5,1,360
BORSOD-ABAÚJ-ZEMPLÉN,Miskolc,118,1305,421,0,420,-1,18,402
BORSOD-ABAÚJ-ZEMPLÉN,Miskolc,119,645,258,0,258,0,3,255
BORSOD-ABAÚJ-ZEMPLÉN,Miskolc,120,836,318,0,318,0,3,315
BORSOD-ABAÚJ-ZEMPLÉN,Miskolc,121,831,429,0,429,0,1,428
BORSOD-ABAÚJ-ZEMPLÉN,Miskolc,122,667,258,0,258,0,0,258
BORSOD-ABAÚJ-ZEMPLÉN,Miskolc,123,916,255,0,255,0,1,254
BORSOD-ABAÚJ-ZEMPLÉN,Miskolc,124,920,394,0,394,0,0,394
BORSOD-ABAÚJ-ZEMPLÉN,Miskolc,125,983,456,0,456,0,3,453
BORSOD-ABAÚJ-ZEMPLÉN,Miskolc,126,1013,501,0,501,0,1,500
BORSOD-ABAÚJ-ZEMPLÉN,Miskolc,127,1101,315,0,315,0,0,315
BORSOD-ABAÚJ-ZEMPLÉN,Miskolc,128,1068,365,1,365,0,13,352
BORSOD-ABAÚJ-ZEMPLÉN,Miskolc,129,455,223,0,223,0,1,222
BORSOD-ABAÚJ-ZEMPLÉN,Miskolc,130,703,269,0,269,0,3,266
BORSOD-ABAÚJ-ZEMPLÉN,Miskolc,131,646,342,1,340,-2,3,337
BORSOD-ABAÚJ-ZEMPLÉN,Miskolc,132,666,319,0,319,0,4,315
BORSOD-ABAÚJ-ZEMPLÉN,Miskolc,133,990,393,0,393,0,1,392
BORSOD-ABAÚJ-ZEMPLÉN,Miskolc,134,851,452,0,452,0,1,451
BORSOD-ABAÚJ-ZEMPLÉN,Miskolc,135,783,398,0,398,0,3,395
BORSOD-ABAÚJ-ZEMPLÉN,Miskolc,136,875,440,0,440,0,2,438
BORSOD-ABAÚJ-ZEMPLÉN,Miskolc,137,885,448,0,448,0,1,447
BORSOD-ABAÚJ-ZEMPLÉN,Miskolc,138,940,434,0,432,-2,3,429
BORSOD-ABAÚJ-ZEMPLÉN,Miskolc,139,637,248,0,248,0,3,245
BORSOD-ABAÚJ-ZEMPLÉN,Miskolc,140,638,253,0,253,0,3,250
BORSOD-ABAÚJ-ZEMPLÉN,Miskolc,141,754,288,0,288,0,2,286
BORSOD-ABAÚJ-ZEMPLÉN,Miskolc,142,741,265,0,265,0,0,265
BORSOD-ABAÚJ-ZEMPLÉN,Miskolc,143,663,260,0,260,0,0,260
BORSOD-ABAÚJ-ZEMPLÉN,Miskolc,144,633,253,0,253,0,4,249
BORSOD-ABAÚJ-ZEMPLÉN,Miskolc,145,712,354,0,354,0,3,351
BORSOD-ABAÚJ-ZEMPLÉN,Miskolc,146,1177,486,0,486,0,2,484
BORSOD-ABAÚJ-ZEMPLÉN,Miskolc,147,1027,395,0,395,0,1,394
BORSOD-ABAÚJ-ZEMPLÉN,Miskolc,148,1097,437,0,436,-1,1,435
BORSOD-ABAÚJ-ZEMPLÉN,Miskolc,149,852,419,0,418,-1,3,415
BORSOD-ABAÚJ-ZEMPLÉN,Miskolc,150,897,423,0,423,0,1,422
BORSOD-ABAÚJ-ZEMPLÉN,Miskolc,151,766,348,0,348,0,2,346
BORSOD-ABAÚJ-ZEMPLÉN,Miskolc,152,880,377,0,377,0,0,377
BORSOD-ABAÚJ-ZEMPLÉN,Miskolc,153,982,465,0,464,-1,1,463
BORSOD-ABAÚJ-ZEMPLÉN,Miskolc,154,838,474,0,474,0,2,472
BORSOD-ABAÚJ-ZEMPLÉN,Miskolc,155,389,183,0,183,0,1,182
BORSOD-ABAÚJ-ZEMPLÉN,Miskolc,156,732,362,0,364,2,18,346
BORSOD-ABAÚJ-ZEMPLÉN,Miskolc,157,686,364,0,364,0,0,364
BORSOD-ABAÚJ-ZEMPLÉN,Miskolc,158,649,354,0,354,0,1,353
BORSOD-ABAÚJ-ZEMPLÉN,Miskolc,159,713,347,0,346,-1,1,345
BORSOD-ABAÚJ-ZEMPLÉN,Miskolc,160,135,74,0,74,0,1,73
BORSOD-ABAÚJ-ZEMPLÉN,Mogyoróska,001,69,41,0,41,0,0,41
BORSOD-ABAÚJ-ZEMPLÉN,Monaj,001,191,55,0,55,0,0,55
BORSOD-ABAÚJ-ZEMPLÉN,Monok,001,610,246,0,246,0,0,246
BORSOD-ABAÚJ-ZEMPLÉN,Monok,002,585,270,0,270,0,4,266
BORSOD-ABAÚJ-ZEMPLÉN,Muhi,001,405,183,0,183,0,0,183
BORSOD-ABAÚJ-ZEMPLÉN,Múcsony,001,831,311,0,311,0,0,311
BORSOD-ABAÚJ-ZEMPLÉN,Múcsony,002,759,223,0,223,0,2,221
BORSOD-ABAÚJ-ZEMPLÉN,Múcsony,003,809,227,0,227,0,2,225
BORSOD-ABAÚJ-ZEMPLÉN,Nagybarca,001,690,210,0,210,0,4,206
BORSOD-ABAÚJ-ZEMPLÉN,Nagycsécs,001,608,279,0,279,0,1,278
BORSOD-ABAÚJ-ZEMPLÉN,Nagyhuta,001,60,35,0,35,0,0,35
BORSOD-ABAÚJ-ZEMPLÉN,Nagykinizs,001,256,99,0,99,0,0,99
BORSOD-ABAÚJ-ZEMPLÉN,Nagyrozvágy,001,560,150,0,150,0,2,148
BORSOD-ABAÚJ-ZEMPLÉN,Nekézseny,001,585,210,0,210,0,1,209
BORSOD-ABAÚJ-ZEMPLÉN,Nemesbikk,001,725,287,0,287,0,4,283
BORSOD-ABAÚJ-ZEMPLÉN,Négyes,001,243,112,0,112,0,1,111
BORSOD-ABAÚJ-ZEMPLÉN,Novajidrány,001,1025,238,0,238,0,1,237
BORSOD-ABAÚJ-ZEMPLÉN,Nyékládháza,001,904,417,0,416,-1,3,413
BORSOD-ABAÚJ-ZEMPLÉN,Nyékládháza,002,768,326,0,326,0,1,325
BORSOD-ABAÚJ-ZEMPLÉN,Nyékládháza,003,795,303,0,303,0,1,302
BORSOD-ABAÚJ-ZEMPLÉN,Nyékládháza,004,781,331,0,331,0,2,329
BORSOD-ABAÚJ-ZEMPLÉN,Nyékládháza,005,932,341,0,341,0,4,337
BORSOD-ABAÚJ-ZEMPLÉN,Nyésta,001,26,16,0,16,0,0,16
BORSOD-ABAÚJ-ZEMPLÉN,Nyíri,001,302,137,0,137,0,0,137
BORSOD-ABAÚJ-ZEMPLÉN,Nyomár,001,244,89,1,88,-1,1,87
BORSOD-ABAÚJ-ZEMPLÉN,Olaszliszka,001,1256,381,0,381,0,1,380
BORSOD-ABAÚJ-ZEMPLÉN,Onga,001,727,220,0,220,0,2,218
BORSOD-ABAÚJ-ZEMPLÉN,Onga,002,870,228,0,228,0,4,224
BORSOD-ABAÚJ-ZEMPLÉN,Onga,003,912,382,0,382,0,0,382
BORSOD-ABAÚJ-ZEMPLÉN,Onga,004,906,408,0,408,0,1,407
BORSOD-ABAÚJ-ZEMPLÉN,Onga,005,169,60,0,60,0,0,60
BORSOD-ABAÚJ-ZEMPLÉN,Onga,006,104,31,0,31,0,0,31
BORSOD-ABAÚJ-ZEMPLÉN,Ormosbánya,001,616,147,0,147,0,0,147
BORSOD-ABAÚJ-ZEMPLÉN,Ormosbánya,002,581,203,0,203,0,0,203
BORSOD-ABAÚJ-ZEMPLÉN,Oszlár,001,305,119,0,119,0,0,119
BORSOD-ABAÚJ-ZEMPLÉN,Ónod,001,903,239,0,239,0,1,238
BORSOD-ABAÚJ-ZEMPLÉN,Ónod,002,933,258,0,258,0,2,256
BORSOD-ABAÚJ-ZEMPLÉN,Ózd,001,697,279,0,279,0,1,278
BORSOD-ABAÚJ-ZEMPLÉN,Ózd,002,869,280,0,280,0,1,279
BORSOD-ABAÚJ-ZEMPLÉN,Ózd,003,931,284,0,284,0,0,284
BORSOD-ABAÚJ-ZEMPLÉN,Ózd,004,1023,299,0,299,0,1,298
BORSOD-ABAÚJ-ZEMPLÉN,Ózd,005,867,282,0,282,0,0,282
BORSOD-ABAÚJ-ZEMPLÉN,Ózd,006,1275,432,0,432,0,1,431
BORSOD-ABAÚJ-ZEMPLÉN,Ózd,007,866,300,0,300,0,2,298
BORSOD-ABAÚJ-ZEMPLÉN,Ózd,008,769,218,0,218,0,2,216
BORSOD-ABAÚJ-ZEMPLÉN,Ózd,009,636,216,0,216,0,0,216
BORSOD-ABAÚJ-ZEMPLÉN,Ózd,010,745,173,0,173,0,0,173
BORSOD-ABAÚJ-ZEMPLÉN,Ózd,011,905,315,0,315,0,0,315
BORSOD-ABAÚJ-ZEMPLÉN,Ózd,012,943,389,0,389,0,2,387
BORSOD-ABAÚJ-ZEMPLÉN,Ózd,013,825,300,0,300,0,1,299
BORSOD-ABAÚJ-ZEMPLÉN,Ózd,014,792,271,0,271,0,3,268
BORSOD-ABAÚJ-ZEMPLÉN,Ózd,015,774,306,0,306,0,1,305
BORSOD-ABAÚJ-ZEMPLÉN,Ózd,016,683,338,0,338,0,0,338
BORSOD-ABAÚJ-ZEMPLÉN,Ózd,017,677,260,0,260,0,0,260
BORSOD-ABAÚJ-ZEMPLÉN,Ózd,018,322,113,0,113,0,2,111
BORSOD-ABAÚJ-ZEMPLÉN,Ózd,019,649,189,0,189,0,0,189
BORSOD-ABAÚJ-ZEMPLÉN,Ózd,020,693,207,0,207,0,0,207
BORSOD-ABAÚJ-ZEMPLÉN,Ózd,021,409,162,0,162,0,0,162
BORSOD-ABAÚJ-ZEMPLÉN,Ózd,022,204,99,0,99,0,0,99
BORSOD-ABAÚJ-ZEMPLÉN,Ózd,023,792,177,0,177,0,1,176
BORSOD-ABAÚJ-ZEMPLÉN,Ózd,024,840,200,0,200,0,0,200
BORSOD-ABAÚJ-ZEMPLÉN,Ózd,025,870,88,0,88,0,3,85
BORSOD-ABAÚJ-ZEMPLÉN,Ózd,026,750,159,0,159,0,3,156
BORSOD-ABAÚJ-ZEMPLÉN,Ózd,027,658,133,0,133,0,0,133
BORSOD-ABAÚJ-ZEMPLÉN,Ózd,028,740,173,0,173,0,2,171
BORSOD-ABAÚJ-ZEMPLÉN,Ózd,029,223,80,0,80,0,4,76
BORSOD-ABAÚJ-ZEMPLÉN,Ózd,030,196,69,0,69,0,0,69
BORSOD-ABAÚJ-ZEMPLÉN,Ózd,031,895,219,0,219,0,1,218
BORSOD-ABAÚJ-ZEMPLÉN,Ózd,032,937,285,0,285,0,4,281
BORSOD-ABAÚJ-ZEMPLÉN,Ózd,033,948,379,1,378,-1,3,375
BORSOD-ABAÚJ-ZEMPLÉN,Ózd,034,785,215,0,215,0,1,214
BORSOD-ABAÚJ-ZEMPLÉN,Ózd,035,955,209,0,209,0,1,208
BORSOD-ABAÚJ-ZEMPLÉN,Ózd,036,480,99,0,99,0,1,98
BORSOD-ABAÚJ-ZEMPLÉN,Ózd,037,278,51,0,51,0,1,50
BORSOD-ABAÚJ-ZEMPLÉN,Pamlény,001,38,19,0,19,0,0,19
BORSOD-ABAÚJ-ZEMPLÉN,Parasznya,001,957,321,0,321,0,1,320
BORSOD-ABAÚJ-ZEMPLÉN,Pácin,001,1136,271,0,271,0,1,270
BORSOD-ABAÚJ-ZEMPLÉN,Pálháza,001,902,343,0,343,0,6,337
BORSOD-ABAÚJ-ZEMPLÉN,Pányok,001,51,27,0,27,0,0,27
BORSOD-ABAÚJ-ZEMPLÉN,Pere,001,237,65,0,65,0,0,65
BORSOD-ABAÚJ-ZEMPLÉN,Perecse,001,23,14,0,14,0,0,14
BORSOD-ABAÚJ-ZEMPLÉN,Perkupa,001,655,227,1,226,-1,1,225
BORSOD-ABAÚJ-ZEMPLÉN,Prügy,001,915,320,0,320,0,2,318
BORSOD-ABAÚJ-ZEMPLÉN,Prügy,002,947,415,0,415,0,7,408
BORSOD-ABAÚJ-ZEMPLÉN,Pusztafalu,001,189,101,0,101,0,1,100
BORSOD-ABAÚJ-ZEMPLÉN,Pusztaradvány,001,146,42,0,42,0,1,41
BORSOD-ABAÚJ-ZEMPLÉN,Putnok,001,797,347,0,347,0,5,342
BORSOD-ABAÚJ-ZEMPLÉN,Putnok,002,642,171,0,171,0,5,166
BORSOD-ABAÚJ-ZEMPLÉN,Putnok,003,506,244,0,244,0,1,243
BORSOD-ABAÚJ-ZEMPLÉN,Putnok,004,687,301,0,301,0,2,299
BORSOD-ABAÚJ-ZEMPLÉN,Putnok,005,656,189,0,189,0,4,185
BORSOD-ABAÚJ-ZEMPLÉN,Putnok,006,790,369,0,369,0,5,364
BORSOD-ABAÚJ-ZEMPLÉN,Putnok,007,576,286,0,286,0,5,281
BORSOD-ABAÚJ-ZEMPLÉN,Putnok,008,302,126,0,126,0,3,123
BORSOD-ABAÚJ-ZEMPLÉN,Radostyán,001,477,163,0,163,0,0,163
BORSOD-ABAÚJ-ZEMPLÉN,Ragály,001,498,141,0,141,0,0,141
BORSOD-ABAÚJ-ZEMPLÉN,Rakaca,001,581,158,0,155,-3,11,144
BORSOD-ABAÚJ-ZEMPLÉN,Rakacaszend,001,258,126,0,126,0,1,125
BORSOD-ABAÚJ-ZEMPLÉN,Rásonysápberencs,001,413,140,0,140,0,0,140
BORSOD-ABAÚJ-ZEMPLÉN,Rátka,001,775,348,0,348,0,2,346
BORSOD-ABAÚJ-ZEMPLÉN,Regéc,001,76,49,0,49,0,0,49
BORSOD-ABAÚJ-ZEMPLÉN,Répáshuta,001,399,216,0,216,0,0,216
BORSOD-ABAÚJ-ZEMPLÉN,Révleányvár,001,385,122,0,122,0,1,121
BORSOD-ABAÚJ-ZEMPLÉN,Ricse,001,649,154,0,154,0,2,152
BORSOD-ABAÚJ-ZEMPLÉN,Ricse,002,632,143,0,143,0,1,142
BORSOD-ABAÚJ-ZEMPLÉN,Rudabánya,001,738,221,0,221,0,2,219
BORSOD-ABAÚJ-ZEMPLÉN,Rudabánya,002,647,165,0,165,0,0,165
BORSOD-ABAÚJ-ZEMPLÉN,Rudabánya,003,591,178,0,178,0,0,178
BORSOD-ABAÚJ-ZEMPLÉN,Rudolftelep,001,580,118,0,118,0,1,117
BORSOD-ABAÚJ-ZEMPLÉN,Sajóbábony,001,740,265,0,265,0,0,265
BORSOD-ABAÚJ-ZEMPLÉN,Sajóbábony,002,667,231,0,231,0,4,227
BORSOD-ABAÚJ-ZEMPLÉN,Sajóbábony,003,732,234,0,234,0,1,233
BORSOD-ABAÚJ-ZEMPLÉN,Sajóecseg,001,863,346,0,346,0,1,345
BORSOD-ABAÚJ-ZEMPLÉN,Sajógalgóc,001,288,115,0,115,0,1,114
BORSOD-ABAÚJ-ZEMPLÉN,Sajóhídvég,001,772,252,0,252,0,3,249
BORSOD-ABAÚJ-ZEMPLÉN,Sajóivánka,001,525,218,0,218,0,4,214
BORSOD-ABAÚJ-ZEMPLÉN,Sajókaza,001,772,187,0,187,0,2,185
BORSOD-ABAÚJ-ZEMPLÉN,Sajókaza,002,550,156,0,156,0,1,155
BORSOD-ABAÚJ-ZEMPLÉN,Sajókaza,003,853,251,0,251,0,7,244
BORSOD-ABAÚJ-ZEMPLÉN,Sajókápolna,001,338,146,0,146,0,3,143
BORSOD-ABAÚJ-ZEMPLÉN,Sajókeresztúr,001,1254,556,0,556,0,6,550
BORSOD-ABAÚJ-ZEMPLÉN,Sajólád,001,1114,408,0,408,0,2,406
BORSOD-ABAÚJ-ZEMPLÉN,Sajólád,002,1180,247,0,247,0,0,247
BORSOD-ABAÚJ-ZEMPLÉN,Sajólászlófalva,001,349,124,0,124,0,1,123
BORSOD-ABAÚJ-ZEMPLÉN,Sajómercse,001,171,62,0,62,0,2,60
BORSOD-ABAÚJ-ZEMPLÉN,Sajónémeti,001,359,114,0,114,0,0,114
BORSOD-ABAÚJ-ZEMPLÉN,Sajóörös,001,1152,505,0,505,0,1,504
BORSOD-ABAÚJ-ZEMPLÉN,Sajópálfala,001,607,252,0,252,0,3,249
BORSOD-ABAÚJ-ZEMPLÉN,Sajópetri,001,1160,363,0,363,0,3,360
BORSOD-ABAÚJ-ZEMPLÉN,Sajópüspöki,001,418,133,0,133,0,0,133
BORSOD-ABAÚJ-ZEMPLÉN,Sajósenye,001,295,141,0,141,0,2,139
BORSOD-ABAÚJ-ZEMPLÉN,Sajószentpéter,001,1133,433,0,433,0,6,427
BORSOD-ABAÚJ-ZEMPLÉN,Sajószentpéter,002,647,175,0,175,0,0,175
BORSOD-ABAÚJ-ZEMPLÉN,Sajószentpéter,003,696,246,1,245,-1,3,242
BORSOD-ABAÚJ-ZEMPLÉN,Sajószentpéter,004,1154,408,0,408,0,1,407
BORSOD-ABAÚJ-ZEMPLÉN,Sajószentpéter,005,1059,81,0,81,0,1,80
BORSOD-ABAÚJ-ZEMPLÉN,Sajószentpéter,006,285,112,0,112,0,1,111
BORSOD-ABAÚJ-ZEMPLÉN,Sajószentpéter,007,1053,359,0,359,0,2,357
BORSOD-ABAÚJ-ZEMPLÉN,Sajószentpéter,008,1069,361,0,361,0,0,361
BORSOD-ABAÚJ-ZEMPLÉN,Sajószentpéter,009,1296,394,0,394,0,2,392
BORSOD-ABAÚJ-ZEMPLÉN,Sajószentpéter,010,1332,408,0,408,0,3,405
BORSOD-ABAÚJ-ZEMPLÉN,Sajószöged,001,905,359,0,359,0,1,358
BORSOD-ABAÚJ-ZEMPLÉN,Sajószöged,002,968,396,0,396,0,1,395
BORSOD-ABAÚJ-ZEMPLÉN,Sajóvámos,001,876,346,1,345,-1,1,344
BORSOD-ABAÚJ-ZEMPLÉN,Sajóvámos,002,846,273,0,273,0,1,272
BORSOD-ABAÚJ-ZEMPLÉN,Sajóvelezd,001,619,210,0,210,0,1,209
BORSOD-ABAÚJ-ZEMPLÉN,Sály,001,1253,452,0,452,0,4,448
BORSOD-ABAÚJ-ZEMPLÉN,Sárazsadány,001,197,92,0,92,0,0,92
BORSOD-ABAÚJ-ZEMPLÉN,Sárospatak,001,755,347,0,347,0,0,347
BORSOD-ABAÚJ-ZEMPLÉN,Sárospatak,002,650,269,0,269,0,1,268
BORSOD-ABAÚJ-ZEMPLÉN,Sárospatak,003,669,297,0,297,0,1,296
BORSOD-ABAÚJ-ZEMPLÉN,Sárospatak,004,627,261,0,261,0,1,260
BORSOD-ABAÚJ-ZEMPLÉN,Sárospatak,005,716,282,0,282,0,2,280
BORSOD-ABAÚJ-ZEMPLÉN,Sárospatak,006,744,331,0,331,0,1,330
BORSOD-ABAÚJ-ZEMPLÉN,Sárospatak,007,780,302,0,302,0,1,301
BORSOD-ABAÚJ-ZEMPLÉN,Sárospatak,008,696,228,0,228,0,4,224
BORSOD-ABAÚJ-ZEMPLÉN,Sárospatak,009,611,244,0,244,0,2,242
BORSOD-ABAÚJ-ZEMPLÉN,Sárospatak,010,733,299,0,299,0,2,297
BORSOD-ABAÚJ-ZEMPLÉN,Sárospatak,011,664,265,0,265,0,2,263
BORSOD-ABAÚJ-ZEMPLÉN,Sárospatak,012,697,274,0,274,0,0,274
BORSOD-ABAÚJ-ZEMPLÉN,Sárospatak,013,450,189,0,189,0,0,189
BORSOD-ABAÚJ-ZEMPLÉN,Sárospatak,014,618,190,0,190,0,0,190
BORSOD-ABAÚJ-ZEMPLÉN,Sárospatak,015,198,44,0,44,0,2,42
BORSOD-ABAÚJ-ZEMPLÉN,Sárospatak,016,274,87,0,87,0,1,86
BORSOD-ABAÚJ-ZEMPLÉN,Sárospatak,017,121,54,0,54,0,1,53
BORSOD-ABAÚJ-ZEMPLÉN,Sáta,001,899,273,0,273,0,4,269
BORSOD-ABAÚJ-ZEMPLÉN,Sátoraljaújhely,001,444,164,0,164,0,1,163
BORSOD-ABAÚJ-ZEMPLÉN,Sátoraljaújhely,002,580,200,0,200,0,2,198
BORSOD-ABAÚJ-ZEMPLÉN,Sátoraljaújhely,003,607,223,0,223,0,1,222
BORSOD-ABAÚJ-ZEMPLÉN,Sátoraljaújhely,004,218,93,0,93,0,0,93
BORSOD-ABAÚJ-ZEMPLÉN,Sátoraljaújhely,005,640,305,0,305,0,1,304
BORSOD-ABAÚJ-ZEMPLÉN,Sátoraljaújhely,006,653,199,0,199,0,1,198
BORSOD-ABAÚJ-ZEMPLÉN,Sátoraljaújhely,007,726,239,0,239,0,3,236
BORSOD-ABAÚJ-ZEMPLÉN,Sátoraljaújhely,008,698,183,0,183,0,2,181
BORSOD-ABAÚJ-ZEMPLÉN,Sátoraljaújhely,009,861,369,0,369,0,1,368
BORSOD-ABAÚJ-ZEMPLÉN,Sátoraljaújhely,010,808,348,0,347,-1,3,344
BORSOD-ABAÚJ-ZEMPLÉN,Sátoraljaújhely,011,659,286,0,286,0,1,285
BORSOD-ABAÚJ-ZEMPLÉN,Sátoraljaújhely,012,795,321,0,321,0,1,320
BORSOD-ABAÚJ-ZEMPLÉN,Sátoraljaújhely,013,711,318,0,318,0,1,317
BORSOD-ABAÚJ-ZEMPLÉN,Sátoraljaújhely,014,734,285,0,285,0,3,282
BORSOD-ABAÚJ-ZEMPLÉN,Sátoraljaújhely,015,751,330,0,330,0,1,329
BORSOD-ABAÚJ-ZEMPLÉN,Sátoraljaújhely,016,699,306,0,306,0,6,300
BORSOD-ABAÚJ-ZEMPLÉN,Sátoraljaújhely,017,637,279,0,279,0,1,278
BORSOD-ABAÚJ-ZEMPLÉN,Sátoraljaújhely,018,560,226,0,226,0,0,226
BORSOD-ABAÚJ-ZEMPLÉN,Sátoraljaújhely,019,258,128,0,128,0,0,128
BORSOD-ABAÚJ-ZEMPLÉN,Selyeb,001,340,128,0,128,0,3,125
BORSOD-ABAÚJ-ZEMPLÉN,Semjén,001,379,68,0,68,0,5,63
BORSOD-ABAÚJ-ZEMPLÉN,Serényfalva,001,810,244,0,244,0,1,243
BORSOD-ABAÚJ-ZEMPLÉN,Sima,001,30,19,0,19,0,0,19
BORSOD-ABAÚJ-ZEMPLÉN,Sóstófalva,001,179,97,0,97,0,0,97
BORSOD-ABAÚJ-ZEMPLÉN,Szakácsi,001,98,59,0,59,0,0,59
BORSOD-ABAÚJ-ZEMPLÉN,Szakáld,001,377,190,0,190,0,0,190
BORSOD-ABAÚJ-ZEMPLÉN,Szalaszend,001,762,145,0,145,0,1,144
BORSOD-ABAÚJ-ZEMPLÉN,Szalonna,001,733,234,0,234,0,2,232
BORSOD-ABAÚJ-ZEMPLÉN,Szászfa,001,92,26,0,26,0,0,26
BORSOD-ABAÚJ-ZEMPLÉN,Szegi,001,256,100,0,100,0,0,100
BORSOD-ABAÚJ-ZEMPLÉN,Szegilong,001,199,87,0,87,0,1,86
BORSOD-ABAÚJ-ZEMPLÉN,Szemere,001,270,54,0,54,0,0,54
BORSOD-ABAÚJ-ZEMPLÉN,Szendrõ,001,653,145,0,145,0,0,145
BORSOD-ABAÚJ-ZEMPLÉN,Szendrõ,002,803,190,0,190,0,2,188
BORSOD-ABAÚJ-ZEMPLÉN,Szendrõ,003,725,257,0,257,0,0,257
BORSOD-ABAÚJ-ZEMPLÉN,Szendrõ,004,780,259,0,259,0,1,258
BORSOD-ABAÚJ-ZEMPLÉN,Szendrõlád,001,1324,188,0,188,0,0,188
BORSOD-ABAÚJ-ZEMPLÉN,Szentistván,001,638,292,0,292,0,2,290
BORSOD-ABAÚJ-ZEMPLÉN,Szentistván,002,675,323,0,323,0,2,321
BORSOD-ABAÚJ-ZEMPLÉN,Szentistván,003,641,315,0,315,0,8,307
BORSOD-ABAÚJ-ZEMPLÉN,Szentistvánbaksa,001,215,109,0,109,0,0,109
BORSOD-ABAÚJ-ZEMPLÉN,Szerencs,001,810,391,0,391,0,5,386
BORSOD-ABAÚJ-ZEMPLÉN,Szerencs,002,775,366,0,366,0,1,365
BORSOD-ABAÚJ-ZEMPLÉN,Szerencs,003,810,437,0,437,0,1,436
BORSOD-ABAÚJ-ZEMPLÉN,Szerencs,004,797,414,0,414,0,2,412
BORSOD-ABAÚJ-ZEMPLÉN,Szerencs,005,778,264,0,264,0,0,264
BORSOD-ABAÚJ-ZEMPLÉN,Szerencs,006,864,349,0,349,0,1,348
BORSOD-ABAÚJ-ZEMPLÉN,Szerencs,007,853,399,0,399,0,3,396
BORSOD-ABAÚJ-ZEMPLÉN,Szerencs,008,851,328,0,328,0,0,328
BORSOD-ABAÚJ-ZEMPLÉN,Szerencs,009,587,225,0,225,0,2,223
BORSOD-ABAÚJ-ZEMPLÉN,Szerencs,010,500,239,0,239,0,2,237
BORSOD-ABAÚJ-ZEMPLÉN,Szikszó,001,614,258,0,258,0,2,256
BORSOD-ABAÚJ-ZEMPLÉN,Szikszó,002,759,268,0,268,0,2,266
BORSOD-ABAÚJ-ZEMPLÉN,Szikszó,003,660,328,0,328,0,3,325
BORSOD-ABAÚJ-ZEMPLÉN,Szikszó,004,621,192,0,192,0,1,191
BORSOD-ABAÚJ-ZEMPLÉN,Szikszó,005,598,225,0,225,0,0,225
BORSOD-ABAÚJ-ZEMPLÉN,Szikszó,006,599,213,0,213,0,3,210
BORSOD-ABAÚJ-ZEMPLÉN,Szikszó,007,603,233,0,233,0,5,228
BORSOD-ABAÚJ-ZEMPLÉN,Szin,001,549,292,0,292,0,2,290
BORSOD-ABAÚJ-ZEMPLÉN,Szinpetri,001,178,84,0,84,0,0,84
BORSOD-ABAÚJ-ZEMPLÉN,Szirmabesenyõ,001,1031,484,0,484,0,2,482
BORSOD-ABAÚJ-ZEMPLÉN,Szirmabesenyõ,002,847,411,0,411,0,1,410
BORSOD-ABAÚJ-ZEMPLÉN,Szirmabesenyõ,003,826,335,0,335,0,1,334
BORSOD-ABAÚJ-ZEMPLÉN,Szirmabesenyõ,004,853,336,0,336,0,0,336
BORSOD-ABAÚJ-ZEMPLÉN,Szomolya,001,1236,497,0,497,0,6,491
BORSOD-ABAÚJ-ZEMPLÉN,Szögliget,001,538,251,0,251,0,2,249
BORSOD-ABAÚJ-ZEMPLÉN,Szõlõsardó,001,97,60,0,60,0,0,60
BORSOD-ABAÚJ-ZEMPLÉN,Szuhafõ,001,127,80,0,80,0,0,80
BORSOD-ABAÚJ-ZEMPLÉN,Szuhakálló,001,768,261,0,261,0,0,261
BORSOD-ABAÚJ-ZEMPLÉN,Szuhogy,001,862,259,0,259,0,1,258
BORSOD-ABAÚJ-ZEMPLÉN,Taktabáj,001,402,152,0,152,0,1,151
BORSOD-ABAÚJ-ZEMPLÉN,Taktaharkány,001,787,353,0,353,0,6,347
BORSOD-ABAÚJ-ZEMPLÉN,Taktaharkány,002,753,294,0,294,0,1,293
BORSOD-ABAÚJ-ZEMPLÉN,Taktaharkány,003,637,266,0,266,0,3,263
BORSOD-ABAÚJ-ZEMPLÉN,Taktaharkány,004,596,199,0,199,0,3,196
BORSOD-ABAÚJ-ZEMPLÉN,Taktakenéz,001,854,254,0,254,0,2,252
BORSOD-ABAÚJ-ZEMPLÉN,Taktaszada,001,713,209,0,209,0,1,208
BORSOD-ABAÚJ-ZEMPLÉN,Taktaszada,002,737,222,0,222,0,0,222
BORSOD-ABAÚJ-ZEMPLÉN,Tarcal,001,1117,381,0,381,0,3,378
BORSOD-ABAÚJ-ZEMPLÉN,Tarcal,002,1148,381,0,381,0,3,378
BORSOD-ABAÚJ-ZEMPLÉN,Tard,001,961,451,0,451,0,7,444
BORSOD-ABAÚJ-ZEMPLÉN,Tardona,001,842,305,0,305,0,0,305
BORSOD-ABAÚJ-ZEMPLÉN,Tállya,001,781,205,0,205,0,4,201
BORSOD-ABAÚJ-ZEMPLÉN,Tállya,002,697,280,0,279,-1,5,274
BORSOD-ABAÚJ-ZEMPLÉN,Telkibánya,001,489,197,0,197,0,3,194
BORSOD-ABAÚJ-ZEMPLÉN,Teresztenye,001,23,15,0,15,0,0,15
BORSOD-ABAÚJ-ZEMPLÉN,Tibolddaróc,001,1102,333,0,333,0,0,333
BORSOD-ABAÚJ-ZEMPLÉN,Tiszabábolna,001,287,142,0,142,0,2,140
BORSOD-ABAÚJ-ZEMPLÉN,Tiszacsermely,001,392,84,0,84,0,0,84
BORSOD-ABAÚJ-ZEMPLÉN,Tiszadorogma,001,335,182,0,182,0,0,182
BORSOD-ABAÚJ-ZEMPLÉN,Tiszakarád,001,769,176,0,175,-1,1,174
BORSOD-ABAÚJ-ZEMPLÉN,Tiszakarád,002,848,127,0,127,0,0,127
BORSOD-ABAÚJ-ZEMPLÉN,Tiszakarád,003,210,29,0,29,0,0,29
BORSOD-ABAÚJ-ZEMPLÉN,Tiszakeszi,001,707,252,0,252,0,1,251
BORSOD-ABAÚJ-ZEMPLÉN,Tiszakeszi,002,624,178,0,178,0,3,175
BORSOD-ABAÚJ-ZEMPLÉN,Tiszakeszi,003,699,240,0,240,0,1,239
BORSOD-ABAÚJ-ZEMPLÉN,Tiszaladány,001,513,232,0,232,0,0,232
BORSOD-ABAÚJ-ZEMPLÉN,Tiszalúc,001,766,148,0,148,0,2,146
BORSOD-ABAÚJ-ZEMPLÉN,Tiszalúc,002,886,278,0,278,0,1,277
BORSOD-ABAÚJ-ZEMPLÉN,Tiszalúc,003,760,187,0,187,0,1,186
BORSOD-ABAÚJ-ZEMPLÉN,Tiszalúc,004,750,139,0,139,0,1,138
BORSOD-ABAÚJ-ZEMPLÉN,Tiszalúc,005,768,174,0,174,0,1,173
BORSOD-ABAÚJ-ZEMPLÉN,Tiszapalkonya,001,1168,357,0,357,0,1,356
BORSOD-ABAÚJ-ZEMPLÉN,Tiszatardos,001,178,93,0,93,0,1,92
BORSOD-ABAÚJ-ZEMPLÉN,Tiszatarján,001,1047,379,0,379,0,5,374
BORSOD-ABAÚJ-ZEMPLÉN,Tiszaújváros,001,702,273,0,273,0,0,273
BORSOD-ABAÚJ-ZEMPLÉN,Tiszaújváros,002,707,186,0,186,0,1,185
BORSOD-ABAÚJ-ZEMPLÉN,Tiszaújváros,003,229,119,0,119,0,0,119
BORSOD-ABAÚJ-ZEMPLÉN,Tiszaújváros,004,808,309,0,308,-1,1,307
BORSOD-ABAÚJ-ZEMPLÉN,Tiszaújváros,005,798,325,0,325,0,1,324
BORSOD-ABAÚJ-ZEMPLÉN,Tiszaújváros,006,829,439,0,439,0,3,436
BORSOD-ABAÚJ-ZEMPLÉN,Tiszaújváros,007,835,356,0,356,0,2,354
BORSOD-ABAÚJ-ZEMPLÉN,Tiszaújváros,008,924,427,0,427,0,1,426
BORSOD-ABAÚJ-ZEMPLÉN,Tiszaújváros,009,891,400,0,400,0,1,399
BORSOD-ABAÚJ-ZEMPLÉN,Tiszaújváros,010,691,279,0,278,-1,1,277
BORSOD-ABAÚJ-ZEMPLÉN,Tiszaújváros,011,832,342,0,342,0,2,340
BORSOD-ABAÚJ-ZEMPLÉN,Tiszaújváros,012,830,308,0,308,0,0,308
BORSOD-ABAÚJ-ZEMPLÉN,Tiszaújváros,013,850,358,0,358,0,0,358
BORSOD-ABAÚJ-ZEMPLÉN,Tiszaújváros,014,882,333,0,333,0,1,332
BORSOD-ABAÚJ-ZEMPLÉN,Tiszaújváros,015,861,328,0,328,0,1,327
BORSOD-ABAÚJ-ZEMPLÉN,Tiszaújváros,016,778,338,0,338,0,3,335
BORSOD-ABAÚJ-ZEMPLÉN,Tiszaújváros,017,1004,500,0,500,0,2,498
BORSOD-ABAÚJ-ZEMPLÉN,Tiszavalk,001,267,149,0,149,0,1,148
BORSOD-ABAÚJ-ZEMPLÉN,Tokaj,001,584,266,0,266,0,5,261
BORSOD-ABAÚJ-ZEMPLÉN,Tokaj,002,479,252,0,252,0,3,249
BORSOD-ABAÚJ-ZEMPLÉN,Tokaj,003,628,323,0,323,0,0,323
BORSOD-ABAÚJ-ZEMPLÉN,Tokaj,004,751,269,0,269,0,1,268
BORSOD-ABAÚJ-ZEMPLÉN,Tokaj,005,729,292,0,292,0,3,289
BORSOD-ABAÚJ-ZEMPLÉN,Tolcsva,001,734,259,0,259,0,1,258
BORSOD-ABAÚJ-ZEMPLÉN,Tolcsva,002,696,285,0,285,0,1,284
BORSOD-ABAÚJ-ZEMPLÉN,Tomor,001,183,96,0,96,0,2,94
BORSOD-ABAÚJ-ZEMPLÉN,Tornabarakony,001,19,14,0,14,0,0,14
BORSOD-ABAÚJ-ZEMPLÉN,Tornakápolna,001,23,14,0,14,0,1,13
BORSOD-ABAÚJ-ZEMPLÉN,Tornanádaska,001,393,258,0,258,0,4,254
BORSOD-ABAÚJ-ZEMPLÉN,Tornaszentandrás,001,164,66,0,66,0,0,66
BORSOD-ABAÚJ-ZEMPLÉN,Tornaszentjakab,001,154,77,0,77,0,0,77
BORSOD-ABAÚJ-ZEMPLÉN,Tornyosnémeti,001,321,125,0,125,0,0,125
BORSOD-ABAÚJ-ZEMPLÉN,Trizs,001,177,96,0,96,0,0,96
BORSOD-ABAÚJ-ZEMPLÉN,Uppony,001,255,107,0,107,0,1,106
BORSOD-ABAÚJ-ZEMPLÉN,Újcsanálos,001,684,202,0,202,0,0,202
BORSOD-ABAÚJ-ZEMPLÉN,Vadna,001,502,161,0,161,0,0,161
BORSOD-ABAÚJ-ZEMPLÉN,Vajdácska,001,962,276,0,276,0,3,273
BORSOD-ABAÚJ-ZEMPLÉN,Varbó,001,920,384,0,384,0,0,384
BORSOD-ABAÚJ-ZEMPLÉN,Varbóc,001,55,36,0,36,0,0,36
BORSOD-ABAÚJ-ZEMPLÉN,Vatta,001,700,297,0,297,0,1,296
BORSOD-ABAÚJ-ZEMPLÉN,Vágáshuta,001,89,47,0,47,0,1,46
BORSOD-ABAÚJ-ZEMPLÉN,Vámosújfalu,001,611,303,0,303,0,1,302
BORSOD-ABAÚJ-ZEMPLÉN,Vilmány,001,960,228,0,228,0,6,222
BORSOD-ABAÚJ-ZEMPLÉN,Vilyvitány,001,217,80,0,80,0,0,80
BORSOD-ABAÚJ-ZEMPLÉN,Viss,001,482,114,0,114,0,0,114
BORSOD-ABAÚJ-ZEMPLÉN,Viszló,001,61,41,0,41,0,0,41
BORSOD-ABAÚJ-ZEMPLÉN,Vizsoly,001,628,183,0,183,0,0,183
BORSOD-ABAÚJ-ZEMPLÉN,Zalkod,001,186,85,0,85,0,2,83
BORSOD-ABAÚJ-ZEMPLÉN,Zádorfalva,001,349,103,0,103,0,2,101
BORSOD-ABAÚJ-ZEMPLÉN,Zemplénagárd,001,548,154,0,154,0,1,153
BORSOD-ABAÚJ-ZEMPLÉN,Ziliz,001,305,126,0,126,0,1,125
BORSOD-ABAÚJ-ZEMPLÉN,Zsujta,001,140,59,0,59,0,0,59
BORSOD-ABAÚJ-ZEMPLÉN,Zubogy,001,431,157,0,157,0,2,155
BORSOD-ABAÚJ-ZEMPLÉN,Gibárt,001,290,127,0,127,0,0,127
CSONGRÁD,Algyõ,001,1056,484,0,484,0,4,480
CSONGRÁD,Algyõ,002,1129,454,0,454,0,4,450
CSONGRÁD,Algyõ,003,1100,431,0,431,0,3,428
CSONGRÁD,Algyõ,004,1140,413,0,413,0,2,411
CSONGRÁD,Ambrózfalva,001,375,169,0,169,0,3,166
CSONGRÁD,Apátfalva,001,749,322,0,322,0,1,321
CSONGRÁD,Apátfalva,002,787,280,0,280,0,1,279
CSONGRÁD,Apátfalva,003,856,357,0,357,0,4,353
CSONGRÁD,Árpádhalom,001,399,152,0,152,0,0,152
CSONGRÁD,Ásotthalom,001,768,294,0,294,0,4,290
CSONGRÁD,Ásotthalom,002,777,286,0,286,0,3,283
CSONGRÁD,Ásotthalom,003,738,272,0,272,0,4,268
CSONGRÁD,Ásotthalom,004,481,134,0,134,0,1,133
CSONGRÁD,Ásotthalom,005,473,156,0,156,0,1,155
CSONGRÁD,Baks,001,819,233,0,233,0,2,231
CSONGRÁD,Baks,002,757,165,0,165,0,3,162
CSONGRÁD,Balástya,001,751,310,0,310,0,1,309
CSONGRÁD,Balástya,002,740,297,0,297,0,0,297
CSONGRÁD,Balástya,003,712,207,0,207,0,1,206
CSONGRÁD,Balástya,004,517,150,0,150,0,1,149
CSONGRÁD,Bordány,001,891,367,0,367,0,2,365
CSONGRÁD,Bordány,002,874,354,0,354,0,2,352
CSONGRÁD,Bordány,003,870,253,0,253,0,2,251
CSONGRÁD,Csanádalberti,001,353,180,0,180,0,1,179
CSONGRÁD,Csanádpalota,001,761,303,0,303,0,2,301
CSONGRÁD,Csanádpalota,002,797,323,0,323,0,1,322
CSONGRÁD,Csanádpalota,003,728,295,0,295,0,2,293
CSONGRÁD,Csanytelek,001,686,219,0,219,0,2,217
CSONGRÁD,Csanytelek,002,719,228,0,228,0,0,228
CSONGRÁD,Csanytelek,003,724,204,0,204,0,1,203
CSONGRÁD,Csengele,001,795,425,0,425,0,6,419
CSONGRÁD,Csengele,002,718,250,0,249,-1,2,247
CSONGRÁD,Csongrád,001,993,334,0,334,0,3,331
CSONGRÁD,Csongrád,002,821,304,0,304,0,0,304
CSONGRÁD,Csongrád,003,776,339,0,339,0,5,334
CSONGRÁD,Csongrád,004,940,318,0,318,0,3,315
CSONGRÁD,Csongrád,005,815,281,0,281,0,0,281
CSONGRÁD,Csongrád,006,912,266,0,266,0,2,264
CSONGRÁD,Csongrád,007,824,368,0,368,0,1,367
CSONGRÁD,Csongrád,008,1076,514,0,514,0,9,505
CSONGRÁD,Csongrád,009,811,380,0,380,0,4,376
CSONGRÁD,Csongrád,010,920,381,0,381,0,3,378
CSONGRÁD,Csongrád,011,737,302,0,302,0,1,301
CSONGRÁD,Csongrád,012,799,350,0,350,0,1,349
CSONGRÁD,Csongrád,013,913,440,0,440,0,2,438
CSONGRÁD,Csongrád,014,822,370,0,370,0,1,369
CSONGRÁD,Csongrád,015,492,148,0,148,0,0,148
CSONGRÁD,Csongrád,016,773,310,0,310,0,5,305
CSONGRÁD,Derekegyház,001,437,169,0,169,0,0,169
CSONGRÁD,Derekegyház,002,584,220,0,220,0,2,218
CSONGRÁD,Derekegyház,003,169,66,0,66,0,0,66
CSONGRÁD,Deszk,001,974,469,0,469,0,2,467
CSONGRÁD,Deszk,002,608,260,0,260,0,2,258
CSONGRÁD,Deszk,003,741,286,0,286,0,1,285
CSONGRÁD,Deszk,004,742,305,0,305,0,1,304
CSONGRÁD,Domaszék,001,921,375,0,375,0,0,375
CSONGRÁD,Domaszék,002,1090,471,0,471,0,4,467
CSONGRÁD,Domaszék,003,875,361,0,361,0,1,360
CSONGRÁD,Domaszék,004,1146,431,0,431,0,3,428
CSONGRÁD,Dóc,001,438,173,0,173,0,3,170
CSONGRÁD,Dóc,002,151,51,0,51,0,0,51
CSONGRÁD,Eperjes,001,409,148,0,148,0,2,146
CSONGRÁD,Fábiánsebestyén,001,561,210,0,210,0,1,209
CSONGRÁD,Fábiánsebestyén,002,532,203,0,203,0,0,203
CSONGRÁD,Fábiánsebestyén,003,531,187,0,187,0,2,185
CSONGRÁD,Felgyõ,001,555,223,0,223,0,2,221
CSONGRÁD,Felgyõ,002,456,171,0,171,0,4,167
CSONGRÁD,Ferencszállás,001,524,215,0,215,0,2,213
CSONGRÁD,Forráskút,001,821,381,0,381,0,2,379
CSONGRÁD,Forráskút,002,870,336,0,336,0,3,333
CSONGRÁD,Földeák,001,903,418,0,418,0,7,411
CSONGRÁD,Földeák,002,842,372,0,372,0,1,371
CSONGRÁD,Földeák,003,764,334,0,334,0,2,332
CSONGRÁD,Hódmezõvásárhely,001,749,405,0,405,0,1,404
CSONGRÁD,Hódmezõvásárhely,002,682,286,0,286,0,2,284
CSONGRÁD,Hódmezõvásárhely,003,833,427,0,427,0,0,427
CSONGRÁD,Hódmezõvásárhely,004,787,409,0,408,-1,1,407
CSONGRÁD,Hódmezõvásárhely,005,703,380,0,380,0,2,378
CSONGRÁD,Hódmezõvásárhely,006,734,452,0,452,0,1,451
CSONGRÁD,Hódmezõvásárhely,007,595,348,0,348,0,0,348
CSONGRÁD,Hódmezõvásárhely,008,630,383,0,383,0,3,380
CSONGRÁD,Hódmezõvásárhely,009,647,436,0,435,-1,5,430
CSONGRÁD,Hódmezõvásárhely,010,750,438,1,437,-1,3,434
CSONGRÁD,Hódmezõvásárhely,011,784,386,0,386,0,1,385
CSONGRÁD,Hódmezõvásárhely,012,665,328,0,328,0,3,325
CSONGRÁD,Hódmezõvásárhely,013,597,295,0,295,0,1,294
CSONGRÁD,Hódmezõvásárhely,014,962,434,0,434,0,4,430
CSONGRÁD,Hódmezõvásárhely,015,792,388,0,388,0,0,388
CSONGRÁD,Hódmezõvásárhely,016,845,329,0,329,0,6,323
CSONGRÁD,Hódmezõvásárhely,017,994,529,0,529,0,6,523
CSONGRÁD,Hódmezõvásárhely,018,952,513,0,513,0,1,512
CSONGRÁD,Hódmezõvásárhely,019,834,493,0,493,0,0,493
CSONGRÁD,Hódmezõvásárhely,020,901,497,0,497,0,4,493
CSONGRÁD,Hódmezõvásárhely,021,804,409,0,409,0,3,406
CSONGRÁD,Hódmezõvásárhely,022,801,388,0,388,0,1,387
CSONGRÁD,Hódmezõvásárhely,023,1031,574,0,573,-1,5,568
CSONGRÁD,Hódmezõvásárhely,024,580,291,0,291,0,2,289
CSONGRÁD,Hódmezõvásárhely,025,665,343,0,343,0,1,342
CSONGRÁD,Hódmezõvásárhely,026,795,347,0,347,0,0,347
CSONGRÁD,Hódmezõvásárhely,027,735,354,0,354,0,0,354
CSONGRÁD,Hódmezõvásárhely,028,731,361,0,361,0,1,360
CSONGRÁD,Hódmezõvásárhely,029,584,265,0,265,0,2,263
CSONGRÁD,Hódmezõvásárhely,030,639,353,0,353,0,7,346
CSONGRÁD,Hódmezõvásárhely,031,577,257,0,257,0,1,256
CSONGRÁD,Hódmezõvásárhely,032,724,358,0,358,0,1,357
CSONGRÁD,Hódmezõvásárhely,033,876,415,0,415,0,3,412
CSONGRÁD,Hódmezõvásárhely,034,919,449,0,449,0,4,445
CSONGRÁD,Hódmezõvásárhely,035,914,403,0,403,0,1,402
CSONGRÁD,Hódmezõvásárhely,036,856,449,0,449,0,4,445
CSONGRÁD,Hódmezõvásárhely,037,879,483,0,483,0,2,481
CSONGRÁD,Hódmezõvásárhely,038,861,508,1,507,-1,1,506
CSONGRÁD,Hódmezõvásárhely,039,892,475,0,474,-1,2,472
CSONGRÁD,Hódmezõvásárhely,040,829,432,0,432,0,4,428
CSONGRÁD,Hódmezõvásárhely,041,914,562,0,562,0,5,557
CSONGRÁD,Hódmezõvásárhely,042,233,107,0,107,0,1,106
CSONGRÁD,Hódmezõvásárhely,043,449,248,0,248,0,0,248
CSONGRÁD,Hódmezõvásárhely,044,250,127,0,127,0,1,126
CSONGRÁD,Hódmezõvásárhely,045,461,256,0,256,0,1,255
CSONGRÁD,Hódmezõvásárhely,046,299,126,0,126,0,0,126
CSONGRÁD,Hódmezõvásárhely,047,279,145,0,145,0,1,144
CSONGRÁD,Hódmezõvásárhely,048,485,214,0,214,0,1,213
CSONGRÁD,Hódmezõvásárhely,049,192,80,0,80,0,0,80
CSONGRÁD,Hódmezõvásárhely,050,1190,685,0,685,0,0,685
CSONGRÁD,Királyhegyes,001,447,223,0,223,0,2,221
CSONGRÁD,Királyhegyes,002,31,17,0,17,0,0,17
CSONGRÁD,Kistelek,001,991,422,0,422,0,3,419
CSONGRÁD,Kistelek,002,947,318,0,318,0,2,316
CSONGRÁD,Kistelek,003,1033,351,0,351,0,6,345
CSONGRÁD,Kistelek,004,991,364,0,364,0,3,361
CSONGRÁD,Kistelek,005,1005,381,0,381,0,3,378
CSONGRÁD,Kistelek,006,1035,341,0,341,0,3,338
CSONGRÁD,Kiszombor,001,816,287,0,287,0,1,286
CSONGRÁD,Kiszombor,002,788,268,0,268,0,0,268
CSONGRÁD,Kiszombor,003,777,314,0,314,0,3,311
CSONGRÁD,Kiszombor,004,786,323,0,323,0,1,322
CSONGRÁD,Klárafalva,001,426,142,0,142,0,0,142
CSONGRÁD,Kövegy,001,334,191,0,191,0,0,191
CSONGRÁD,Kübekháza,001,1217,408,0,408,0,3,405
CSONGRÁD,Magyarcsanád,001,577,224,0,224,0,1,223
CSONGRÁD,Magyarcsanád,002,516,207,1,206,-1,0,206
CSONGRÁD,Makó,001,720,408,0,407,-1,4,403
CSONGRÁD,Makó,002,793,372,0,372,0,2,370
CSONGRÁD,Makó,003,914,415,0,415,0,8,407
CSONGRÁD,Makó,004,845,363,0,363,0,1,362
CSONGRÁD,Makó,005,710,337,0,337,0,3,334
CSONGRÁD,Makó,006,725,315,0,315,0,1,314
CSONGRÁD,Makó,007,644,296,0,296,0,1,295
CSONGRÁD,Makó,008,759,368,0,368,0,6,362
CSONGRÁD,Makó,009,948,209,0,209,0,1,208
CSONGRÁD,Makó,010,1014,518,0,517,-1,1,516
CSONGRÁD,Makó,011,1021,381,0,381,0,2,379
CSONGRÁD,Makó,012,768,382,0,382,0,2,380
CSONGRÁD,Makó,013,908,480,1,480,0,0,480
CSONGRÁD,Makó,014,831,404,0,404,0,2,402
CSONGRÁD,Makó,015,915,460,0,460,0,10,450
CSONGRÁD,Makó,016,700,349,0,349,0,0,349
CSONGRÁD,Makó,017,763,382,0,382,0,6,376
CSONGRÁD,Makó,018,1014,491,0,491,0,3,488
CSONGRÁD,Makó,019,668,342,0,342,0,1,341
CSONGRÁD,Makó,020,700,337,0,336,-1,2,334
CSONGRÁD,Makó,021,870,404,0,404,0,3,401
CSONGRÁD,Makó,022,725,343,0,343,0,2,341
CSONGRÁD,Makó,023,912,385,0,385,0,1,384
CSONGRÁD,Maroslele,001,523,239,0,239,0,0,239
CSONGRÁD,Maroslele,002,549,227,0,227,0,1,226
CSONGRÁD,Maroslele,003,596,211,0,211,0,2,209
CSONGRÁD,Mártély,001,699,379,0,379,0,3,376
CSONGRÁD,Mártély,002,342,205,0,205,0,2,203
CSONGRÁD,Mindszent,001,1184,435,0,435,0,0,435
CSONGRÁD,Mindszent,002,1134,425,0,424,-1,1,423
CSONGRÁD,Mindszent,003,1127,434,0,434,0,1,433
CSONGRÁD,Mindszent,004,978,353,0,353,0,2,351
CSONGRÁD,Mindszent,005,1028,372,0,372,0,2,370
CSONGRÁD,Mórahalom,001,648,352,0,352,0,1,351
CSONGRÁD,Mórahalom,002,758,400,0,400,0,3,397
CSONGRÁD,Mórahalom,003,931,497,0,497,0,9,488
CSONGRÁD,Mórahalom,004,918,553,0,553,0,1,552
CSONGRÁD,Mórahalom,005,850,432,0,432,0,4,428
CSONGRÁD,Mórahalom,006,312,114,0,114,0,0,114
CSONGRÁD,Mórahalom,007,259,113,0,113,0,1,112
CSONGRÁD,Mórahalom,008,309,141,0,141,0,0,141
CSONGRÁD,Mórahalom,009,165,76,0,76,0,0,76
CSONGRÁD,Nagyér,001,404,160,0,160,0,2,158
CSONGRÁD,Nagylak,001,390,184,0,184,0,1,183
CSONGRÁD,Nagymágocs,001,550,169,0,169,0,0,169
CSONGRÁD,Nagymágocs,002,661,213,0,213,0,0,213
CSONGRÁD,Nagymágocs,003,524,207,0,207,0,3,204
CSONGRÁD,Nagymágocs,004,494,230,0,230,0,5,225
CSONGRÁD,Nagymágocs,005,137,56,0,56,0,1,55
CSONGRÁD,Nagytõke,001,354,96,0,96,0,0,96
CSONGRÁD,Óföldeák,001,406,205,0,205,0,2,203
CSONGRÁD,Ópusztaszer,001,590,198,0,198,0,2,196
CSONGRÁD,Ópusztaszer,002,484,151,0,151,0,6,145
CSONGRÁD,Ópusztaszer,003,355,100,0,100,0,3,97
CSONGRÁD,Ópusztaszer,004,150,49,0,49,0,1,48
CSONGRÁD,Öttömös,001,422,211,0,211,0,3,208
CSONGRÁD,Öttömös,002,141,44,0,44,0,1,43
CSONGRÁD,Pitvaros,001,617,300,0,300,0,5,295
CSONGRÁD,Pitvaros,002,514,265,0,265,0,2,263
CSONGRÁD,Pusztamérges,001,873,348,0,348,0,2,346
CSONGRÁD,Pusztaszer,001,742,336,0,336,0,1,335
CSONGRÁD,Pusztaszer,002,429,112,0,112,0,1,111
CSONGRÁD,Röszke,001,1088,405,0,405,0,5,400
CSONGRÁD,Röszke,002,1299,502,0,502,0,3,499
CSONGRÁD,Röszke,003,581,166,0,166,0,6,160
CSONGRÁD,Ruzsa,001,1078,407,0,407,0,3,404
CSONGRÁD,Ruzsa,002,987,363,0,363,0,2,361
CSONGRÁD,Sándorfalva,001,840,271,0,271,0,2,269
CSONGRÁD,Sándorfalva,002,844,286,0,286,0,3,283
CSONGRÁD,Sándorfalva,003,650,242,0,242,0,2,240
CSONGRÁD,Sándorfalva,004,733,245,0,245,0,2,243
CSONGRÁD,Sándorfalva,005,815,345,0,345,0,4,341
CSONGRÁD,Sándorfalva,006,842,336,1,336,0,4,332
CSONGRÁD,Sándorfalva,007,801,320,0,320,0,1,319
CSONGRÁD,Sándorfalva,008,727,270,0,270,0,1,269
CSONGRÁD,Sándorfalva,009,466,113,0,113,0,0,113
CSONGRÁD,Szatymaz,001,944,300,0,300,0,6,294
CSONGRÁD,Szatymaz,002,936,365,0,365,0,0,365
CSONGRÁD,Szatymaz,003,1014,327,0,327,0,1,326
CSONGRÁD,Szatymaz,004,1146,399,0,399,0,1,398
CSONGRÁD,Szeged,001,1414,528,2,526,-2,0,526
CSONGRÁD,Szeged,002,1039,451,0,451,0,1,450
CSONGRÁD,Szeged,003,1174,502,0,502,0,2,500
CSONGRÁD,Szeged,004,1282,503,0,503,0,3,500
CSONGRÁD,Szeged,005,1079,441,0,441,0,1,440
CSONGRÁD,Szeged,006,1291,694,0,695,1,11,684
CSONGRÁD,Szeged,007,1394,663,0,663,0,4,659
CSONGRÁD,Szeged,008,1152,430,0,430,0,0,430
CSONGRÁD,Szeged,009,1338,496,0,496,0,2,494
CSONGRÁD,Szeged,010,1067,459,0,459,0,2,457
CSONGRÁD,Szeged,011,1138,515,1,515,0,2,513
CSONGRÁD,Szeged,012,1402,707,0,707,0,5,702
CSONGRÁD,Szeged,013,1189,525,0,525,0,1,524
CSONGRÁD,Szeged,014,1363,643,1,643,0,2,641
CSONGRÁD,Szeged,015,1201,454,0,453,-1,7,446
CSONGRÁD,Szeged,016,1275,478,0,478,0,0,478
CSONGRÁD,Szeged,017,1312,575,0,575,0,2,573
CSONGRÁD,Szeged,018,1225,548,0,548,0,0,548
CSONGRÁD,Szeged,019,1365,738,0,737,-1,1,736
CSONGRÁD,Szeged,020,1037,478,0,478,0,2,476
CSONGRÁD,Szeged,101,1447,653,0,653,0,0,653
CSONGRÁD,Szeged,102,1350,557,0,557,0,1,556
CSONGRÁD,Szeged,103,1056,467,0,467,0,3,464
CSONGRÁD,Szeged,104,1284,465,1,464,-1,1,463
CSONGRÁD,Szeged,105,1084,446,0,446,0,0,446
CSONGRÁD,Szeged,106,1249,617,0,616,-1,3,613
CSONGRÁD,Szeged,107,1302,627,0,627,0,3,624
CSONGRÁD,Szeged,108,1277,506,0,506,0,2,504
CSONGRÁD,Szeged,109,1295,576,0,576,0,1,575
CSONGRÁD,Szeged,110,1246,514,0,514,0,0,514
CSONGRÁD,Szeged,111,1130,554,0,554,0,2,552
CSONGRÁD,Szeged,112,1390,655,0,655,0,0,655
CSONGRÁD,Szeged,113,1296,542,0,542,0,2,540
CSONGRÁD,Szeged,114,1273,494,0,494,0,0,494
CSONGRÁD,Szeged,115,1177,531,0,531,0,1,530
CSONGRÁD,Szeged,116,1356,648,0,648,0,5,643
CSONGRÁD,Szeged,117,1241,571,0,571,0,1,570
CSONGRÁD,Szeged,118,1251,567,0,567,0,2,565
CSONGRÁD,Szeged,119,1387,723,0,724,1,9,715
CSONGRÁD,Szeged,120,1350,695,0,695,0,4,691
CSONGRÁD,Szeged,201,1434,562,0,562,0,2,560
CSONGRÁD,Szeged,202,1231,524,0,524,0,3,521
CSONGRÁD,Szeged,203,1108,547,0,546,-1,2,544
CSONGRÁD,Szeged,204,1309,466,0,466,0,2,464
CSONGRÁD,Szeged,205,1095,468,0,467,-1,2,465
CSONGRÁD,Szeged,206,1147,663,0,663,0,2,661
CSONGRÁD,Szeged,207,662,300,0,300,0,0,300
CSONGRÁD,Szeged,208,1311,529,0,529,0,7,522
CSONGRÁD,Szeged,209,1251,555,0,555,0,3,552
CSONGRÁD,Szeged,210,993,454,0,452,-2,2,450
CSONGRÁD,Szeged,211,701,332,0,331,-1,0,331
CSONGRÁD,Szeged,212,1060,474,0,474,0,11,463
CSONGRÁD,Szeged,213,1222,543,0,543,0,0,543
CSONGRÁD,Szeged,214,1224,523,0,521,-2,5,516
CSONGRÁD,Szeged,215,1268,504,0,504,0,2,502
CSONGRÁD,Szeged,216,1262,534,0,534,0,9,525
CSONGRÁD,Szeged,217,1175,547,0,547,0,2,545
CSONGRÁD,Szeged,218,1230,569,0,569,0,7,562
CSONGRÁD,Szeged,219,1219,675,0,675,0,0,675
CSONGRÁD,Szeged,220,1303,694,0,694,0,2,692
CSONGRÁD,Szeged,301,1454,519,0,519,0,2,517
CSONGRÁD,Szeged,302,1011,427,0,427,0,4,423
CSONGRÁD,Szeged,303,925,475,0,475,0,3,472
CSONGRÁD,Szeged,304,1300,538,0,536,-2,2,534
CSONGRÁD,Szeged,305,1359,605,0,605,0,1,604
CSONGRÁD,Szeged,306,1121,616,0,616,0,2,614
CSONGRÁD,Szeged,307,1379,674,0,673,-1,1,672
CSONGRÁD,Szeged,308,1199,435,0,434,-1,3,431
CSONGRÁD,Szeged,309,1211,527,0,526,-1,6,520
CSONGRÁD,Szeged,310,1019,515,0,515,0,2,513
CSONGRÁD,Szeged,311,3629,2584,0,2582,-2,4,2578
CSONGRÁD,Szeged,312,1212,608,0,608,0,4,604
CSONGRÁD,Szeged,313,1142,470,0,470,0,0,470
CSONGRÁD,Szeged,314,1350,665,0,665,0,3,662
CSONGRÁD,Szeged,315,1225,495,0,495,0,7,488
CSONGRÁD,Szeged,316,1280,495,0,495,0,0,495
CSONGRÁD,Szeged,317,1292,511,0,511,0,1,510
CSONGRÁD,Szeged,318,1204,659,0,659,0,5,654
CSONGRÁD,Szeged,319,1222,572,0,572,0,3,569
CSONGRÁD,Szeged,320,1128,555,0,555,0,1,554
CSONGRÁD,Szeged,401,1417,578,0,578,0,2,576
CSONGRÁD,Szeged,402,1053,413,0,413,0,0,413
CSONGRÁD,Szeged,403,901,459,0,459,0,0,459
CSONGRÁD,Szeged,404,1210,479,0,479,0,1,478
CSONGRÁD,Szeged,405,937,400,0,400,0,4,396
CSONGRÁD,Szeged,406,948,501,0,501,0,1,500
CSONGRÁD,Szeged,407,1124,481,0,481,0,2,479
CSONGRÁD,Szeged,408,1139,462,0,462,0,2,460
CSONGRÁD,Szeged,409,1380,585,0,585,0,0,585
CSONGRÁD,Szeged,410,1066,493,0,492,-1,5,487
CSONGRÁD,Szeged,411,925,416,0,416,0,1,415
CSONGRÁD,Szeged,412,1359,575,0,574,-1,1,573
CSONGRÁD,Szeged,413,1274,514,0,514,0,3,511
CSONGRÁD,Szeged,414,1308,559,2,557,-2,1,556
CSONGRÁD,Szeged,415,1315,490,0,490,0,2,488
CSONGRÁD,Szeged,416,1309,643,0,643,0,3,640
CSONGRÁD,Szeged,417,1235,493,0,493,0,2,491
CSONGRÁD,Szeged,418,1273,644,0,643,-1,2,641
CSONGRÁD,Szeged,419,1290,734,3,731,-3,4,727
CSONGRÁD,Szeged,420,1070,534,0,534,0,1,533
CSONGRÁD,Szeged,502,1053,503,0,501,-2,1,500
CSONGRÁD,Szeged,503,1128,579,0,579,0,2,577
CSONGRÁD,Szeged,505,1158,468,0,468,0,0,468
CSONGRÁD,Szeged,507,1059,421,0,421,0,0,421
CSONGRÁD,Szeged,511,662,315,0,315,0,2,313
CSONGRÁD,Szeged,520,1120,502,0,502,0,0,502
CSONGRÁD,Szeged,603,936,512,0,512,0,1,511
CSONGRÁD,Szeged,611,756,347,0,347,0,3,344
CSONGRÁD,Szegvár,001,613,288,0,288,0,5,283
CSONGRÁD,Szegvár,002,660,299,0,299,0,3,296
CSONGRÁD,Szegvár,003,575,249,0,249,0,4,245
CSONGRÁD,Szegvár,004,581,226,0,226,0,0,226
CSONGRÁD,Szegvár,005,575,227,0,227,0,1,226
CSONGRÁD,Szegvár,006,572,226,0,226,0,1,225
CSONGRÁD,Szegvár,007,72,32,0,32,0,0,32
CSONGRÁD,Szentes,001,731,401,0,401,0,4,397
CSONGRÁD,Szentes,002,660,278,0,278,0,0,278
CSONGRÁD,Szentes,003,704,300,0,300,0,0,300
CSONGRÁD,Szentes,004,59,25,0,25,0,0,25
CSONGRÁD,Szentes,005,196,98,0,98,0,0,98
CSONGRÁD,Szentes,006,877,329,0,329,0,2,327
CSONGRÁD,Szentes,007,1000,425,0,425,0,1,424
CSONGRÁD,Szentes,008,674,245,0,245,0,0,245
CSONGRÁD,Szentes,009,674,278,0,278,0,1,277
CSONGRÁD,Szentes,010,736,266,0,266,0,6,260
CSONGRÁD,Szentes,011,137,51,0,51,0,0,51
CSONGRÁD,Szentes,012,167,43,0,43,0,0,43
CSONGRÁD,Szentes,013,98,48,0,48,0,0,48
CSONGRÁD,Szentes,014,905,444,0,444,0,1,443
CSONGRÁD,Szentes,015,926,425,0,424,-1,1,423
CSONGRÁD,Szentes,016,681,317,0,317,0,0,317
CSONGRÁD,Szentes,017,919,376,0,376,0,0,376
CSONGRÁD,Szentes,018,670,337,0,337,0,1,336
CSONGRÁD,Szentes,019,710,369,0,369,0,1,368
CSONGRÁD,Szentes,020,656,284,0,284,0,1,283
CSONGRÁD,Szentes,021,864,414,0,414,0,2,412
CSONGRÁD,Szentes,022,872,409,0,409,0,6,403
CSONGRÁD,Szentes,023,773,350,0,350,0,1,349
CSONGRÁD,Szentes,024,596,253,0,253,0,4,249
CSONGRÁD,Szentes,025,932,433,0,433,0,1,432
CSONGRÁD,Szentes,026,856,379,0,379,0,0,379
CSONGRÁD,Szentes,027,614,279,0,279,0,3,276
CSONGRÁD,Szentes,028,823,334,0,334,0,0,334
CSONGRÁD,Szentes,029,840,348,0,348,0,0,348
CSONGRÁD,Szentes,030,625,295,0,295,0,2,293
CSONGRÁD,Szentes,031,146,56,0,56,0,0,56
CSONGRÁD,Szentes,032,1103,356,0,356,0,1,355
CSONGRÁD,Szentes,033,689,227,0,227,0,0,227
CSONGRÁD,Szentes,034,85,29,0,29,0,0,29
CSONGRÁD,Szentes,035,172,74,0,74,0,1,73
CSONGRÁD,Székkutas,001,922,482,0,482,0,4,478
CSONGRÁD,Székkutas,002,878,454,0,454,0,3,451
CSONGRÁD,Tiszasziget,001,719,334,0,334,0,4,330
CSONGRÁD,Tiszasziget,002,775,313,0,313,0,2,311
CSONGRÁD,Tömörkény,001,732,281,0,281,0,2,279
CSONGRÁD,Tömörkény,002,688,200,0,200,0,2,198
CSONGRÁD,Újszentiván,001,809,351,0,351,0,2,349
CSONGRÁD,Újszentiván,002,761,351,0,351,0,4,347
CSONGRÁD,Üllés,001,845,297,0,297,0,1,296
CSONGRÁD,Üllés,002,886,369,1,368,-1,3,365
CSONGRÁD,Üllés,003,829,323,0,323,0,3,320
CSONGRÁD,Zákányszék,001,1153,501,0,501,0,3,498
CSONGRÁD,Zákányszék,002,1136,494,0,494,0,3,491
CSONGRÁD,Zsombó,001,904,340,0,340,0,1,339
CSONGRÁD,Zsombó,002,914,358,0,358,0,0,358
CSONGRÁD,Zsombó,003,1041,476,0,476,0,1,475
FEJÉR,Aba,001,1102,285,0,284,-1,2,282
FEJÉR,Aba,002,1033,318,0,318,0,0,318
FEJÉR,Aba,003,200,71,0,71,0,1,70
FEJÉR,Aba,004,192,72,0,72,0,1,71
FEJÉR,Aba,005,1185,403,0,403,0,3,400
FEJÉR,Adony,001,1022,373,0,373,0,2,371
FEJÉR,Adony,002,1129,397,2,395,-2,2,393
FEJÉR,Adony,003,1039,400,0,400,0,2,398
FEJÉR,Alap,001,847,272,0,272,0,0,272
FEJÉR,Alap,002,656,201,0,201,0,0,201
FEJÉR,Alcsútdoboz,001,486,261,0,260,-1,3,257
FEJÉR,Alcsútdoboz,002,680,339,0,339,0,3,336
FEJÉR,Alsószentiván,001,483,169,0,169,0,0,169
FEJÉR,Bakonycsernye,001,806,309,0,309,0,4,305
FEJÉR,Bakonycsernye,002,885,389,0,389,0,0,389
FEJÉR,Bakonycsernye,003,865,388,0,388,0,5,383
FEJÉR,Bakonykúti,001,129,74,0,74,0,0,74
FEJÉR,Balinka,001,380,148,0,148,0,1,147
FEJÉR,Balinka,002,387,177,0,177,0,0,177
FEJÉR,Baracs,001,729,285,0,285,0,2,283
FEJÉR,Baracs,002,659,263,0,263,0,2,261
FEJÉR,Baracs,003,817,376,0,376,0,1,375
FEJÉR,Baracs,004,696,253,0,253,0,2,251
FEJÉR,Baracska,001,1167,482,0,482,0,2,480
FEJÉR,Baracska,002,963,396,0,396,0,1,395
FEJÉR,Baracska,003,131,59,0,59,0,1,58
FEJÉR,Beloiannisz,001,908,335,0,335,0,6,329
FEJÉR,Besnyõ,001,692,233,0,233,0,2,231
FEJÉR,Besnyõ,002,764,247,0,247,0,4,243
FEJÉR,Bicske,001,1152,605,0,605,0,2,603
FEJÉR,Bicske,002,1198,404,0,404,0,1,403
FEJÉR,Bicske,003,1168,552,0,552,0,4,548
FEJÉR,Bicske,004,1208,591,0,591,0,2,589
FEJÉR,Bicske,005,1034,569,0,569,0,7,562
FEJÉR,Bicske,006,1126,565,0,565,0,4,561
FEJÉR,Bicske,007,1148,572,0,572,0,1,571
FEJÉR,Bicske,008,1093,436,0,436,0,0,436
FEJÉR,Bodajk,001,800,382,0,382,0,1,381
FEJÉR,Bodajk,002,771,344,0,344,0,1,343
FEJÉR,Bodajk,003,742,353,0,353,0,4,349
FEJÉR,Bodajk,004,954,448,0,448,0,3,445
FEJÉR,Bodmér,001,203,130,0,130,0,1,129
FEJÉR,Cece,001,740,306,0,306,0,1,305
FEJÉR,Cece,002,663,250,0,250,0,2,248
FEJÉR,Cece,003,688,219,0,219,0,0,219
FEJÉR,Csabdi,001,857,431,0,431,0,3,428
FEJÉR,Csabdi,002,165,68,0,68,0,0,68
FEJÉR,Csákberény,001,963,474,0,474,0,3,471
FEJÉR,Csákvár,001,924,413,0,413,0,2,411
FEJÉR,Csákvár,002,791,401,0,401,0,1,400
FEJÉR,Csákvár,003,935,472,0,472,0,2,470
FEJÉR,Csákvár,004,927,357,0,357,0,5,352
FEJÉR,Csákvár,005,765,348,0,348,0,2,346
FEJÉR,Csókakõ,001,1195,669,0,669,0,5,664
FEJÉR,Csór,001,834,325,0,325,0,3,322
FEJÉR,Csór,002,676,279,0,279,0,5,274
FEJÉR,Csõsz,001,815,244,0,244,0,1,243
FEJÉR,Dég,001,869,260,1,259,-1,0,259
FEJÉR,Dég,002,921,285,0,285,0,7,278
FEJÉR,Dunaújváros,001,1007,502,0,502,0,5,497
FEJÉR,Dunaújváros,002,878,418,1,417,-1,0,417
FEJÉR,Dunaújváros,003,493,234,0,234,0,1,233
FEJÉR,Dunaújváros,004,740,360,0,360,0,1,359
FEJÉR,Dunaújváros,005,1213,553,0,554,1,18,536
FEJÉR,Dunaújváros,006,560,293,0,294,1,11,283
FEJÉR,Dunaújváros,007,630,328,0,327,-1,0,327
FEJÉR,Dunaújváros,008,551,236,0,236,0,4,232
FEJÉR,Dunaújváros,009,706,328,0,328,0,0,328
FEJÉR,Dunaújváros,010,922,370,0,369,-1,4,365
FEJÉR,Dunaújváros,011,685,268,0,268,0,0,268
FEJÉR,Dunaújváros,012,795,338,0,338,0,1,337
FEJÉR,Dunaújváros,013,800,340,0,340,0,0,340
FEJÉR,Dunaújváros,014,845,340,0,340,0,0,340
FEJÉR,Dunaújváros,015,790,329,0,329,0,1,328
FEJÉR,Dunaújváros,016,713,317,0,317,0,0,317
FEJÉR,Dunaújváros,017,490,223,0,223,0,1,222
FEJÉR,Dunaújváros,018,792,322,0,322,0,0,322
FEJÉR,Dunaújváros,019,694,335,0,335,0,3,332
FEJÉR,Dunaújváros,020,696,334,0,334,0,1,333
FEJÉR,Dunaújváros,021,441,209,0,209,0,0,209
FEJÉR,Dunaújváros,022,827,411,0,411,0,0,411
FEJÉR,Dunaújváros,023,785,368,0,367,-1,4,363
FEJÉR,Dunaújváros,024,810,358,0,358,0,1,357
FEJÉR,Dunaújváros,025,748,312,0,312,0,1,311
FEJÉR,Dunaújváros,026,733,312,0,312,0,0,312
FEJÉR,Dunaújváros,027,639,279,0,279,0,0,279
FEJÉR,Dunaújváros,028,628,261,0,261,0,0,261
FEJÉR,Dunaújváros,029,609,285,0,285,0,1,284
FEJÉR,Dunaújváros,030,821,346,0,346,0,2,344
FEJÉR,Dunaújváros,031,576,261,0,261,0,1,260
FEJÉR,Dunaújváros,032,792,317,0,317,0,0,317
FEJÉR,Dunaújváros,033,780,299,0,296,-3,0,296
FEJÉR,Dunaújváros,034,597,255,0,255,0,1,254
FEJÉR,Dunaújváros,035,799,279,0,279,0,4,275
FEJÉR,Dunaújváros,036,949,429,0,429,0,1,428
FEJÉR,Dunaújváros,037,988,402,0,402,0,0,402
FEJÉR,Dunaújváros,038,1086,449,0,449,0,2,447
FEJÉR,Dunaújváros,039,989,360,0,360,0,2,358
FEJÉR,Dunaújváros,040,985,383,0,383,0,1,382
FEJÉR,Dunaújváros,041,1049,411,0,411,0,1,410
FEJÉR,Dunaújváros,042,994,446,0,446,0,1,445
FEJÉR,Dunaújváros,043,1010,560,0,559,-1,0,559
FEJÉR,Dunaújváros,044,1058,595,0,595,0,2,593
FEJÉR,Dunaújváros,045,1136,502,0,502,0,1,501
FEJÉR,Dunaújváros,046,1223,579,0,579,0,2,577
FEJÉR,Dunaújváros,047,423,129,0,129,0,0,129
FEJÉR,Elõszállás,001,831,265,0,265,0,2,263
FEJÉR,Elõszállás,002,489,160,0,160,0,0,160
FEJÉR,Elõszállás,003,563,224,0,224,0,1,223
FEJÉR,Enying,001,841,296,0,296,0,1,295
FEJÉR,Enying,002,834,280,0,280,0,1,279
FEJÉR,Enying,003,888,285,0,285,0,6,279
FEJÉR,Enying,004,977,297,0,297,0,0,297
FEJÉR,Enying,005,838,213,0,213,0,2,211
FEJÉR,Enying,006,566,168,0,168,0,0,168
FEJÉR,Enying,007,307,87,0,87,0,0,87
FEJÉR,Enying,008,145,55,0,55,0,0,55
FEJÉR,Ercsi,001,1071,365,0,365,0,6,359
FEJÉR,Ercsi,002,1030,422,0,422,0,1,421
FEJÉR,Ercsi,003,1151,526,0,526,0,5,521
FEJÉR,Ercsi,004,784,273,0,273,0,1,272
FEJÉR,Ercsi,005,905,374,0,374,0,2,372
FEJÉR,Ercsi,006,1086,252,0,252,0,4,248
FEJÉR,Ercsi,007,222,99,0,99,0,0,99
FEJÉR,Ercsi,008,283,119,0,119,0,1,118
FEJÉR,Etyek,001,1127,526,0,526,0,2,524
FEJÉR,Etyek,002,923,398,0,398,0,1,397
FEJÉR,Etyek,003,1197,562,0,562,0,3,559
FEJÉR,Etyek,004,117,33,0,33,0,0,33
FEJÉR,Fehérvárcsurgó,001,916,391,0,391,0,2,389
FEJÉR,Fehérvárcsurgó,002,746,312,0,312,0,2,310
FEJÉR,Felcsút,001,702,374,0,374,0,2,372
FEJÉR,Felcsút,002,803,486,0,486,0,4,482
FEJÉR,Füle,001,734,307,0,307,0,0,307
FEJÉR,Gánt,001,508,266,0,266,0,2,264
FEJÉR,Gárdony,001,1647,989,0,988,-1,0,988
FEJÉR,Gárdony,002,1004,440,0,440,0,4,436
FEJÉR,Gárdony,003,1305,632,0,631,-1,1,630
FEJÉR,Gárdony,004,1194,578,0,578,0,1,577
FEJÉR,Gárdony,005,1074,490,0,490,0,1,489
FEJÉR,Gárdony,006,1171,603,0,603,0,3,600
FEJÉR,Gárdony,007,1357,653,0,653,0,5,648
FEJÉR,Gárdony,008,893,339,2,338,-1,0,338
FEJÉR,Gyúró,001,1022,480,0,480,0,2,478
FEJÉR,Hantos,001,772,251,0,251,0,3,248
FEJÉR,Igar,001,318,119,0,119,0,0,119
FEJÉR,Igar,002,212,49,0,49,0,0,49
FEJÉR,Igar,003,247,60,0,60,0,3,57
FEJÉR,Iszkaszentgyörgy,001,982,443,0,443,0,6,437
FEJÉR,Iszkaszentgyörgy,002,728,287,0,286,-1,1,285
FEJÉR,Isztimér,001,670,295,0,295,0,4,291
FEJÉR,Isztimér,002,71,38,0,38,0,0,38
FEJÉR,Iváncsa,001,1206,400,0,400,0,3,397
FEJÉR,Iváncsa,002,1066,355,0,355,0,4,351
FEJÉR,Jenõ,001,1070,397,2,395,-2,4,391
FEJÉR,Kajászó,001,906,403,0,403,0,1,402
FEJÉR,Káloz,001,982,292,0,292,0,1,291
FEJÉR,Káloz,002,930,291,0,291,0,1,290
FEJÉR,Kápolnásnyék,001,1076,543,0,543,0,3,540
FEJÉR,Kápolnásnyék,002,836,385,0,385,0,1,384
FEJÉR,Kápolnásnyék,003,330,169,0,169,0,0,169
FEJÉR,Kápolnásnyék,004,878,403,0,403,0,1,402
FEJÉR,Kincsesbánya,001,540,204,0,204,0,1,203
FEJÉR,Kincsesbánya,002,713,308,0,308,0,1,307
FEJÉR,Kisapostag,001,588,274,0,274,0,1,273
FEJÉR,Kisapostag,002,631,288,0,288,0,0,288
FEJÉR,Kisláng,001,915,160,0,160,0,2,158
FEJÉR,Kisláng,002,1082,277,0,277,0,0,277
FEJÉR,Kõszárhegy,001,615,271,0,271,0,0,271
FEJÉR,Kõszárhegy,002,664,281,0,281,0,0,281
FEJÉR,Kulcs,001,1416,527,0,527,0,2,525
FEJÉR,Kulcs,002,1221,539,0,539,0,1,538
FEJÉR,Lajoskomárom,001,376,100,0,100,0,1,99
FEJÉR,Lajoskomárom,002,38,22,0,22,0,0,22
FEJÉR,Lajoskomárom,003,693,269,0,269,0,1,268
FEJÉR,Lajoskomárom,004,688,255,0,255,0,0,255
FEJÉR,Lepsény,001,895,329,0,329,0,2,327
FEJÉR,Lepsény,002,866,280,0,280,0,0,280
FEJÉR,Lepsény,003,765,291,0,291,0,1,290
FEJÉR,Lovasberény,001,727,298,0,298,0,3,295
FEJÉR,Lovasberény,002,716,314,0,314,0,0,314
FEJÉR,Lovasberény,003,767,304,0,304,0,0,304
FEJÉR,Magyaralmás,001,1311,641,0,641,0,5,636
FEJÉR,Martonvásár,001,1168,532,0,532,0,1,531
FEJÉR,Martonvásár,002,1129,561,0,561,0,2,559
FEJÉR,Martonvásár,003,1082,553,0,553,0,2,551
FEJÉR,Martonvásár,004,1156,542,0,542,0,2,540
FEJÉR,Mány,001,1060,515,0,515,0,1,514
FEJÉR,Mány,002,853,318,0,318,0,2,316
FEJÉR,Mátyásdomb,001,584,159,0,159,0,1,158
FEJÉR,Mezõfalva,001,1007,347,0,347,0,1,346
FEJÉR,Mezõfalva,002,971,310,0,310,0,1,309
FEJÉR,Mezõfalva,003,951,356,0,355,-1,1,354
FEJÉR,Mezõfalva,004,843,199,0,199,0,2,197
FEJÉR,Mezõkomárom,001,762,281,0,281,0,1,280
FEJÉR,Mezõszentgyörgy,001,473,154,0,154,0,0,154
FEJÉR,Mezõszentgyörgy,002,549,107,0,107,0,2,105
FEJÉR,Mezõszilas,001,727,195,0,194,-1,2,192
FEJÉR,Mezõszilas,002,963,305,0,305,0,1,304
FEJÉR,Moha,001,455,231,0,231,0,1,230
FEJÉR,Mór,001,722,352,0,352,0,3,349
FEJÉR,Mór,002,852,385,0,385,0,0,385
FEJÉR,Mór,003,757,313,0,313,0,3,310
FEJÉR,Mór,004,763,431,0,431,0,2,429
FEJÉR,Mór,005,708,311,0,311,0,0,311
FEJÉR,Mór,006,648,358,0,358,0,1,357
FEJÉR,Mór,007,935,447,0,447,0,1,446
FEJÉR,Mór,008,545,263,0,263,0,1,262
FEJÉR,Mór,009,821,439,0,439,0,0,439
FEJÉR,Mór,010,582,340,0,340,0,0,340
FEJÉR,Mór,011,1106,527,0,527,0,1,526
FEJÉR,Mór,012,1219,636,0,636,0,1,635
FEJÉR,Mór,013,715,374,0,374,0,0,374
FEJÉR,Mór,014,700,393,0,393,0,5,388
FEJÉR,Mór,015,167,69,0,69,0,0,69
FEJÉR,Nadap,001,488,277,0,277,0,0,277
FEJÉR,Nagykarácsony,001,490,162,1,161,-1,1,160
FEJÉR,Nagykarácsony,002,510,182,3,179,-3,1,178
FEJÉR,Nagykarácsony,003,135,46,0,46,0,1,45
FEJÉR,Nagylók,001,878,271,0,271,0,2,269
FEJÉR,Nagyveleg,001,513,226,0,226,0,0,226
FEJÉR,Nagyvenyim,001,776,344,0,344,0,0,344
FEJÉR,Nagyvenyim,002,859,440,0,440,0,1,439
FEJÉR,Nagyvenyim,003,857,435,0,435,0,4,431
FEJÉR,Nagyvenyim,004,783,400,0,400,0,1,399
FEJÉR,Nagyvenyim,005,107,40,0,40,0,0,40
FEJÉR,Nádasdladány,001,435,155,0,155,0,0,155
FEJÉR,Nádasdladány,002,533,199,0,199,0,0,199
FEJÉR,Nádasdladány,003,471,171,0,170,-1,0,170
FEJÉR,Óbarok,001,450,222,0,222,0,4,218
FEJÉR,Óbarok,002,207,72,0,72,0,0,72
FEJÉR,Pákozd,001,975,481,0,481,0,2,479
FEJÉR,Pákozd,002,941,460,0,460,0,4,456
FEJÉR,Pákozd,003,769,362,0,362,0,3,359
FEJÉR,Pátka,001,726,344,0,341,-3,2,339
FEJÉR,Pátka,002,683,258,0,258,0,2,256
FEJÉR,Pázmánd,001,919,463,2,462,-1,2,460
FEJÉR,Pázmánd,002,828,438,0,438,0,1,437
FEJÉR,Perkáta,001,759,221,0,221,0,2,219
FEJÉR,Perkáta,002,714,232,0,232,0,2,230
FEJÉR,Perkáta,003,796,241,0,241,0,4,237
FEJÉR,Perkáta,004,868,226,0,226,0,2,224
FEJÉR,Polgárdi,001,318,117,0,117,0,2,115
FEJÉR,Polgárdi,002,935,327,0,327,0,1,326
FEJÉR,Polgárdi,003,1024,391,0,391,0,2,389
FEJÉR,Polgárdi,004,961,293,0,293,0,1,292
FEJÉR,Polgárdi,005,808,229,0,229,0,3,226
FEJÉR,Polgárdi,006,1093,375,0,375,0,3,372
FEJÉR,Polgárdi,007,216,69,0,69,0,2,67
FEJÉR,Pusztaszabolcs,001,983,288,0,288,0,2,286
FEJÉR,Pusztaszabolcs,002,751,315,0,315,0,2,313
FEJÉR,Pusztaszabolcs,003,991,320,0,320,0,0,320
FEJÉR,Pusztaszabolcs,004,972,296,0,296,0,0,296
FEJÉR,Pusztaszabolcs,005,1164,380,0,380,0,1,379
FEJÉR,Pusztavám,001,754,361,0,361,0,0,361
FEJÉR,Pusztavám,002,625,265,0,265,0,4,261
FEJÉR,Pusztavám,003,571,291,0,291,0,3,288
FEJÉR,Rácalmás,001,946,422,0,422,0,0,422
FEJÉR,Rácalmás,002,983,366,0,366,0,3,363
FEJÉR,Rácalmás,003,946,450,0,450,0,1,449
FEJÉR,Rácalmás,004,970,482,0,482,0,0,482
FEJÉR,Ráckeresztúr,001,876,314,0,314,0,2,312
FEJÉR,Ráckeresztúr,002,909,291,0,291,0,2,289
FEJÉR,Ráckeresztúr,003,994,342,0,342,0,4,338
FEJÉR,Sárbogárd,001,720,218,0,218,0,2,216
FEJÉR,Sárbogárd,002,644,262,0,262,0,2,260
FEJÉR,Sárbogárd,003,514,219,0,219,0,0,219
FEJÉR,Sárbogárd,004,666,221,0,221,0,0,221
FEJÉR,Sárbogárd,005,618,224,0,224,0,2,222
FEJÉR,Sárbogárd,006,519,227,0,227,0,3,224
FEJÉR,Sárbogárd,007,566,215,1,215,0,1,214
FEJÉR,Sárbogárd,008,584,233,0,233,0,0,233
FEJÉR,Sárbogárd,009,605,264,0,264,0,1,263
FEJÉR,Sárbogárd,010,666,296,0,296,0,0,296
FEJÉR,Sárbogárd,011,683,251,0,250,-1,0,250
FEJÉR,Sárbogárd,012,712,242,0,242,0,1,241
FEJÉR,Sárbogárd,013,469,199,0,199,0,1,198
FEJÉR,Sárbogárd,014,648,230,0,230,0,1,229
FEJÉR,Sárbogárd,015,220,100,0,100,0,0,100
FEJÉR,Sárbogárd,016,162,72,0,72,0,0,72
FEJÉR,Sárbogárd,017,508,152,0,152,0,0,152
FEJÉR,Sárbogárd,018,196,76,0,76,0,3,73
FEJÉR,Sárbogárd,019,75,32,0,32,0,2,30
FEJÉR,Sáregres,001,567,227,0,227,0,1,226
FEJÉR,Sárkeresztes,001,1265,656,0,656,0,5,651
FEJÉR,Sárkeresztúr,001,646,130,1,129,-1,1,128
FEJÉR,Sárkeresztúr,002,1053,178,0,178,0,0,178
FEJÉR,Sárkeszi,001,483,161,0,161,0,3,158
FEJÉR,Sárosd,001,1076,287,0,287,0,3,284
FEJÉR,Sárosd,002,796,258,0,258,0,1,257
FEJÉR,Sárosd,003,751,206,0,206,0,5,201
FEJÉR,Sárszentágota,001,969,355,0,355,0,2,353
FEJÉR,Sárszentágota,002,151,62,0,62,0,0,62
FEJÉR,Sárszentmihály,001,849,344,0,344,0,5,339
FEJÉR,Sárszentmihály,002,922,424,0,424,0,1,423
FEJÉR,Sárszentmihály,003,755,230,0,230,0,4,226
FEJÉR,Seregélyes,001,1014,415,0,415,0,3,412
FEJÉR,Seregélyes,002,1082,352,0,351,-1,0,351
FEJÉR,Seregélyes,003,860,271,0,271,0,0,271
FEJÉR,Seregélyes,004,704,175,0,175,0,1,174
FEJÉR,Soponya,001,751,224,0,224,0,3,221
FEJÉR,Soponya,002,767,245,0,245,0,1,244
FEJÉR,Söréd,001,415,229,0,229,0,2,227
FEJÉR,Sukoró,001,1428,913,0,913,0,6,907
FEJÉR,Szabadbattyán,001,943,351,0,351,0,4,347
FEJÉR,Szabadbattyán,002,946,421,0,421,0,2,419
FEJÉR,Szabadbattyán,003,1031,345,0,345,0,1,344
FEJÉR,Szabadbattyán,004,995,389,0,389,0,0,389
FEJÉR,Szabadegyháza,001,1280,388,0,388,0,3,385
FEJÉR,Szabadegyháza,002,474,138,0,138,0,2,136
FEJÉR,Szabadhídvég,001,597,207,0,207,0,3,204
FEJÉR,Szabadhídvég,002,63,18,0,18,0,0,18
FEJÉR,Szár,001,641,364,0,365,1,10,355
FEJÉR,Szár,002,689,320,0,320,0,1,319
FEJÉR,Székesfehérvár,001,714,340,0,340,0,1,339
FEJÉR,Székesfehérvár,002,859,401,0,401,0,0,401
FEJÉR,Székesfehérvár,003,641,276,0,276,0,1,275
FEJÉR,Székesfehérvár,004,558,293,0,293,0,0,293
FEJÉR,Székesfehérvár,005,695,302,0,302,0,0,302
FEJÉR,Székesfehérvár,006,494,247,0,246,-1,1,245
FEJÉR,Székesfehérvár,007,960,509,0,509,0,0,509
FEJÉR,Székesfehérvár,008,780,435,0,435,0,2,433
FEJÉR,Székesfehérvár,009,890,368,1,368,0,2,366
FEJÉR,Székesfehérvár,010,810,363,0,363,0,1,362
FEJÉR,Székesfehérvár,011,784,385,0,385,0,2,383
FEJÉR,Székesfehérvár,012,805,406,0,406,0,3,403
FEJÉR,Székesfehérvár,013,947,442,0,442,0,0,442
FEJÉR,Székesfehérvár,014,775,377,0,377,0,3,374
FEJÉR,Székesfehérvár,015,656,307,0,307,0,2,305
FEJÉR,Székesfehérvár,016,705,342,0,342,0,1,341
FEJÉR,Székesfehérvár,017,699,272,0,272,0,1,271
FEJÉR,Székesfehérvár,018,830,402,0,402,0,1,401
FEJÉR,Székesfehérvár,019,805,397,0,397,0,1,396
FEJÉR,Székesfehérvár,020,832,322,0,321,-1,1,320
FEJÉR,Székesfehérvár,021,936,465,0,464,-1,0,464
FEJÉR,Székesfehérvár,022,860,397,0,395,-2,1,394
FEJÉR,Székesfehérvár,023,947,455,0,455,0,2,453
FEJÉR,Székesfehérvár,024,584,313,0,313,0,0,313
FEJÉR,Székesfehérvár,025,577,260,0,260,0,0,260
FEJÉR,Székesfehérvár,026,652,299,0,299,0,0,299
FEJÉR,Székesfehérvár,027,809,452,0,452,0,3,449
FEJÉR,Székesfehérvár,028,2299,1350,0,1349,-1,11,1338
FEJÉR,Székesfehérvár,029,861,354,0,354,0,1,353
FEJÉR,Székesfehérvár,030,1081,446,0,446,0,1,445
FEJÉR,Székesfehérvár,031,817,392,0,392,0,1,391
FEJÉR,Székesfehérvár,032,881,420,0,420,0,3,417
FEJÉR,Székesfehérvár,033,552,262,0,262,0,0,262
FEJÉR,Székesfehérvár,034,1111,529,0,529,0,1,528
FEJÉR,Székesfehérvár,035,918,424,0,423,-1,1,422
FEJÉR,Székesfehérvár,036,848,391,0,391,0,1,390
FEJÉR,Székesfehérvár,037,816,397,0,397,0,1,396
FEJÉR,Székesfehérvár,038,905,398,0,398,0,4,394
FEJÉR,Székesfehérvár,039,922,460,0,460,0,0,460
FEJÉR,Székesfehérvár,040,1102,486,0,485,-1,0,485
FEJÉR,Székesfehérvár,041,1056,492,0,492,0,0,492
FEJÉR,Székesfehérvár,042,1012,365,0,365,0,3,362
FEJÉR,Székesfehérvár,043,1036,553,0,553,0,0,553
FEJÉR,Székesfehérvár,044,982,445,0,445,0,2,443
FEJÉR,Székesfehérvár,045,678,327,0,327,0,1,326
FEJÉR,Székesfehérvár,046,857,398,0,398,0,0,398
FEJÉR,Székesfehérvár,047,833,404,0,404,0,1,403
FEJÉR,Székesfehérvár,048,1158,623,1,621,-2,1,620
FEJÉR,Székesfehérvár,049,1212,624,0,624,0,2,622
FEJÉR,Székesfehérvár,050,776,394,0,394,0,1,393
FEJÉR,Székesfehérvár,051,1235,573,0,573,0,0,573
FEJÉR,Székesfehérvár,052,648,360,0,360,0,2,358
FEJÉR,Székesfehérvár,053,852,459,0,459,0,2,457
FEJÉR,Székesfehérvár,054,1062,543,0,543,0,3,540
FEJÉR,Székesfehérvár,055,754,418,0,418,0,0,418
FEJÉR,Székesfehérvár,056,498,265,0,265,0,2,263
FEJÉR,Székesfehérvár,057,583,313,0,313,0,0,313
FEJÉR,Székesfehérvár,058,967,519,0,519,0,2,517
FEJÉR,Székesfehérvár,059,636,361,0,359,-2,2,357
FEJÉR,Székesfehérvár,060,562,350,0,350,0,2,348
FEJÉR,Székesfehérvár,061,624,348,0,348,0,1,347
FEJÉR,Székesfehérvár,062,723,384,0,384,0,4,380
FEJÉR,Székesfehérvár,063,853,501,0,499,-2,1,498
FEJÉR,Székesfehérvár,064,963,554,0,554,0,0,554
FEJÉR,Székesfehérvár,065,714,410,0,410,0,2,408
FEJÉR,Székesfehérvár,066,1069,607,0,606,-1,1,605
FEJÉR,Székesfehérvár,067,1103,586,0,585,-1,5,580
FEJÉR,Székesfehérvár,068,905,487,0,487,0,0,487
FEJÉR,Székesfehérvár,069,844,542,0,542,0,2,540
FEJÉR,Székesfehérvár,070,951,545,0,545,0,2,543
FEJÉR,Székesfehérvár,071,794,495,0,495,0,2,493
FEJÉR,Székesfehérvár,072,904,595,0,595,0,1,594
FEJÉR,Székesfehérvár,073,1184,665,0,665,0,0,665
FEJÉR,Székesfehérvár,074,660,340,0,340,0,2,338
FEJÉR,Székesfehérvár,075,378,201,0,201,0,1,200
FEJÉR,Székesfehérvár,076,1127,503,0,503,0,1,502
FEJÉR,Székesfehérvár,077,1018,599,0,599,0,5,594
FEJÉR,Székesfehérvár,078,1044,524,0,524,0,2,522
FEJÉR,Székesfehérvár,079,867,453,0,453,0,3,450
FEJÉR,Székesfehérvár,080,1043,559,0,559,0,2,557
FEJÉR,Székesfehérvár,081,838,377,0,377,0,1,376
FEJÉR,Székesfehérvár,082,553,283,0,283,0,1,282
FEJÉR,Székesfehérvár,083,851,460,0,460,0,2,458
FEJÉR,Székesfehérvár,084,637,290,0,290,0,0,290
FEJÉR,Székesfehérvár,085,955,525,2,521,-4,0,521
FEJÉR,Székesfehérvár,086,799,352,0,352,0,2,350
FEJÉR,Székesfehérvár,087,1025,480,0,480,0,1,479
FEJÉR,Székesfehérvár,088,789,407,0,407,0,0,407
FEJÉR,Székesfehérvár,089,1263,532,0,532,0,3,529
FEJÉR,Székesfehérvár,090,1299,600,0,599,-1,2,597
FEJÉR,Székesfehérvár,091,465,160,0,160,0,1,159
FEJÉR,Székesfehérvár,092,205,110,0,110,0,0,110
FEJÉR,Tabajd,001,756,354,1,354,0,3,351
FEJÉR,Tác,001,713,281,0,281,0,2,279
FEJÉR,Tác,002,639,249,0,249,0,1,248
FEJÉR,Tordas,001,1478,768,0,768,0,9,759
FEJÉR,Újbarok,001,356,176,0,176,0,0,176
FEJÉR,Úrhida,001,926,390,0,390,0,2,388
FEJÉR,Úrhida,002,1010,404,1,403,-1,0,403
FEJÉR,Vajta,001,665,221,0,221,0,0,221
FEJÉR,Vál,001,775,361,0,361,0,1,360
FEJÉR,Vál,002,703,298,0,298,0,3,295
FEJÉR,Vál,003,574,278,0,278,0,2,276
FEJÉR,Velence,001,1131,559,2,557,-2,4,553
FEJÉR,Velence,002,782,391,0,391,0,5,386
FEJÉR,Velence,003,1213,707,0,707,0,1,706
FEJÉR,Velence,004,1030,550,0,550,0,3,547
FEJÉR,Velence,005,1156,609,0,609,0,5,604
FEJÉR,Vereb,001,635,261,0,260,-1,1,259
FEJÉR,Vértesacsa,001,724,265,0,265,0,1,264
FEJÉR,Vértesacsa,002,710,306,0,306,0,1,305
FEJÉR,Vértesboglár,001,735,415,0,415,0,2,413
FEJÉR,Zámoly,001,931,317,0,317,0,0,317
FEJÉR,Zámoly,002,933,361,0,360,-1,1,359
FEJÉR,Zichyújfalu,001,765,312,0,312,0,0,312
FEJÉR,Daruszentmiklós,001,581,211,0,211,0,5,206
FEJÉR,Daruszentmiklós,002,424,129,3,126,-3,0,126
GYÕR-MOSON-SOPRON,Abda,001,624,307,0,307,0,0,307
GYÕR-MOSON-SOPRON,Abda,002,670,253,0,253,0,2,251
GYÕR-MOSON-SOPRON,Abda,003,747,320,0,320,0,2,318
GYÕR-MOSON-SOPRON,Abda,004,585,259,0,259,0,1,258
GYÕR-MOSON-SOPRON,Acsalag,001,391,251,0,251,0,0,251
GYÕR-MOSON-SOPRON,Agyagosszergény,001,751,393,0,392,-1,1,391
GYÕR-MOSON-SOPRON,Ágfalva,001,860,376,0,376,0,2,374
GYÕR-MOSON-SOPRON,Ágfalva,002,893,442,0,442,0,2,440
GYÕR-MOSON-SOPRON,Árpás,001,211,123,0,123,0,0,123
GYÕR-MOSON-SOPRON,Ásványráró,001,895,338,0,338,0,4,334
GYÕR-MOSON-SOPRON,Ásványráró,002,754,322,0,322,0,1,321
GYÕR-MOSON-SOPRON,Babót,001,938,467,0,467,0,2,465
GYÕR-MOSON-SOPRON,Bakonygyirót,001,132,77,0,77,0,1,76
GYÕR-MOSON-SOPRON,Bakonypéterd,001,231,109,0,109,0,0,109
GYÕR-MOSON-SOPRON,Bakonyszentlászló,001,861,339,0,339,0,3,336
GYÕR-MOSON-SOPRON,Bakonyszentlászló,002,616,230,0,230,0,1,229
GYÕR-MOSON-SOPRON,Barbacs,001,606,235,0,235,0,4,231
GYÕR-MOSON-SOPRON,Bágyogszovát,001,571,299,0,299,0,1,298
GYÕR-MOSON-SOPRON,Bágyogszovát,002,529,234,0,234,0,0,234
GYÕR-MOSON-SOPRON,Beled,001,954,436,0,436,0,3,433
GYÕR-MOSON-SOPRON,Beled,002,936,456,0,456,0,4,452
GYÕR-MOSON-SOPRON,Beled,003,266,125,0,125,0,0,125
GYÕR-MOSON-SOPRON,Bezenye,001,422,209,0,209,0,0,209
GYÕR-MOSON-SOPRON,Bezenye,002,387,202,0,202,0,1,201
GYÕR-MOSON-SOPRON,Bezenye,003,151,72,0,72,0,1,71
GYÕR-MOSON-SOPRON,Bezi,001,408,169,0,169,0,1,168
GYÕR-MOSON-SOPRON,Bodonhely,001,264,140,0,140,0,0,140
GYÕR-MOSON-SOPRON,Bogyoszló,001,528,256,0,256,0,1,255
GYÕR-MOSON-SOPRON,Börcs,001,1023,397,0,397,0,4,393
GYÕR-MOSON-SOPRON,Bõny,001,792,284,0,284,0,1,283
GYÕR-MOSON-SOPRON,Bõny,002,807,260,0,260,0,2,258
GYÕR-MOSON-SOPRON,Bõny,003,192,85,0,85,0,0,85
GYÕR-MOSON-SOPRON,Bõsárkány,001,877,371,0,371,0,1,370
GYÕR-MOSON-SOPRON,Bõsárkány,002,865,354,0,354,0,1,353
GYÕR-MOSON-SOPRON,Cakóháza,001,43,32,0,32,0,4,28
GYÕR-MOSON-SOPRON,Cirák,001,436,176,0,176,0,3,173
GYÕR-MOSON-SOPRON,Csapod,001,433,187,0,186,-1,3,183
GYÕR-MOSON-SOPRON,Csáfordjánosfa,001,179,98,0,98,0,2,96
GYÕR-MOSON-SOPRON,Csér,001,29,20,0,20,0,0,20
GYÕR-MOSON-SOPRON,Csikvánd,001,409,204,0,204,0,0,204
GYÕR-MOSON-SOPRON,Csorna,001,1082,563,0,563,0,2,561
GYÕR-MOSON-SOPRON,Csorna,002,1062,564,0,564,0,2,562
GYÕR-MOSON-SOPRON,Csorna,003,1033,498,0,498,0,4,494
GYÕR-MOSON-SOPRON,Csorna,004,1033,579,0,579,0,2,577
GYÕR-MOSON-SOPRON,Csorna,005,1004,510,0,510,0,3,507
GYÕR-MOSON-SOPRON,Csorna,006,978,512,0,512,0,2,510
GYÕR-MOSON-SOPRON,Csorna,007,971,474,0,474,0,2,472
GYÕR-MOSON-SOPRON,Csorna,008,1066,508,0,508,0,1,507
GYÕR-MOSON-SOPRON,Darnózseli,001,631,254,0,254,0,2,252
GYÕR-MOSON-SOPRON,Darnózseli,002,660,311,0,311,0,0,311
GYÕR-MOSON-SOPRON,Dénesfa,001,322,157,0,157,0,0,157
GYÕR-MOSON-SOPRON,Dör,001,501,275,0,275,0,0,275
GYÕR-MOSON-SOPRON,Dunakiliti,001,676,276,0,276,0,0,276
GYÕR-MOSON-SOPRON,Dunakiliti,002,763,326,0,326,0,4,322
GYÕR-MOSON-SOPRON,Dunaremete,001,209,99,0,99,0,1,98
GYÕR-MOSON-SOPRON,Dunaszeg,001,860,341,0,341,0,1,340
GYÕR-MOSON-SOPRON,Dunaszeg,002,838,303,0,303,0,1,302
GYÕR-MOSON-SOPRON,Dunaszentpál,001,589,211,0,211,0,0,211
GYÕR-MOSON-SOPRON,Dunasziget,001,193,83,0,83,0,0,83
GYÕR-MOSON-SOPRON,Dunasziget,002,447,205,0,205,0,1,204
GYÕR-MOSON-SOPRON,Dunasziget,003,584,277,0,276,-1,2,274
GYÕR-MOSON-SOPRON,Ebergõc,001,135,72,0,72,0,1,71
GYÕR-MOSON-SOPRON,Edve,001,102,72,0,72,0,0,72
GYÕR-MOSON-SOPRON,Egyed,001,433,224,0,224,0,1,223
GYÕR-MOSON-SOPRON,Egyházasfalu,001,715,361,0,361,0,3,358
GYÕR-MOSON-SOPRON,Enese,001,1419,583,0,583,0,1,582
GYÕR-MOSON-SOPRON,Écs,001,883,371,0,371,0,0,371
GYÕR-MOSON-SOPRON,Écs,002,759,379,0,379,0,0,379
GYÕR-MOSON-SOPRON,Farád,001,771,411,0,411,0,10,401
GYÕR-MOSON-SOPRON,Farád,002,798,373,0,373,0,0,373
GYÕR-MOSON-SOPRON,Fehértó,001,378,164,0,164,0,1,163
GYÕR-MOSON-SOPRON,Feketeerdõ,001,430,202,0,202,0,1,201
GYÕR-MOSON-SOPRON,Felpéc,001,758,306,0,306,0,1,305
GYÕR-MOSON-SOPRON,Fenyõfõ,001,97,48,0,48,0,3,45
GYÕR-MOSON-SOPRON,Fertõboz,001,248,134,0,134,0,0,134
GYÕR-MOSON-SOPRON,Fertõd,001,1105,560,0,560,0,4,556
GYÕR-MOSON-SOPRON,Fertõd,002,653,365,0,365,0,2,363
GYÕR-MOSON-SOPRON,Fertõd,003,807,347,0,347,0,2,345
GYÕR-MOSON-SOPRON,Fertõd,004,99,36,0,36,0,0,36
GYÕR-MOSON-SOPRON,Fertõendréd,001,500,260,0,260,0,1,259
GYÕR-MOSON-SOPRON,Fertõhomok,001,623,331,0,331,0,2,329
GYÕR-MOSON-SOPRON,Fertõrákos,001,940,392,0,392,0,1,391
GYÕR-MOSON-SOPRON,Fertõrákos,002,870,414,0,414,0,5,409
GYÕR-MOSON-SOPRON,Fertõszentmiklós,001,908,452,0,452,0,0,452
GYÕR-MOSON-SOPRON,Fertõszentmiklós,002,824,448,0,448,0,1,447
GYÕR-MOSON-SOPRON,Fertõszentmiklós,003,700,393,0,393,0,2,391
GYÕR-MOSON-SOPRON,Fertõszentmiklós,004,667,333,0,333,0,1,332
GYÕR-MOSON-SOPRON,Fertõszéplak,001,1016,488,0,488,0,3,485
GYÕR-MOSON-SOPRON,Gönyû,001,851,303,0,303,0,2,301
GYÕR-MOSON-SOPRON,Gönyû,002,852,325,0,325,0,2,323
GYÕR-MOSON-SOPRON,Gönyû,003,844,326,0,326,0,1,325
GYÕR-MOSON-SOPRON,Gyalóka,001,55,32,0,32,0,0,32
GYÕR-MOSON-SOPRON,Gyarmat,001,1097,521,0,521,0,5,516
GYÕR-MOSON-SOPRON,Gyóró,001,324,167,0,167,0,0,167
GYÕR-MOSON-SOPRON,Gyömöre,001,973,364,0,364,0,1,363
GYÕR-MOSON-SOPRON,Gyõr,001,1082,511,0,511,0,0,511
GYÕR-MOSON-SOPRON,Gyõr,002,1120,429,0,429,0,1,428
GYÕR-MOSON-SOPRON,Gyõr,003,1016,493,0,493,0,1,492
GYÕR-MOSON-SOPRON,Gyõr,004,1040,392,0,392,0,1,391
GYÕR-MOSON-SOPRON,Gyõr,005,996,388,0,387,-1,0,387
GYÕR-MOSON-SOPRON,Gyõr,006,1048,565,0,565,0,4,561
GYÕR-MOSON-SOPRON,Gyõr,007,883,412,1,410,-2,4,406
GYÕR-MOSON-SOPRON,Gyõr,008,2163,1618,0,1618,0,0,1618
GYÕR-MOSON-SOPRON,Gyõr,009,720,359,0,358,-1,1,357
GYÕR-MOSON-SOPRON,Gyõr,010,822,406,0,406,0,2,404
GYÕR-MOSON-SOPRON,Gyõr,011,1099,418,0,418,0,0,418
GYÕR-MOSON-SOPRON,Gyõr,012,1057,333,0,333,0,0,333
GYÕR-MOSON-SOPRON,Gyõr,013,748,435,0,435,0,5,430
GYÕR-MOSON-SOPRON,Gyõr,014,896,399,0,399,0,1,398
GYÕR-MOSON-SOPRON,Gyõr,015,973,527,0,527,0,0,527
GYÕR-MOSON-SOPRON,Gyõr,016,917,492,0,492,0,1,491
GYÕR-MOSON-SOPRON,Gyõr,017,930,466,0,466,0,0,466
GYÕR-MOSON-SOPRON,Gyõr,018,828,498,0,496,-2,1,495
GYÕR-MOSON-SOPRON,Gyõr,019,842,429,0,429,0,0,429
GYÕR-MOSON-SOPRON,Gyõr,020,719,396,0,396,0,1,395
GYÕR-MOSON-SOPRON,Gyõr,021,1176,582,0,582,0,0,582
GYÕR-MOSON-SOPRON,Gyõr,022,1228,644,0,644,0,3,641
GYÕR-MOSON-SOPRON,Gyõr,023,1183,621,0,621,0,2,619
GYÕR-MOSON-SOPRON,Gyõr,024,1233,590,0,590,0,0,590
GYÕR-MOSON-SOPRON,Gyõr,025,1068,589,0,589,0,1,588
GYÕR-MOSON-SOPRON,Gyõr,026,1203,660,0,660,0,0,660
GYÕR-MOSON-SOPRON,Gyõr,027,1244,605,0,605,0,0,605
GYÕR-MOSON-SOPRON,Gyõr,028,1123,584,0,584,0,0,584
GYÕR-MOSON-SOPRON,Gyõr,029,1099,552,0,554,2,18,536
GYÕR-MOSON-SOPRON,Gyõr,030,930,539,0,539,0,1,538
GYÕR-MOSON-SOPRON,Gyõr,031,846,402,0,402,0,1,401
GYÕR-MOSON-SOPRON,Gyõr,032,874,390,0,390,0,0,390
GYÕR-MOSON-SOPRON,Gyõr,033,973,453,0,453,0,2,451
GYÕR-MOSON-SOPRON,Gyõr,034,1037,468,0,468,0,2,466
GYÕR-MOSON-SOPRON,Gyõr,035,1005,383,0,383,0,0,383
GYÕR-MOSON-SOPRON,Gyõr,036,1042,438,1,437,-1,0,437
GYÕR-MOSON-SOPRON,Gyõr,037,1094,393,0,393,0,1,392
GYÕR-MOSON-SOPRON,Gyõr,038,1037,389,0,389,0,1,388
GYÕR-MOSON-SOPRON,Gyõr,039,1079,473,0,473,0,0,473
GYÕR-MOSON-SOPRON,Gyõr,040,1200,482,0,482,0,0,482
GYÕR-MOSON-SOPRON,Gyõr,041,868,364,0,364,0,1,363
GYÕR-MOSON-SOPRON,Gyõr,042,1034,407,0,407,0,2,405
GYÕR-MOSON-SOPRON,Gyõr,043,1004,365,0,364,-1,1,363
GYÕR-MOSON-SOPRON,Gyõr,044,919,401,0,401,0,3,398
GYÕR-MOSON-SOPRON,Gyõr,045,950,452,0,452,0,1,451
GYÕR-MOSON-SOPRON,Gyõr,046,910,380,0,380,0,0,380
GYÕR-MOSON-SOPRON,Gyõr,047,963,396,0,396,0,0,396
GYÕR-MOSON-SOPRON,Gyõr,048,907,405,0,405,0,2,403
GYÕR-MOSON-SOPRON,Gyõr,049,906,328,0,328,0,1,327
GYÕR-MOSON-SOPRON,Gyõr,050,866,379,0,379,0,1,378
GYÕR-MOSON-SOPRON,Gyõr,051,892,393,0,393,0,3,390
GYÕR-MOSON-SOPRON,Gyõr,052,1055,598,0,597,-1,3,594
GYÕR-MOSON-SOPRON,Gyõr,053,839,407,0,407,0,4,403
GYÕR-MOSON-SOPRON,Gyõr,054,1098,538,0,538,0,6,532
GYÕR-MOSON-SOPRON,Gyõr,055,1083,325,0,325,0,2,323
GYÕR-MOSON-SOPRON,Gyõr,056,1018,399,0,398,-1,0,398
GYÕR-MOSON-SOPRON,Gyõr,057,947,394,0,394,0,0,394
GYÕR-MOSON-SOPRON,Gyõr,058,1110,522,0,522,0,2,520
GYÕR-MOSON-SOPRON,Gyõr,059,1046,526,0,526,0,1,525
GYÕR-MOSON-SOPRON,Gyõr,060,1014,420,1,417,-3,0,417
GYÕR-MOSON-SOPRON,Gyõr,061,961,503,0,503,0,2,501
GYÕR-MOSON-SOPRON,Gyõr,062,1131,506,0,506,0,3,503
GYÕR-MOSON-SOPRON,Gyõr,063,1043,473,0,473,0,0,473
GYÕR-MOSON-SOPRON,Gyõr,064,1101,502,0,502,0,4,498
GYÕR-MOSON-SOPRON,Gyõr,065,991,420,0,420,0,0,420
GYÕR-MOSON-SOPRON,Gyõr,066,957,421,0,420,-1,0,420
GYÕR-MOSON-SOPRON,Gyõr,067,1022,446,0,445,-1,1,444
GYÕR-MOSON-SOPRON,Gyõr,068,891,437,0,437,0,0,437
GYÕR-MOSON-SOPRON,Gyõr,069,992,570,0,570,0,4,566
GYÕR-MOSON-SOPRON,Gyõr,070,883,483,0,483,0,1,482
GYÕR-MOSON-SOPRON,Gyõr,071,963,349,0,349,0,0,349
GYÕR-MOSON-SOPRON,Gyõr,072,1162,490,0,490,0,1,489
GYÕR-MOSON-SOPRON,Gyõr,073,1075,400,0,400,0,2,398
GYÕR-MOSON-SOPRON,Gyõr,074,1063,485,0,485,0,3,482
GYÕR-MOSON-SOPRON,Gyõr,075,882,517,0,517,0,1,516
GYÕR-MOSON-SOPRON,Gyõr,076,946,462,0,462,0,1,461
GYÕR-MOSON-SOPRON,Gyõr,077,1002,525,0,525,0,1,524
GYÕR-MOSON-SOPRON,Gyõr,078,950,505,0,505,0,2,503
GYÕR-MOSON-SOPRON,Gyõr,079,935,489,0,489,0,0,489
GYÕR-MOSON-SOPRON,Gyõr,080,1131,621,0,620,-1,3,617
GYÕR-MOSON-SOPRON,Gyõr,081,1074,596,0,596,0,2,594
GYÕR-MOSON-SOPRON,Gyõr,082,1217,389,0,389,0,1,388
GYÕR-MOSON-SOPRON,Gyõr,083,1139,462,0,462,0,0,462
GYÕR-MOSON-SOPRON,Gyõr,084,1123,483,0,483,0,0,483
GYÕR-MOSON-SOPRON,Gyõr,085,1143,468,0,468,0,1,467
GYÕR-MOSON-SOPRON,Gyõr,086,1112,534,0,534,0,0,534
GYÕR-MOSON-SOPRON,Gyõr,087,1086,462,0,462,0,3,459
GYÕR-MOSON-SOPRON,Gyõr,088,1274,559,0,559,0,4,555
GYÕR-MOSON-SOPRON,Gyõr,089,1217,575,0,575,0,1,574
GYÕR-MOSON-SOPRON,Gyõr,090,1117,573,0,573,0,0,573
GYÕR-MOSON-SOPRON,Gyõr,091,1133,576,0,576,0,0,576
GYÕR-MOSON-SOPRON,Gyõr,092,1114,597,0,597,0,2,595
GYÕR-MOSON-SOPRON,Gyõr,093,1188,563,0,563,0,4,559
GYÕR-MOSON-SOPRON,Gyõr,094,1196,579,0,579,0,1,578
GYÕR-MOSON-SOPRON,Gyõr,095,1090,569,0,569,0,5,564
GYÕR-MOSON-SOPRON,Gyõr,096,1225,595,0,595,0,2,593
GYÕR-MOSON-SOPRON,Gyõrasszonyfa,001,425,176,0,176,0,2,174
GYÕR-MOSON-SOPRON,Gyõrladamér,001,1347,604,0,604,0,0,604
GYÕR-MOSON-SOPRON,Gyõrság,001,1209,530,0,530,0,2,528
GYÕR-MOSON-SOPRON,Gyõrsövényház,001,646,257,0,257,0,2,255
GYÕR-MOSON-SOPRON,Gyõrszemere,001,770,214,0,214,0,0,214
GYÕR-MOSON-SOPRON,Gyõrszemere,002,827,255,0,255,0,1,254
GYÕR-MOSON-SOPRON,Gyõrszemere,003,965,421,0,421,0,2,419
GYÕR-MOSON-SOPRON,Gyõrújbarát,001,1099,557,0,557,0,1,556
GYÕR-MOSON-SOPRON,Gyõrújbarát,002,1140,606,0,606,0,0,606
GYÕR-MOSON-SOPRON,Gyõrújbarát,003,1096,579,0,579,0,1,578
GYÕR-MOSON-SOPRON,Gyõrújbarát,004,1098,550,0,550,0,6,544
GYÕR-MOSON-SOPRON,Gyõrújbarát,005,1023,478,0,478,0,2,476
GYÕR-MOSON-SOPRON,Gyõrújfalu,001,1550,832,0,832,0,1,831
GYÕR-MOSON-SOPRON,Gyõrzámoly,001,1206,535,0,535,0,4,531
GYÕR-MOSON-SOPRON,Gyõrzámoly,002,1094,484,0,484,0,0,484
GYÕR-MOSON-SOPRON,Halászi,001,1175,481,0,481,0,2,479
GYÕR-MOSON-SOPRON,Halászi,002,1233,554,0,554,0,2,552
GYÕR-MOSON-SOPRON,Halászi,003,130,55,0,55,0,0,55
GYÕR-MOSON-SOPRON,Harka,001,978,388,0,388,0,0,388
GYÕR-MOSON-SOPRON,Harka,002,961,504,0,504,0,2,502
GYÕR-MOSON-SOPRON,Hegyeshalom,001,958,417,0,417,0,3,414
GYÕR-MOSON-SOPRON,Hegyeshalom,002,954,344,0,344,0,0,344
GYÕR-MOSON-SOPRON,Hegyeshalom,003,800,313,0,313,0,1,312
GYÕR-MOSON-SOPRON,Hegykõ,001,1232,682,0,682,0,2,680
GYÕR-MOSON-SOPRON,Hédervár,001,980,397,0,397,0,1,396
GYÕR-MOSON-SOPRON,Hidegség,001,332,197,0,197,0,0,197
GYÕR-MOSON-SOPRON,Himod,001,531,263,0,263,0,2,261
GYÕR-MOSON-SOPRON,Hövej,001,253,155,0,155,0,0,155
GYÕR-MOSON-SOPRON,Ikrény,001,797,355,0,355,0,1,354
GYÕR-MOSON-SOPRON,Ikrény,002,680,315,0,315,0,1,314
GYÕR-MOSON-SOPRON,Iván,001,996,374,0,374,0,2,372
GYÕR-MOSON-SOPRON,Jánossomorja,001,841,342,0,342,0,2,340
GYÕR-MOSON-SOPRON,Jánossomorja,002,841,318,0,318,0,3,315
GYÕR-MOSON-SOPRON,Jánossomorja,003,721,275,0,275,0,1,274
GYÕR-MOSON-SOPRON,Jánossomorja,004,819,367,0,367,0,4,363
GYÕR-MOSON-SOPRON,Jánossomorja,005,807,313,0,313,0,2,311
GYÕR-MOSON-SOPRON,Jánossomorja,006,632,248,0,248,0,1,247
GYÕR-MOSON-SOPRON,Jánossomorja,007,206,50,0,50,0,2,48
GYÕR-MOSON-SOPRON,Jobaháza,001,468,198,0,198,0,1,197
GYÕR-MOSON-SOPRON,Kajárpéc,001,1031,434,0,434,0,2,432
GYÕR-MOSON-SOPRON,Kapuvár,001,142,62,0,62,0,1,61
GYÕR-MOSON-SOPRON,Kapuvár,002,1164,608,0,608,0,3,605
GYÕR-MOSON-SOPRON,Kapuvár,003,991,494,0,494,0,6,488
GYÕR-MOSON-SOPRON,Kapuvár,004,953,527,3,523,-4,2,521
GYÕR-MOSON-SOPRON,Kapuvár,005,1016,523,0,523,0,2,521
GYÕR-MOSON-SOPRON,Kapuvár,006,1068,499,0,499,0,0,499
GYÕR-MOSON-SOPRON,Kapuvár,007,1008,490,0,490,0,1,489
GYÕR-MOSON-SOPRON,Kapuvár,008,1044,556,0,555,-1,5,550
GYÕR-MOSON-SOPRON,Kapuvár,009,876,439,0,439,0,3,436
GYÕR-MOSON-SOPRON,Kimle,001,681,270,0,270,0,1,269
GYÕR-MOSON-SOPRON,Kimle,002,956,362,0,361,-1,3,358
GYÕR-MOSON-SOPRON,Kimle,003,193,90,0,90,0,0,90
GYÕR-MOSON-SOPRON,Kisbabot,001,199,127,0,127,0,0,127
GYÕR-MOSON-SOPRON,Kisbajcs,001,707,339,0,339,0,4,335
GYÕR-MOSON-SOPRON,Kisbodak,001,288,156,0,156,0,0,156
GYÕR-MOSON-SOPRON,Kisfalud,001,622,342,1,341,-1,1,340
GYÕR-MOSON-SOPRON,Koroncó,001,846,329,0,329,0,2,327
GYÕR-MOSON-SOPRON,Koroncó,002,939,346,0,346,0,1,345
GYÕR-MOSON-SOPRON,Kóny,001,1083,498,0,498,0,2,496
GYÕR-MOSON-SOPRON,Kóny,002,1109,503,0,503,0,1,502
GYÕR-MOSON-SOPRON,Kópháza,001,871,433,0,433,0,4,429
GYÕR-MOSON-SOPRON,Kópháza,002,800,420,0,420,0,3,417
GYÕR-MOSON-SOPRON,Kunsziget,001,998,482,0,482,0,2,480
GYÕR-MOSON-SOPRON,Lázi,001,446,175,0,175,0,1,174
GYÕR-MOSON-SOPRON,Levél,001,714,270,0,270,0,2,268
GYÕR-MOSON-SOPRON,Levél,002,779,279,1,278,-1,2,276
GYÕR-MOSON-SOPRON,Lébény,001,1093,482,0,482,0,4,478
GYÕR-MOSON-SOPRON,Lébény,002,659,269,0,269,0,5,264
GYÕR-MOSON-SOPRON,Lébény,003,793,342,0,341,-1,1,340
GYÕR-MOSON-SOPRON,Lipót,001,602,288,0,288,0,0,288
GYÕR-MOSON-SOPRON,Lövõ,001,1175,582,0,582,0,3,579
GYÕR-MOSON-SOPRON,Maglóca,001,83,57,0,57,0,1,56
GYÕR-MOSON-SOPRON,Magyarkeresztúr,001,388,147,0,147,0,1,146
GYÕR-MOSON-SOPRON,Markotabödöge,001,390,162,0,162,0,0,162
GYÕR-MOSON-SOPRON,Máriakálnok,001,705,303,0,303,0,1,302
GYÕR-MOSON-SOPRON,Máriakálnok,002,804,300,0,300,0,1,299
GYÕR-MOSON-SOPRON,Mecsér,001,504,229,0,229,0,2,227
GYÕR-MOSON-SOPRON,Mezõörs,001,776,349,0,349,0,0,349
GYÕR-MOSON-SOPRON,Mérges,001,84,47,0,47,0,0,47
GYÕR-MOSON-SOPRON,Mihályi,001,897,498,0,497,-1,4,493
GYÕR-MOSON-SOPRON,Mosonmagyaróvár,001,820,350,0,349,-1,1,348
GYÕR-MOSON-SOPRON,Mosonmagyaróvár,002,762,267,0,267,0,2,265
GYÕR-MOSON-SOPRON,Mosonmagyaróvár,003,1086,592,0,592,0,1,591
GYÕR-MOSON-SOPRON,Mosonmagyaróvár,004,1045,458,0,456,-2,0,456
GYÕR-MOSON-SOPRON,Mosonmagyaróvár,005,780,318,0,318,0,2,316
GYÕR-MOSON-SOPRON,Mosonmagyaróvár,006,878,343,0,343,0,0,343
GYÕR-MOSON-SOPRON,Mosonmagyaróvár,007,910,355,0,355,0,3,352
GYÕR-MOSON-SOPRON,Mosonmagyaróvár,008,1218,580,0,580,0,0,580
GYÕR-MOSON-SOPRON,Mosonmagyaróvár,009,787,350,0,350,0,0,350
GYÕR-MOSON-SOPRON,Mosonmagyaróvár,010,913,346,0,346,0,0,346
GYÕR-MOSON-SOPRON,Mosonmagyaróvár,011,870,316,0,316,0,2,314
GYÕR-MOSON-SOPRON,Mosonmagyaróvár,012,775,377,0,377,0,3,374
GYÕR-MOSON-SOPRON,Mosonmagyaróvár,013,927,389,0,389,0,5,384
GYÕR-MOSON-SOPRON,Mosonmagyaróvár,014,923,400,0,400,0,1,399
GYÕR-MOSON-SOPRON,Mosonmagyaróvár,015,718,330,0,330,0,3,327
GYÕR-MOSON-SOPRON,Mosonmagyaróvár,016,722,333,0,333,0,0,333
GYÕR-MOSON-SOPRON,Mosonmagyaróvár,017,818,336,0,336,0,0,336
GYÕR-MOSON-SOPRON,Mosonmagyaróvár,018,857,373,0,373,0,1,372
GYÕR-MOSON-SOPRON,Mosonmagyaróvár,019,869,332,0,332,0,1,331
GYÕR-MOSON-SOPRON,Mosonmagyaróvár,020,811,325,0,325,0,1,324
GYÕR-MOSON-SOPRON,Mosonmagyaróvár,021,761,270,0,270,0,2,268
GYÕR-MOSON-SOPRON,Mosonmagyaróvár,022,917,394,0,394,0,4,390
GYÕR-MOSON-SOPRON,Mosonmagyaróvár,023,701,241,0,241,0,2,239
GYÕR-MOSON-SOPRON,Mosonmagyaróvár,024,682,306,0,306,0,5,301
GYÕR-MOSON-SOPRON,Mosonmagyaróvár,025,773,244,0,243,-1,2,241
GYÕR-MOSON-SOPRON,Mosonmagyaróvár,026,832,316,0,316,0,1,315
GYÕR-MOSON-SOPRON,Mosonmagyaróvár,027,873,335,0,335,0,2,333
GYÕR-MOSON-SOPRON,Mosonmagyaróvár,028,877,321,0,321,0,1,320
GYÕR-MOSON-SOPRON,Mosonmagyaróvár,029,785,324,0,324,0,2,322
GYÕR-MOSON-SOPRON,Mosonmagyaróvár,030,809,375,0,375,0,2,373
GYÕR-MOSON-SOPRON,Mosonszentmiklós,001,974,391,0,391,0,2,389
GYÕR-MOSON-SOPRON,Mosonszentmiklós,002,1055,394,0,394,0,0,394
GYÕR-MOSON-SOPRON,Mosonszolnok,001,702,241,0,241,0,0,241
GYÕR-MOSON-SOPRON,Mosonszolnok,002,683,258,0,258,0,0,258
GYÕR-MOSON-SOPRON,Mórichida,001,681,318,0,318,0,1,317
GYÕR-MOSON-SOPRON,Nagybajcs,001,791,391,0,391,0,2,389
GYÕR-MOSON-SOPRON,Nagycenk,001,854,394,0,394,0,1,393
GYÕR-MOSON-SOPRON,Nagycenk,002,876,421,0,421,0,1,420
GYÕR-MOSON-SOPRON,Nagylózs,001,825,407,0,407,0,1,406
GYÕR-MOSON-SOPRON,Nagyszentjános,001,635,225,0,225,0,1,224
GYÕR-MOSON-SOPRON,Nagyszentjános,002,842,299,0,299,0,3,296
GYÕR-MOSON-SOPRON,Nemeskér,001,172,101,0,101,0,0,101
GYÕR-MOSON-SOPRON,Nyalka,001,364,186,0,186,0,0,186
GYÕR-MOSON-SOPRON,Nyúl,001,931,490,0,490,0,1,489
GYÕR-MOSON-SOPRON,Nyúl,002,973,437,1,436,-1,1,435
GYÕR-MOSON-SOPRON,Nyúl,003,1115,496,0,496,0,1,495
GYÕR-MOSON-SOPRON,Nyúl,004,492,252,0,252,0,0,252
GYÕR-MOSON-SOPRON,Osli,001,717,333,0,333,0,2,331
GYÕR-MOSON-SOPRON,Öttevény,001,875,376,0,374,-2,1,373
GYÕR-MOSON-SOPRON,Öttevény,002,780,341,0,340,-1,3,337
GYÕR-MOSON-SOPRON,Öttevény,003,782,285,0,285,0,1,284
GYÕR-MOSON-SOPRON,Pannonhalma,001,1101,454,0,454,0,6,448
GYÕR-MOSON-SOPRON,Pannonhalma,002,724,314,0,314,0,3,311
GYÕR-MOSON-SOPRON,Pannonhalma,003,800,325,0,325,0,1,324
GYÕR-MOSON-SOPRON,Pannonhalma,004,190,118,0,118,0,0,118
GYÕR-MOSON-SOPRON,Páli,001,325,142,0,142,0,0,142
GYÕR-MOSON-SOPRON,Pásztori,001,247,141,0,141,0,1,140
GYÕR-MOSON-SOPRON,Pázmándfalu,001,825,344,0,344,0,2,342
GYÕR-MOSON-SOPRON,Pereszteg,001,1180,528,0,528,0,1,527
GYÕR-MOSON-SOPRON,Petõháza,001,885,473,0,473,0,2,471
GYÕR-MOSON-SOPRON,Pér,001,867,347,0,347,0,1,346
GYÕR-MOSON-SOPRON,Pér,002,910,348,0,348,0,2,346
GYÕR-MOSON-SOPRON,Pér,003,263,109,0,109,0,0,109
GYÕR-MOSON-SOPRON,Pinnye,001,296,166,0,166,0,0,166
GYÕR-MOSON-SOPRON,Potyond,001,92,55,0,55,0,2,53
GYÕR-MOSON-SOPRON,Pusztacsalád,001,226,149,0,149,0,5,144
GYÕR-MOSON-SOPRON,Püski,001,514,244,0,244,0,0,244
GYÕR-MOSON-SOPRON,Rajka,001,449,218,0,218,0,0,218
GYÕR-MOSON-SOPRON,Rajka,002,611,315,0,315,0,1,314
GYÕR-MOSON-SOPRON,Rajka,003,420,174,0,174,0,1,173
GYÕR-MOSON-SOPRON,Ravazd,001,1034,417,0,417,0,3,414
GYÕR-MOSON-SOPRON,Rábacsanak,001,430,194,0,194,0,1,193
GYÕR-MOSON-SOPRON,Rábacsécsény,001,478,214,0,214,0,1,213
GYÕR-MOSON-SOPRON,Rábakecöl,001,603,278,0,278,0,1,277
GYÕR-MOSON-SOPRON,Rábapatona,001,1069,400,0,400,0,4,396
GYÕR-MOSON-SOPRON,Rábapatona,002,1037,424,1,423,-1,5,418
GYÕR-MOSON-SOPRON,Rábapordány,001,821,397,0,397,0,3,394
GYÕR-MOSON-SOPRON,Rábasebes,001,71,49,0,49,0,0,49
GYÕR-MOSON-SOPRON,Rábaszentandrás,001,372,213,0,213,0,2,211
GYÕR-MOSON-SOPRON,Rábaszentmihály,001,423,208,0,208,0,1,207
GYÕR-MOSON-SOPRON,Rábaszentmiklós,001,123,84,0,84,0,1,83
GYÕR-MOSON-SOPRON,Rábatamási,001,822,431,0,431,0,2,429
GYÕR-MOSON-SOPRON,Rábcakapi,001,140,68,0,68,0,0,68
GYÕR-MOSON-SOPRON,Répceszemere,001,226,116,0,116,0,1,115
GYÕR-MOSON-SOPRON,Répcevis,001,284,199,0,199,0,0,199
GYÕR-MOSON-SOPRON,Rétalap,001,460,157,0,157,0,1,156
GYÕR-MOSON-SOPRON,Románd,001,258,103,0,103,0,0,103
GYÕR-MOSON-SOPRON,Röjtökmuzsaj,001,360,179,1,179,0,1,178
GYÕR-MOSON-SOPRON,Sarród,001,514,287,0,287,0,1,286
GYÕR-MOSON-SOPRON,Sarród,002,179,103,0,103,0,1,102
GYÕR-MOSON-SOPRON,Sarród,003,82,39,0,39,0,0,39
GYÕR-MOSON-SOPRON,Sikátor,001,259,119,0,119,0,3,116
GYÕR-MOSON-SOPRON,Sobor,001,218,103,0,103,0,0,103
GYÕR-MOSON-SOPRON,Sokorópátka,001,944,402,0,402,0,1,401
GYÕR-MOSON-SOPRON,Sopron,001,2111,1445,0,1444,-1,1,1443
GYÕR-MOSON-SOPRON,Sopron,002,1013,425,0,425,0,0,425
GYÕR-MOSON-SOPRON,Sopron,003,1081,462,0,462,0,1,461
GYÕR-MOSON-SOPRON,Sopron,004,939,530,0,530,0,4,526
GYÕR-MOSON-SOPRON,Sopron,005,785,431,0,431,0,5,426
GYÕR-MOSON-SOPRON,Sopron,006,941,468,0,468,0,1,467
GYÕR-MOSON-SOPRON,Sopron,007,1026,570,0,570,0,1,569
GYÕR-MOSON-SOPRON,Sopron,008,831,421,0,421,0,0,421
GYÕR-MOSON-SOPRON,Sopron,009,1080,543,0,543,0,2,541
GYÕR-MOSON-SOPRON,Sopron,010,780,386,0,386,0,2,384
GYÕR-MOSON-SOPRON,Sopron,011,827,378,0,378,0,2,376
GYÕR-MOSON-SOPRON,Sopron,012,843,389,0,389,0,2,387
GYÕR-MOSON-SOPRON,Sopron,013,790,352,0,352,0,2,350
GYÕR-MOSON-SOPRON,Sopron,014,780,373,0,373,0,1,372
GYÕR-MOSON-SOPRON,Sopron,015,773,382,0,382,0,2,380
GYÕR-MOSON-SOPRON,Sopron,016,958,470,0,470,0,1,469
GYÕR-MOSON-SOPRON,Sopron,017,641,354,0,354,0,1,353
GYÕR-MOSON-SOPRON,Sopron,018,815,416,0,416,0,1,415
GYÕR-MOSON-SOPRON,Sopron,019,1033,564,0,564,0,4,560
GYÕR-MOSON-SOPRON,Sopron,020,820,380,0,380,0,5,375
GYÕR-MOSON-SOPRON,Sopron,021,850,427,0,427,0,0,427
GYÕR-MOSON-SOPRON,Sopron,022,901,461,0,461,0,2,459
GYÕR-MOSON-SOPRON,Sopron,023,1109,565,0,565,0,3,562
GYÕR-MOSON-SOPRON,Sopron,024,855,335,0,335,0,2,333
GYÕR-MOSON-SOPRON,Sopron,025,687,301,0,301,0,0,301
GYÕR-MOSON-SOPRON,Sopron,026,647,308,0,308,0,1,307
GYÕR-MOSON-SOPRON,Sopron,027,766,366,0,366,0,1,365
GYÕR-MOSON-SOPRON,Sopron,028,1003,395,0,395,0,1,394
GYÕR-MOSON-SOPRON,Sopron,029,1266,586,0,586,0,10,576
GYÕR-MOSON-SOPRON,Sopron,030,760,315,0,315,0,1,314
GYÕR-MOSON-SOPRON,Sopron,031,1074,513,0,513,0,3,510
GYÕR-MOSON-SOPRON,Sopron,032,971,464,0,463,-1,0,463
GYÕR-MOSON-SOPRON,Sopron,033,1032,574,0,574,0,0,574
GYÕR-MOSON-SOPRON,Sopron,034,939,461,0,461,0,3,458
GYÕR-MOSON-SOPRON,Sopron,035,964,487,0,487,0,0,487
GYÕR-MOSON-SOPRON,Sopron,036,1012,496,0,496,0,1,495
GYÕR-MOSON-SOPRON,Sopron,037,975,502,0,502,0,0,502
GYÕR-MOSON-SOPRON,Sopron,038,932,532,0,532,0,1,531
GYÕR-MOSON-SOPRON,Sopron,039,1030,620,0,620,0,2,618
GYÕR-MOSON-SOPRON,Sopron,040,1165,669,0,669,0,6,663
GYÕR-MOSON-SOPRON,Sopron,041,987,650,0,650,0,2,648
GYÕR-MOSON-SOPRON,Sopron,042,840,527,0,527,0,4,523
GYÕR-MOSON-SOPRON,Sopron,043,986,531,0,531,0,0,531
GYÕR-MOSON-SOPRON,Sopron,044,936,438,0,438,0,1,437
GYÕR-MOSON-SOPRON,Sopron,045,720,420,0,420,0,1,419
GYÕR-MOSON-SOPRON,Sopron,046,758,345,0,345,0,2,343
GYÕR-MOSON-SOPRON,Sopron,047,983,520,0,520,0,2,518
GYÕR-MOSON-SOPRON,Sopron,048,1265,617,0,617,0,0,617
GYÕR-MOSON-SOPRON,Sopron,049,1202,640,0,640,0,1,639
GYÕR-MOSON-SOPRON,Sopron,050,762,314,0,313,-1,2,311
GYÕR-MOSON-SOPRON,Sopronhorpács,001,671,416,0,416,0,3,413
GYÕR-MOSON-SOPRON,Sopronkövesd,001,1013,513,0,513,0,3,510
GYÕR-MOSON-SOPRON,Sopronnémeti,001,254,138,0,138,0,2,136
GYÕR-MOSON-SOPRON,Szakony,001,342,165,0,165,0,1,164
GYÕR-MOSON-SOPRON,Szany,001,1070,532,0,532,0,1,531
GYÕR-MOSON-SOPRON,Szany,002,687,340,0,340,0,5,335
GYÕR-MOSON-SOPRON,Szárföld,001,792,390,0,390,0,4,386
GYÕR-MOSON-SOPRON,Szerecseny,001,666,255,0,255,0,0,255
GYÕR-MOSON-SOPRON,Szil,001,1082,451,0,451,0,3,448
GYÕR-MOSON-SOPRON,Szilsárkány,001,558,288,0,288,0,0,288
GYÕR-MOSON-SOPRON,Tarjánpuszta,001,333,154,0,154,0,3,151
GYÕR-MOSON-SOPRON,Táp,001,605,272,0,272,0,2,270
GYÕR-MOSON-SOPRON,Tápszentmiklós,001,740,320,0,320,0,3,317
GYÕR-MOSON-SOPRON,Tárnokréti,001,163,92,0,92,0,0,92
GYÕR-MOSON-SOPRON,Tényõ,001,1286,549,0,549,0,3,546
GYÕR-MOSON-SOPRON,Tét,001,1177,377,0,377,0,2,375
GYÕR-MOSON-SOPRON,Tét,002,989,384,0,384,0,0,384
GYÕR-MOSON-SOPRON,Tét,003,1094,442,0,442,0,1,441
GYÕR-MOSON-SOPRON,Töltéstava,001,867,363,0,363,0,1,362
GYÕR-MOSON-SOPRON,Töltéstava,002,817,335,0,335,0,0,335
GYÕR-MOSON-SOPRON,Und,001,267,146,0,146,0,0,146
GYÕR-MOSON-SOPRON,Újkér,001,819,377,0,377,0,2,375
GYÕR-MOSON-SOPRON,Újrónafõ,001,647,251,0,251,0,3,248
GYÕR-MOSON-SOPRON,Vadosfa,001,80,48,0,48,0,0,48
GYÕR-MOSON-SOPRON,Vág,001,432,215,0,215,0,2,213
GYÕR-MOSON-SOPRON,Vámosszabadi,001,1621,735,0,734,-1,3,731
GYÕR-MOSON-SOPRON,Várbalog,001,298,153,0,153,0,0,153
GYÕR-MOSON-SOPRON,Vásárosfalu,001,131,80,0,80,0,2,78
GYÕR-MOSON-SOPRON,Veszkény,001,761,436,0,436,0,1,435
GYÕR-MOSON-SOPRON,Veszprémvarsány,001,836,369,0,369,0,3,366
GYÕR-MOSON-SOPRON,Vének,001,150,90,0,90,0,0,90
GYÕR-MOSON-SOPRON,Vitnyéd,001,1107,553,0,553,0,2,551
GYÕR-MOSON-SOPRON,Völcsej,001,307,196,0,196,0,0,196
GYÕR-MOSON-SOPRON,Zsebeháza,001,118,70,0,70,0,0,70
GYÕR-MOSON-SOPRON,Zsira,001,541,277,0,277,0,1,276
GYÕR-MOSON-SOPRON,Károlyháza,001,446,153,0,153,0,0,153
GYÕR-MOSON-SOPRON,Mosonudvar,001,367,112,0,112,0,0,112
HAJDÚ-BIHAR,Álmosd,001,733,181,0,181,0,2,179
HAJDÚ-BIHAR,Álmosd,002,700,192,0,192,0,0,192
HAJDÚ-BIHAR,Ártánd,001,538,206,0,206,0,3,203
HAJDÚ-BIHAR,Bagamér,001,929,288,0,288,0,1,287
HAJDÚ-BIHAR,Bagamér,002,945,182,0,182,0,5,177
HAJDÚ-BIHAR,Bakonszeg,001,983,352,0,352,0,3,349
HAJDÚ-BIHAR,Balmazújváros,001,1025,404,0,404,0,4,400
HAJDÚ-BIHAR,Balmazújváros,002,770,302,0,302,0,0,302
HAJDÚ-BIHAR,Balmazújváros,003,889,351,0,351,0,1,350
HAJDÚ-BIHAR,Balmazújváros,004,846,331,0,331,0,1,330
HAJDÚ-BIHAR,Balmazújváros,005,750,251,0,251,0,0,251
HAJDÚ-BIHAR,Balmazújváros,006,851,178,0,178,0,6,172
HAJDÚ-BIHAR,Balmazújváros,007,762,333,0,333,0,0,333
HAJDÚ-BIHAR,Balmazújváros,008,921,308,0,308,0,2,306
HAJDÚ-BIHAR,Balmazújváros,009,1016,263,0,263,0,0,263
HAJDÚ-BIHAR,Balmazújváros,010,783,217,0,217,0,0,217
HAJDÚ-BIHAR,Balmazújváros,011,1015,193,0,193,0,0,193
HAJDÚ-BIHAR,Balmazújváros,012,886,213,0,213,0,0,213
HAJDÚ-BIHAR,Balmazújváros,013,883,257,0,256,-1,11,245
HAJDÚ-BIHAR,Balmazújváros,014,824,260,0,260,0,2,258
HAJDÚ-BIHAR,Balmazújváros,015,812,298,0,298,0,2,296
HAJDÚ-BIHAR,Balmazújváros,016,897,287,0,287,0,2,285
HAJDÚ-BIHAR,Balmazújváros,017,86,33,0,33,0,0,33
HAJDÚ-BIHAR,Báránd,001,625,234,0,234,0,1,233
HAJDÚ-BIHAR,Báránd,002,696,211,0,211,0,0,211
HAJDÚ-BIHAR,Báránd,003,717,216,0,216,0,2,214
HAJDÚ-BIHAR,Bedõ,001,286,117,0,117,0,4,113
HAJDÚ-BIHAR,Berekböszörmény,001,719,199,0,199,0,0,199
HAJDÚ-BIHAR,Berekböszörmény,002,789,254,0,254,0,3,251
HAJDÚ-BIHAR,Berettyóújfalu,001,833,380,0,380,0,0,380
HAJDÚ-BIHAR,Berettyóújfalu,002,672,327,0,327,0,4,323
HAJDÚ-BIHAR,Berettyóújfalu,003,683,266,0,266,0,0,266
HAJDÚ-BIHAR,Berettyóújfalu,004,996,381,0,381,0,1,380
HAJDÚ-BIHAR,Berettyóújfalu,005,629,179,1,179,0,1,178
HAJDÚ-BIHAR,Berettyóújfalu,006,820,203,0,203,0,1,202
HAJDÚ-BIHAR,Berettyóújfalu,007,724,338,0,338,0,2,336
HAJDÚ-BIHAR,Berettyóújfalu,008,686,210,0,210,0,2,208
HAJDÚ-BIHAR,Berettyóújfalu,009,811,386,0,386,0,0,386
HAJDÚ-BIHAR,Berettyóújfalu,010,691,268,0,267,-1,2,265
HAJDÚ-BIHAR,Berettyóújfalu,011,791,353,0,353,0,1,352
HAJDÚ-BIHAR,Berettyóújfalu,012,680,349,0,349,0,2,347
HAJDÚ-BIHAR,Berettyóújfalu,013,911,326,0,325,-1,5,320
HAJDÚ-BIHAR,Berettyóújfalu,014,611,274,0,274,0,1,273
HAJDÚ-BIHAR,Berettyóújfalu,015,754,250,0,250,0,5,245
HAJDÚ-BIHAR,Berettyóújfalu,016,762,251,0,251,0,2,249
HAJDÚ-BIHAR,Bihardancsháza,001,156,85,0,85,0,4,81
HAJDÚ-BIHAR,Biharkeresztes,001,719,293,0,293,0,1,292
HAJDÚ-BIHAR,Biharkeresztes,002,719,294,0,294,0,6,288
HAJDÚ-BIHAR,Biharkeresztes,003,574,167,0,167,0,1,166
HAJDÚ-BIHAR,Biharkeresztes,004,876,285,0,285,0,2,283
HAJDÚ-BIHAR,Biharkeresztes,005,722,210,0,210,0,2,208
HAJDÚ-BIHAR,Biharnagybajom,001,647,191,0,191,0,1,190
HAJDÚ-BIHAR,Biharnagybajom,002,675,169,0,169,0,1,168
HAJDÚ-BIHAR,Biharnagybajom,003,721,172,0,172,0,2,170
HAJDÚ-BIHAR,Bihartorda,001,759,262,0,262,0,3,259
HAJDÚ-BIHAR,Bocskaikert,001,1379,538,0,538,0,1,537
HAJDÚ-BIHAR,Bocskaikert,002,1423,560,0,560,0,1,559
HAJDÚ-BIHAR,Bojt,001,416,139,0,139,0,1,138
HAJDÚ-BIHAR,Csökmõ,001,771,253,0,253,0,2,251
HAJDÚ-BIHAR,Csökmõ,002,737,195,0,195,0,0,195
HAJDÚ-BIHAR,Csökmõ,003,45,20,0,20,0,0,20
HAJDÚ-BIHAR,Darvas,001,480,140,0,140,0,0,140
HAJDÚ-BIHAR,Debrecen,011,707,156,0,156,0,0,156
HAJDÚ-BIHAR,Debrecen,012,1362,547,0,547,0,0,547
HAJDÚ-BIHAR,Debrecen,013,1304,296,0,296,0,0,296
HAJDÚ-BIHAR,Debrecen,014,1293,525,0,525,0,1,524
HAJDÚ-BIHAR,Debrecen,015,1269,382,0,382,0,2,380
HAJDÚ-BIHAR,Debrecen,016,676,332,0,332,0,1,331
HAJDÚ-BIHAR,Debrecen,021,1405,582,0,582,0,3,579
HAJDÚ-BIHAR,Debrecen,022,1386,558,0,558,0,2,556
HAJDÚ-BIHAR,Debrecen,023,1383,639,0,638,-1,1,637
HAJDÚ-BIHAR,Debrecen,024,1312,561,0,561,0,0,561
HAJDÚ-BIHAR,Debrecen,025,1263,626,0,626,0,2,624
HAJDÚ-BIHAR,Debrecen,031,1288,522,0,522,0,3,519
HAJDÚ-BIHAR,Debrecen,032,1290,649,0,647,-2,2,645
HAJDÚ-BIHAR,Debrecen,033,1096,536,0,533,-3,0,533
HAJDÚ-BIHAR,Debrecen,034,1041,521,0,521,0,2,519
HAJDÚ-BIHAR,Debrecen,035,1310,654,0,654,0,0,654
HAJDÚ-BIHAR,Debrecen,041,1347,552,0,552,0,1,551
HAJDÚ-BIHAR,Debrecen,042,1225,514,0,514,0,2,512
HAJDÚ-BIHAR,Debrecen,043,1016,425,0,425,0,2,423
HAJDÚ-BIHAR,Debrecen,044,873,315,0,315,0,2,313
HAJDÚ-BIHAR,Debrecen,045,1058,452,0,452,0,1,451
HAJDÚ-BIHAR,Debrecen,046,1024,449,0,449,0,0,449
HAJDÚ-BIHAR,Debrecen,051,1335,600,0,599,-1,3,596
HAJDÚ-BIHAR,Debrecen,052,1357,612,0,612,0,0,612
HAJDÚ-BIHAR,Debrecen,053,1394,687,0,686,-1,2,684
HAJDÚ-BIHAR,Debrecen,054,1355,589,0,588,-1,2,586
HAJDÚ-BIHAR,Debrecen,055,1286,408,0,408,0,2,406
HAJDÚ-BIHAR,Debrecen,061,853,204,0,204,0,3,201
HAJDÚ-BIHAR,Debrecen,062,1416,360,0,360,0,3,357
HAJDÚ-BIHAR,Debrecen,063,1424,630,0,630,0,2,628
HAJDÚ-BIHAR,Debrecen,064,564,130,0,130,0,1,129
HAJDÚ-BIHAR,Debrecen,065,1223,599,0,598,-1,1,597
HAJDÚ-BIHAR,Debrecen,066,932,465,0,465,0,1,464
HAJDÚ-BIHAR,Debrecen,067,850,404,0,404,0,2,402
HAJDÚ-BIHAR,Debrecen,071,894,219,0,219,0,1,218
HAJDÚ-BIHAR,Debrecen,072,1465,443,0,443,0,2,441
HAJDÚ-BIHAR,Debrecen,073,1371,525,0,524,-1,0,524
HAJDÚ-BIHAR,Debrecen,074,1445,567,0,568,1,13,555
HAJDÚ-BIHAR,Debrecen,075,1021,420,0,420,0,1,419
HAJDÚ-BIHAR,Debrecen,076,1129,495,0,495,0,3,492
HAJDÚ-BIHAR,Debrecen,081,1135,312,0,312,0,1,311
HAJDÚ-BIHAR,Debrecen,082,1444,617,0,617,0,3,614
HAJDÚ-BIHAR,Debrecen,083,1219,462,0,462,0,1,461
HAJDÚ-BIHAR,Debrecen,084,1302,640,0,640,0,0,640
HAJDÚ-BIHAR,Debrecen,085,931,447,0,447,0,4,443
HAJDÚ-BIHAR,Debrecen,086,899,345,0,345,0,2,343
HAJDÚ-BIHAR,Debrecen,091,1295,365,0,365,0,4,361
HAJDÚ-BIHAR,Debrecen,092,1472,413,0,412,-1,1,411
HAJDÚ-BIHAR,Debrecen,093,1395,505,0,505,0,2,503
HAJDÚ-BIHAR,Debrecen,094,1393,358,0,357,-1,2,355
HAJDÚ-BIHAR,Debrecen,095,1418,619,0,620,1,12,608
HAJDÚ-BIHAR,Debrecen,101,1292,613,0,612,-1,2,610
HAJDÚ-BIHAR,Debrecen,102,1449,461,0,461,0,0,461
HAJDÚ-BIHAR,Debrecen,103,1315,574,0,574,0,3,571
HAJDÚ-BIHAR,Debrecen,104,1049,412,0,412,0,0,412
HAJDÚ-BIHAR,Debrecen,105,1397,582,0,575,-7,10,565
HAJDÚ-BIHAR,Debrecen,106,1446,685,0,685,0,1,684
HAJDÚ-BIHAR,Debrecen,111,3177,1816,2,1810,-6,6,1804
HAJDÚ-BIHAR,Debrecen,112,1287,583,0,583,0,2,581
HAJDÚ-BIHAR,Debrecen,113,1239,524,0,524,0,4,520
HAJDÚ-BIHAR,Debrecen,114,1078,551,0,551,0,6,545
HAJDÚ-BIHAR,Debrecen,115,1157,602,0,602,0,8,594
HAJDÚ-BIHAR,Debrecen,116,760,300,0,300,0,0,300
HAJDÚ-BIHAR,Debrecen,117,924,361,0,361,0,1,360
HAJDÚ-BIHAR,Debrecen,121,1091,404,0,404,0,4,400
HAJDÚ-BIHAR,Debrecen,122,948,324,0,324,0,3,321
HAJDÚ-BIHAR,Debrecen,123,1208,521,0,521,0,1,520
HAJDÚ-BIHAR,Debrecen,124,1172,466,0,466,0,0,466
HAJDÚ-BIHAR,Debrecen,125,1231,464,0,464,0,2,462
HAJDÚ-BIHAR,Debrecen,126,1089,424,0,424,0,2,422
HAJDÚ-BIHAR,Debrecen,127,1147,444,0,444,0,3,441
HAJDÚ-BIHAR,Debrecen,131,1235,454,0,454,0,6,448
HAJDÚ-BIHAR,Debrecen,132,1199,410,0,410,0,2,408
HAJDÚ-BIHAR,Debrecen,133,1307,470,0,470,0,0,470
HAJDÚ-BIHAR,Debrecen,134,1194,417,0,417,0,1,416
HAJDÚ-BIHAR,Debrecen,135,1182,473,0,473,0,0,473
HAJDÚ-BIHAR,Debrecen,136,1024,307,0,307,0,3,304
HAJDÚ-BIHAR,Debrecen,141,1328,499,0,500,1,11,489
HAJDÚ-BIHAR,Debrecen,142,1424,481,0,481,0,0,481
HAJDÚ-BIHAR,Debrecen,143,1401,534,0,532,-2,3,529
HAJDÚ-BIHAR,Debrecen,144,1145,350,0,350,0,1,349
HAJDÚ-BIHAR,Debrecen,145,1451,717,0,717,0,5,712
HAJDÚ-BIHAR,Debrecen,151,834,475,0,475,0,1,474
HAJDÚ-BIHAR,Debrecen,152,1116,403,0,402,-1,4,398
HAJDÚ-BIHAR,Debrecen,153,846,435,0,435,0,1,434
HAJDÚ-BIHAR,Debrecen,154,1240,440,0,440,0,2,438
HAJDÚ-BIHAR,Debrecen,155,1245,496,0,495,-1,3,492
HAJDÚ-BIHAR,Debrecen,156,1063,400,1,399,-1,4,395
HAJDÚ-BIHAR,Debrecen,161,1178,525,0,523,-2,2,521
HAJDÚ-BIHAR,Debrecen,162,1179,476,0,476,0,0,476
HAJDÚ-BIHAR,Debrecen,163,1333,509,0,508,-1,1,507
HAJDÚ-BIHAR,Debrecen,164,1247,593,1,593,0,3,590
HAJDÚ-BIHAR,Debrecen,165,1270,577,0,577,0,3,574
HAJDÚ-BIHAR,Debrecen,171,1255,648,0,648,0,0,648
HAJDÚ-BIHAR,Debrecen,172,1396,546,0,546,0,1,545
HAJDÚ-BIHAR,Debrecen,173,1342,608,0,608,0,1,607
HAJDÚ-BIHAR,Debrecen,174,777,367,0,367,0,2,365
HAJDÚ-BIHAR,Debrecen,175,1131,588,0,588,0,3,585
HAJDÚ-BIHAR,Debrecen,176,788,308,0,308,0,4,304
HAJDÚ-BIHAR,Debrecen,181,544,230,0,230,0,2,228
HAJDÚ-BIHAR,Debrecen,182,1281,630,0,630,0,3,627
HAJDÚ-BIHAR,Debrecen,183,1205,752,0,751,-1,6,745
HAJDÚ-BIHAR,Debrecen,184,500,254,0,253,-1,1,252
HAJDÚ-BIHAR,Debrecen,185,705,357,0,356,-1,1,355
HAJDÚ-BIHAR,Debrecen,186,1126,475,0,475,0,0,475
HAJDÚ-BIHAR,Debrecen,187,939,402,0,402,0,1,401
HAJDÚ-BIHAR,Debrecen,188,743,293,0,293,0,0,293
HAJDÚ-BIHAR,Debrecen,191,928,373,0,373,0,3,370
HAJDÚ-BIHAR,Debrecen,192,1174,466,0,466,0,4,462
HAJDÚ-BIHAR,Debrecen,193,1288,575,0,574,-1,6,568
HAJDÚ-BIHAR,Debrecen,194,1264,572,0,572,0,0,572
HAJDÚ-BIHAR,Debrecen,195,818,427,0,427,0,1,426
HAJDÚ-BIHAR,Debrecen,196,1292,664,0,664,0,7,657
HAJDÚ-BIHAR,Debrecen,201,1288,521,0,521,0,5,516
HAJDÚ-BIHAR,Debrecen,202,1234,506,0,505,-1,5,500
HAJDÚ-BIHAR,Debrecen,203,1257,570,0,570,0,5,565
HAJDÚ-BIHAR,Debrecen,204,1248,498,0,498,0,2,496
HAJDÚ-BIHAR,Debrecen,205,1142,541,0,541,0,2,539
HAJDÚ-BIHAR,Debrecen,211,555,227,0,227,0,1,226
HAJDÚ-BIHAR,Debrecen,212,796,283,0,283,0,3,280
HAJDÚ-BIHAR,Debrecen,213,404,191,0,191,0,1,190
HAJDÚ-BIHAR,Debrecen,214,1260,551,0,551,0,5,546
HAJDÚ-BIHAR,Debrecen,215,847,536,0,535,-1,0,535
HAJDÚ-BIHAR,Debrecen,216,1177,673,0,673,0,2,671
HAJDÚ-BIHAR,Debrecen,217,1354,723,0,723,0,0,723
HAJDÚ-BIHAR,Debrecen,218,1281,643,0,643,0,1,642
HAJDÚ-BIHAR,Debrecen,221,1227,454,0,454,0,2,452
HAJDÚ-BIHAR,Debrecen,222,1173,480,0,480,0,1,479
HAJDÚ-BIHAR,Debrecen,223,1245,486,0,486,0,0,486
HAJDÚ-BIHAR,Debrecen,224,1117,535,0,531,-4,2,529
HAJDÚ-BIHAR,Debrecen,225,1085,546,0,546,0,0,546
HAJDÚ-BIHAR,Debrecen,231,1301,566,0,565,-1,2,563
HAJDÚ-BIHAR,Debrecen,232,1431,594,0,594,0,1,593
HAJDÚ-BIHAR,Debrecen,233,1395,591,0,591,0,1,590
HAJDÚ-BIHAR,Debrecen,234,1185,554,0,553,-1,3,550
HAJDÚ-BIHAR,Debrecen,235,1349,594,0,594,0,2,592
HAJDÚ-BIHAR,Debrecen,236,1118,490,0,490,0,0,490
HAJDÚ-BIHAR,Derecske,001,966,273,0,273,0,2,271
HAJDÚ-BIHAR,Derecske,002,916,217,0,217,0,0,217
HAJDÚ-BIHAR,Derecske,003,881,337,0,337,0,0,337
HAJDÚ-BIHAR,Derecske,004,917,333,0,333,0,3,330
HAJDÚ-BIHAR,Derecske,005,874,342,0,342,0,0,342
HAJDÚ-BIHAR,Derecske,006,997,355,0,355,0,1,354
HAJDÚ-BIHAR,Derecske,007,873,362,0,362,0,2,360
HAJDÚ-BIHAR,Derecske,008,393,77,0,77,0,0,77
HAJDÚ-BIHAR,Ebes,001,1015,371,0,371,0,3,368
HAJDÚ-BIHAR,Ebes,002,894,277,0,277,0,2,275
HAJDÚ-BIHAR,Ebes,003,1037,359,0,359,0,1,358
HAJDÚ-BIHAR,Ebes,004,855,323,0,323,0,0,323
HAJDÚ-BIHAR,Egyek,001,649,156,0,156,0,2,154
HAJDÚ-BIHAR,Egyek,002,617,179,0,179,0,0,179
HAJDÚ-BIHAR,Egyek,003,722,222,0,222,0,0,222
HAJDÚ-BIHAR,Egyek,004,678,200,0,200,0,2,198
HAJDÚ-BIHAR,Egyek,005,744,229,0,229,0,1,228
HAJDÚ-BIHAR,Egyek,006,462,105,0,105,0,1,104
HAJDÚ-BIHAR,Egyek,007,147,53,0,53,0,0,53
HAJDÚ-BIHAR,Esztár,001,1116,335,0,335,0,2,333
HAJDÚ-BIHAR,Folyás,001,246,85,0,83,-2,0,83
HAJDÚ-BIHAR,Földes,001,841,292,0,292,0,3,289
HAJDÚ-BIHAR,Földes,002,862,317,0,317,0,2,315
HAJDÚ-BIHAR,Földes,003,776,269,0,269,0,2,267
HAJDÚ-BIHAR,Földes,004,828,310,0,310,0,1,309
HAJDÚ-BIHAR,Furta,001,925,357,0,357,0,2,355
HAJDÚ-BIHAR,Fülöp,001,416,148,0,148,0,1,147
HAJDÚ-BIHAR,Fülöp,002,376,136,0,136,0,2,134
HAJDÚ-BIHAR,Fülöp,003,393,118,0,118,0,1,117
HAJDÚ-BIHAR,Fülöp,004,175,74,0,74,0,0,74
HAJDÚ-BIHAR,Gáborján,001,648,218,0,218,0,1,217
HAJDÚ-BIHAR,Görbeháza,001,924,291,0,291,0,2,289
HAJDÚ-BIHAR,Görbeháza,002,987,310,0,310,0,1,309
HAJDÚ-BIHAR,Görbeháza,003,56,23,0,23,0,0,23
HAJDÚ-BIHAR,Hajdúbagos,001,900,326,0,326,0,3,323
HAJDÚ-BIHAR,Hajdúbagos,002,772,261,0,261,0,5,256
HAJDÚ-BIHAR,Hajdúböszörmény,001,1069,442,0,442,0,0,442
HAJDÚ-BIHAR,Hajdúböszörmény,002,932,394,0,394,0,6,388
HAJDÚ-BIHAR,Hajdúböszörmény,003,665,193,0,193,0,0,193
HAJDÚ-BIHAR,Hajdúböszörmény,004,1112,408,0,408,0,1,407
HAJDÚ-BIHAR,Hajdúböszörmény,005,1023,463,0,463,0,2,461
HAJDÚ-BIHAR,Hajdúböszörmény,006,1228,339,0,339,0,1,338
HAJDÚ-BIHAR,Hajdúböszörmény,007,793,162,0,162,0,1,161
HAJDÚ-BIHAR,Hajdúböszörmény,008,189,94,0,94,0,2,92
HAJDÚ-BIHAR,Hajdúböszörmény,009,1180,307,0,307,0,0,307
HAJDÚ-BIHAR,Hajdúböszörmény,010,1163,385,0,385,0,3,382
HAJDÚ-BIHAR,Hajdúböszörmény,011,796,307,0,307,0,0,307
HAJDÚ-BIHAR,Hajdúböszörmény,012,1089,548,0,545,-3,3,542
HAJDÚ-BIHAR,Hajdúböszörmény,013,717,230,0,230,0,0,230
HAJDÚ-BIHAR,Hajdúböszörmény,014,850,362,0,362,0,0,362
HAJDÚ-BIHAR,Hajdúböszörmény,015,691,329,0,329,0,1,328
HAJDÚ-BIHAR,Hajdúböszörmény,016,717,295,0,295,0,2,293
HAJDÚ-BIHAR,Hajdúböszörmény,017,877,405,0,405,0,0,405
HAJDÚ-BIHAR,Hajdúböszörmény,018,779,321,1,320,-1,3,317
HAJDÚ-BIHAR,Hajdúböszörmény,019,1214,409,0,409,0,1,408
HAJDÚ-BIHAR,Hajdúböszörmény,020,670,267,0,267,0,2,265
HAJDÚ-BIHAR,Hajdúböszörmény,021,1280,477,0,477,0,2,475
HAJDÚ-BIHAR,Hajdúböszörmény,022,936,381,0,381,0,2,379
HAJDÚ-BIHAR,Hajdúböszörmény,023,1016,258,0,258,0,8,250
HAJDÚ-BIHAR,Hajdúböszörmény,024,1037,212,0,212,0,0,212
HAJDÚ-BIHAR,Hajdúböszörmény,025,1148,366,0,366,0,0,366
HAJDÚ-BIHAR,Hajdúböszörmény,026,772,158,0,158,0,0,158
HAJDÚ-BIHAR,Hajdúböszörmény,027,694,178,0,178,0,0,178
HAJDÚ-BIHAR,Hajdúdorog,001,859,354,0,354,0,1,353
HAJDÚ-BIHAR,Hajdúdorog,002,1022,356,0,356,0,2,354
HAJDÚ-BIHAR,Hajdúdorog,003,976,416,0,416,0,1,415
HAJDÚ-BIHAR,Hajdúdorog,004,1002,330,0,330,0,2,328
HAJDÚ-BIHAR,Hajdúdorog,005,865,269,0,269,0,2,267
HAJDÚ-BIHAR,Hajdúdorog,006,764,263,0,263,0,1,262
HAJDÚ-BIHAR,Hajdúdorog,007,790,168,0,168,0,1,167
HAJDÚ-BIHAR,Hajdúdorog,008,665,223,0,223,0,1,222
HAJDÚ-BIHAR,Hajdúhadház,001,1124,268,0,268,0,0,268
HAJDÚ-BIHAR,Hajdúhadház,002,968,175,0,175,0,2,173
HAJDÚ-BIHAR,Hajdúhadház,003,1260,305,0,305,0,1,304
HAJDÚ-BIHAR,Hajdúhadház,004,1224,345,0,345,0,2,343
HAJDÚ-BIHAR,Hajdúhadház,005,1058,299,0,299,0,2,297
HAJDÚ-BIHAR,Hajdúhadház,006,1251,319,0,319,0,3,316
HAJDÚ-BIHAR,Hajdúhadház,007,1306,456,0,456,0,2,454
HAJDÚ-BIHAR,Hajdúhadház,008,1227,409,0,409,0,5,404
HAJDÚ-BIHAR,Hajdúhadház,009,116,37,0,37,0,1,36
HAJDÚ-BIHAR,Hajdúnánás,001,990,349,0,349,0,3,346
HAJDÚ-BIHAR,Hajdúnánás,002,787,250,0,250,0,1,249
HAJDÚ-BIHAR,Hajdúnánás,003,860,265,0,265,0,1,264
HAJDÚ-BIHAR,Hajdúnánás,004,899,250,0,250,0,2,248
HAJDÚ-BIHAR,Hajdúnánás,005,914,249,0,249,0,2,247
HAJDÚ-BIHAR,Hajdúnánás,006,903,336,0,336,0,1,335
HAJDÚ-BIHAR,Hajdúnánás,007,570,183,0,183,0,1,182
HAJDÚ-BIHAR,Hajdúnánás,008,602,160,0,160,0,1,159
HAJDÚ-BIHAR,Hajdúnánás,009,573,202,1,201,-1,4,197
HAJDÚ-BIHAR,Hajdúnánás,010,756,247,0,247,0,1,246
HAJDÚ-BIHAR,Hajdúnánás,011,844,273,0,273,0,2,271
HAJDÚ-BIHAR,Hajdúnánás,012,849,291,0,291,0,3,288
HAJDÚ-BIHAR,Hajdúnánás,013,872,253,0,253,0,2,251
HAJDÚ-BIHAR,Hajdúnánás,014,797,288,0,288,0,7,281
HAJDÚ-BIHAR,Hajdúnánás,015,820,275,0,275,0,1,274
HAJDÚ-BIHAR,Hajdúnánás,016,802,215,0,215,0,1,214
HAJDÚ-BIHAR,Hajdúnánás,017,575,194,0,194,0,2,192
HAJDÚ-BIHAR,Hajdúnánás,018,325,123,0,123,0,0,123
HAJDÚ-BIHAR,Hajdúsámson,001,1415,496,0,496,0,3,493
HAJDÚ-BIHAR,Hajdúsámson,002,1458,529,0,529,0,2,527
HAJDÚ-BIHAR,Hajdúsámson,003,1381,320,0,320,0,2,318
HAJDÚ-BIHAR,Hajdúsámson,004,1281,446,0,446,0,2,444
HAJDÚ-BIHAR,Hajdúsámson,005,1234,339,0,339,0,0,339
HAJDÚ-BIHAR,Hajdúsámson,006,552,126,0,126,0,1,125
HAJDÚ-BIHAR,Hajdúsámson,007,888,317,0,317,0,1,316
HAJDÚ-BIHAR,Hajdúsámson,008,1371,357,0,357,0,0,357
HAJDÚ-BIHAR,Hajdúsámson,009,1285,312,0,312,0,1,311
HAJDÚ-BIHAR,Hajdúszoboszló,001,1397,784,0,784,0,10,774
HAJDÚ-BIHAR,Hajdúszoboszló,002,1092,474,0,474,0,1,473
HAJDÚ-BIHAR,Hajdúszoboszló,003,941,361,0,361,0,13,348
HAJDÚ-BIHAR,Hajdúszoboszló,004,882,361,0,361,0,2,359
HAJDÚ-BIHAR,Hajdúszoboszló,005,763,288,0,288,0,0,288
HAJDÚ-BIHAR,Hajdúszoboszló,006,903,368,0,368,0,2,366
HAJDÚ-BIHAR,Hajdúszoboszló,007,749,275,0,275,0,2,273
HAJDÚ-BIHAR,Hajdúszoboszló,008,1163,383,0,383,0,1,382
HAJDÚ-BIHAR,Hajdúszoboszló,009,771,258,0,258,0,3,255
HAJDÚ-BIHAR,Hajdúszoboszló,010,940,363,0,363,0,1,362
HAJDÚ-BIHAR,Hajdúszoboszló,011,856,333,0,333,0,1,332
HAJDÚ-BIHAR,Hajdúszoboszló,012,712,229,0,229,0,1,228
HAJDÚ-BIHAR,Hajdúszoboszló,013,973,228,0,228,0,0,228
HAJDÚ-BIHAR,Hajdúszoboszló,014,882,300,0,300,0,3,297
HAJDÚ-BIHAR,Hajdúszoboszló,015,1008,446,0,446,0,7,439
HAJDÚ-BIHAR,Hajdúszoboszló,016,1163,476,0,476,0,2,474
HAJDÚ-BIHAR,Hajdúszoboszló,017,1015,305,0,305,0,4,301
HAJDÚ-BIHAR,Hajdúszoboszló,018,1240,269,0,269,0,0,269
HAJDÚ-BIHAR,Hajdúszoboszló,019,1193,574,3,572,-2,1,571
HAJDÚ-BIHAR,Hajdúszoboszló,020,1214,501,0,501,0,3,498
HAJDÚ-BIHAR,Hajdúszovát,001,787,241,0,241,0,3,238
HAJDÚ-BIHAR,Hajdúszovát,002,799,262,0,262,0,3,259
HAJDÚ-BIHAR,Hajdúszovát,003,788,187,0,187,0,4,183
HAJDÚ-BIHAR,Hencida,001,810,194,0,194,0,2,192
HAJDÚ-BIHAR,Hortobágy,001,1032,414,0,414,0,5,409
HAJDÚ-BIHAR,Hortobágy,002,179,52,0,52,0,1,51
HAJDÚ-BIHAR,Hosszúpályi,001,1102,386,0,385,-1,0,385
HAJDÚ-BIHAR,Hosszúpályi,002,1165,224,0,224,0,6,218
HAJDÚ-BIHAR,Hosszúpályi,003,1054,232,0,232,0,0,232
HAJDÚ-BIHAR,Hosszúpályi,004,1156,333,0,333,0,2,331
HAJDÚ-BIHAR,Kaba,001,943,326,0,325,-1,2,323
HAJDÚ-BIHAR,Kaba,002,976,414,0,414,0,0,414
HAJDÚ-BIHAR,Kaba,003,922,270,0,270,0,2,268
HAJDÚ-BIHAR,Kaba,004,963,341,0,341,0,2,339
HAJDÚ-BIHAR,Kaba,005,977,372,1,371,-1,2,369
HAJDÚ-BIHAR,Kismarja,001,988,328,1,327,-1,0,327
HAJDÚ-BIHAR,Kokad,001,493,142,0,142,0,7,135
HAJDÚ-BIHAR,Komádi,001,653,216,0,216,0,2,214
HAJDÚ-BIHAR,Komádi,002,597,215,0,215,0,0,215
HAJDÚ-BIHAR,Komádi,003,598,168,1,168,0,0,168
HAJDÚ-BIHAR,Komádi,004,608,161,0,161,0,0,161
HAJDÚ-BIHAR,Komádi,005,602,160,0,160,0,2,158
HAJDÚ-BIHAR,Komádi,006,627,129,0,129,0,1,128
HAJDÚ-BIHAR,Komádi,007,473,124,0,124,0,1,123
HAJDÚ-BIHAR,Komádi,008,84,32,0,32,0,0,32
HAJDÚ-BIHAR,Konyár,001,734,200,1,199,-1,0,199
HAJDÚ-BIHAR,Konyár,002,913,281,0,281,0,0,281
HAJDÚ-BIHAR,Körösszakál,001,628,177,0,177,0,0,177
HAJDÚ-BIHAR,Körösszegapáti,001,754,305,0,305,0,3,302
HAJDÚ-BIHAR,Körösszegapáti,002,70,42,0,42,0,3,39
HAJDÚ-BIHAR,Létavértes,001,1034,332,0,332,0,2,330
HAJDÚ-BIHAR,Létavértes,002,883,229,0,229,0,0,229
HAJDÚ-BIHAR,Létavértes,003,1154,282,0,282,0,1,281
HAJDÚ-BIHAR,Létavértes,004,1027,178,0,178,0,1,177
HAJDÚ-BIHAR,Létavértes,005,779,155,0,155,0,1,154
HAJDÚ-BIHAR,Létavértes,006,856,207,0,207,0,0,207
HAJDÚ-BIHAR,Magyarhomorog,001,719,240,0,240,0,0,240
HAJDÚ-BIHAR,Mezõpeterd,001,536,169,0,169,0,2,167
HAJDÚ-BIHAR,Mezõsas,001,503,166,0,166,0,4,162
HAJDÚ-BIHAR,Mikepércs,001,840,356,0,356,0,2,354
HAJDÚ-BIHAR,Mikepércs,002,1117,349,1,348,-1,3,345
HAJDÚ-BIHAR,Mikepércs,003,914,355,0,355,0,2,353
HAJDÚ-BIHAR,Mikepércs,004,890,349,0,349,0,3,346
HAJDÚ-BIHAR,Monostorpályi,001,823,243,0,243,0,0,243
HAJDÚ-BIHAR,Monostorpályi,002,929,270,0,270,0,4,266
HAJDÚ-BIHAR,Nagyhegyes,001,1213,382,0,382,0,0,382
HAJDÚ-BIHAR,Nagyhegyes,002,1119,420,0,420,0,0,420
HAJDÚ-BIHAR,Nagykereki,001,1025,298,0,298,0,1,297
HAJDÚ-BIHAR,Nagyrábé,001,885,294,0,294,0,0,294
HAJDÚ-BIHAR,Nagyrábé,002,878,248,0,248,0,6,242
HAJDÚ-BIHAR,Nádudvar,001,1076,333,0,333,0,2,331
HAJDÚ-BIHAR,Nádudvar,002,967,307,0,307,0,4,303
HAJDÚ-BIHAR,Nádudvar,003,1065,375,0,375,0,4,371
HAJDÚ-BIHAR,Nádudvar,004,1009,255,0,255,0,3,252
HAJDÚ-BIHAR,Nádudvar,005,995,328,0,328,0,4,324
HAJDÚ-BIHAR,Nádudvar,006,953,259,0,259,0,1,258
HAJDÚ-BIHAR,Nádudvar,007,930,250,0,250,0,2,248
HAJDÚ-BIHAR,Nyíracsád,001,454,151,0,151,0,0,151
HAJDÚ-BIHAR,Nyíracsád,002,822,276,0,276,0,5,271
HAJDÚ-BIHAR,Nyíracsád,003,602,195,0,195,0,2,193
HAJDÚ-BIHAR,Nyíracsád,004,934,336,0,336,0,11,325
HAJDÚ-BIHAR,Nyíracsád,005,92,32,0,32,0,0,32
HAJDÚ-BIHAR,Nyíracsád,006,176,60,0,60,0,0,60
HAJDÚ-BIHAR,Nyíradony,001,777,355,0,355,0,0,355
HAJDÚ-BIHAR,Nyíradony,002,762,328,0,328,0,5,323
HAJDÚ-BIHAR,Nyíradony,003,712,261,0,261,0,7,254
HAJDÚ-BIHAR,Nyíradony,004,612,321,0,321,0,2,319
HAJDÚ-BIHAR,Nyíradony,005,862,401,0,401,0,4,397
HAJDÚ-BIHAR,Nyíradony,006,1125,395,0,395,0,7,388
HAJDÚ-BIHAR,Nyíradony,007,763,276,0,276,0,2,274
HAJDÚ-BIHAR,Nyíradony,008,416,191,0,191,0,0,191
HAJDÚ-BIHAR,Nyírábrány,001,818,285,0,285,0,4,281
HAJDÚ-BIHAR,Nyírábrány,002,834,271,0,271,0,6,265
HAJDÚ-BIHAR,Nyírábrány,003,587,208,0,208,0,4,204
HAJDÚ-BIHAR,Nyírábrány,004,741,243,0,243,0,3,240
HAJDÚ-BIHAR,Nyírábrány,005,84,49,0,49,0,0,49
HAJDÚ-BIHAR,Nyírmártonfalva,001,820,264,0,264,0,2,262
HAJDÚ-BIHAR,Nyírmártonfalva,002,803,301,0,301,0,1,300
HAJDÚ-BIHAR,Pocsaj,001,924,271,0,271,0,0,271
HAJDÚ-BIHAR,Pocsaj,002,1052,342,0,342,0,0,342
HAJDÚ-BIHAR,Polgár,001,775,270,0,270,0,1,269
HAJDÚ-BIHAR,Polgár,002,911,296,0,296,0,2,294
HAJDÚ-BIHAR,Polgár,003,872,363,0,362,-1,3,359
HAJDÚ-BIHAR,Polgár,004,715,197,0,197,0,1,196
HAJDÚ-BIHAR,Polgár,005,1066,355,0,355,0,1,354
HAJDÚ-BIHAR,Polgár,006,1102,254,0,254,0,2,252
HAJDÚ-BIHAR,Polgár,007,972,161,0,161,0,0,161
HAJDÚ-BIHAR,Püspökladány,001,839,314,0,314,0,2,312
HAJDÚ-BIHAR,Püspökladány,002,648,311,0,311,0,2,309
HAJDÚ-BIHAR,Püspökladány,003,663,275,0,275,0,3,272
HAJDÚ-BIHAR,Püspökladány,004,757,283,0,282,-1,2,280
HAJDÚ-BIHAR,Püspökladány,005,755,268,1,267,-1,1,266
HAJDÚ-BIHAR,Püspökladány,006,713,248,1,248,0,3,245
HAJDÚ-BIHAR,Püspökladány,007,777,290,0,290,0,0,290
HAJDÚ-BIHAR,Püspökladány,008,743,291,0,291,0,2,289
HAJDÚ-BIHAR,Püspökladány,009,823,340,0,340,0,3,337
HAJDÚ-BIHAR,Püspökladány,010,642,273,0,273,0,2,271
HAJDÚ-BIHAR,Püspökladány,011,675,247,0,247,0,1,246
HAJDÚ-BIHAR,Püspökladány,012,761,248,0,248,0,2,246
HAJDÚ-BIHAR,Püspökladány,013,803,303,0,303,0,0,303
HAJDÚ-BIHAR,Püspökladány,014,587,202,0,202,0,1,201
HAJDÚ-BIHAR,Püspökladány,015,717,179,0,179,0,1,178
HAJDÚ-BIHAR,Püspökladány,016,830,224,0,224,0,1,223
HAJDÚ-BIHAR,Sáp,001,704,211,0,211,0,3,208
HAJDÚ-BIHAR,Sáránd,001,893,331,0,331,0,2,329
HAJDÚ-BIHAR,Sáránd,002,996,287,0,287,0,1,286
HAJDÚ-BIHAR,Sárrétudvari,001,791,260,0,260,0,0,260
HAJDÚ-BIHAR,Sárrétudvari,002,741,257,0,257,0,0,257
HAJDÚ-BIHAR,Sárrétudvari,003,769,276,0,276,0,0,276
HAJDÚ-BIHAR,Szentpéterszeg,001,893,293,0,293,0,1,292
HAJDÚ-BIHAR,Szerep,001,973,307,0,307,0,4,303
HAJDÚ-BIHAR,Szerep,002,66,28,0,28,0,0,28
HAJDÚ-BIHAR,Tetétlen,001,502,139,0,139,0,2,137
HAJDÚ-BIHAR,Tetétlen,002,574,180,0,180,0,1,179
HAJDÚ-BIHAR,Téglás,001,1179,344,0,344,0,1,343
HAJDÚ-BIHAR,Téglás,002,1043,247,0,247,0,2,245
HAJDÚ-BIHAR,Téglás,003,983,324,0,324,0,2,322
HAJDÚ-BIHAR,Téglás,004,1003,329,0,329,0,1,328
HAJDÚ-BIHAR,Téglás,005,915,265,0,265,0,1,264
HAJDÚ-BIHAR,Tépe,001,818,269,0,269,0,0,269
HAJDÚ-BIHAR,Tiszacsege,001,687,182,0,182,0,3,179
HAJDÚ-BIHAR,Tiszacsege,002,683,177,0,177,0,0,177
HAJDÚ-BIHAR,Tiszacsege,003,860,223,0,223,0,0,223
HAJDÚ-BIHAR,Tiszacsege,004,800,183,0,183,0,1,182
HAJDÚ-BIHAR,Tiszacsege,005,633,167,0,167,0,1,166
HAJDÚ-BIHAR,Tiszacsege,006,77,29,0,29,0,0,29
HAJDÚ-BIHAR,Tiszagyulaháza,001,581,191,0,191,0,0,191
HAJDÚ-BIHAR,Told,001,266,55,0,55,0,2,53
HAJDÚ-BIHAR,Újiráz,001,429,201,0,201,0,1,200
HAJDÚ-BIHAR,Újléta,001,809,312,0,312,0,3,309
HAJDÚ-BIHAR,Újszentmargita,001,1160,308,0,308,0,2,306
HAJDÚ-BIHAR,Újtikos,001,710,214,0,214,0,2,212
HAJDÚ-BIHAR,Vámospércs,001,1103,374,0,374,0,5,369
HAJDÚ-BIHAR,Vámospércs,002,910,338,0,338,0,6,332
HAJDÚ-BIHAR,Vámospércs,003,841,310,0,310,0,3,307
HAJDÚ-BIHAR,Vámospércs,004,701,344,0,343,-1,2,341
HAJDÚ-BIHAR,Vámospércs,005,839,413,0,413,0,5,408
HAJDÚ-BIHAR,Váncsod,001,935,285,0,285,0,3,282
HAJDÚ-BIHAR,Vekerd,001,108,60,0,60,0,5,55
HAJDÚ-BIHAR,Zsáka,001,1251,376,0,375,-1,5,370
HEVES,Abasár,001,1041,429,0,429,0,1,428
HEVES,Abasár,002,1034,416,0,416,0,3,413
HEVES,Adács,001,701,216,0,216,0,0,216
HEVES,Adács,002,718,281,0,281,0,0,281
HEVES,Adács,003,687,258,0,258,0,2,256
HEVES,Aldebrõ,001,605,294,0,294,0,2,292
HEVES,Andornaktálya,001,1111,528,0,528,0,2,526
HEVES,Andornaktálya,002,1087,449,0,449,0,1,448
HEVES,Apc,001,770,276,0,276,0,3,273
HEVES,Apc,002,600,222,0,222,0,2,220
HEVES,Apc,003,625,227,0,227,0,0,227
HEVES,Atkár,001,734,332,0,332,0,1,331
HEVES,Atkár,002,749,263,0,263,0,1,262
HEVES,Átány,001,1039,319,0,319,0,2,317
HEVES,Balaton,001,502,200,0,200,0,2,198
HEVES,Balaton,002,352,123,0,123,0,2,121
HEVES,Bátor,001,293,133,0,133,0,1,132
HEVES,Bekölce,001,540,176,0,176,0,0,176
HEVES,Besenyõtelek,001,689,213,0,213,0,0,213
HEVES,Besenyõtelek,002,640,207,0,207,0,1,206
HEVES,Besenyõtelek,003,786,220,0,220,0,2,218
HEVES,Bélapátfalva,001,775,309,0,309,0,1,308
HEVES,Bélapátfalva,002,859,285,0,285,0,0,285
HEVES,Bélapátfalva,003,664,265,0,265,0,1,264
HEVES,Boconád,001,1067,378,0,378,0,0,378
HEVES,Bodony,001,596,261,0,261,0,1,260
HEVES,Boldog,001,826,309,0,309,0,0,309
HEVES,Boldog,002,800,303,0,303,0,1,302
HEVES,Boldog,003,781,305,0,305,0,3,302
HEVES,Bükkszenterzsébet,001,796,299,0,299,0,0,299
HEVES,Bükkszentmárton,001,220,81,0,81,0,0,81
HEVES,Bükkszék,001,587,296,0,296,0,1,295
HEVES,Csány,001,583,181,0,181,0,5,176
HEVES,Csány,002,552,125,0,125,0,1,124
HEVES,Csány,003,581,178,0,178,0,0,178
HEVES,Demjén,001,537,256,0,256,0,3,253
HEVES,Detk,001,931,320,0,320,0,2,318
HEVES,Domoszló,001,753,284,0,284,0,1,283
HEVES,Domoszló,002,887,377,0,377,0,1,376
HEVES,Dormánd,001,756,205,0,205,0,4,201
HEVES,Ecséd,001,895,356,0,356,0,1,355
HEVES,Ecséd,002,888,319,0,319,0,2,317
HEVES,Ecséd,003,845,329,2,327,-2,3,324
HEVES,Eger,001,697,379,0,379,0,1,378
HEVES,Eger,002,638,327,0,327,0,1,326
HEVES,Eger,003,1032,497,0,496,-1,4,492
HEVES,Eger,004,1045,572,0,572,0,2,570
HEVES,Eger,005,992,458,0,458,0,1,457
HEVES,Eger,006,1003,536,0,536,0,3,533
HEVES,Eger,007,979,508,0,508,0,0,508
HEVES,Eger,008,826,482,0,482,0,3,479
HEVES,Eger,009,822,397,0,397,0,3,394
HEVES,Eger,010,945,511,0,511,0,0,511
HEVES,Eger,011,1064,580,0,581,1,10,571
HEVES,Eger,012,967,520,0,520,0,3,517
HEVES,Eger,013,1003,487,0,487,0,5,482
HEVES,Eger,014,962,502,0,502,0,2,500
HEVES,Eger,015,1137,533,5,528,-5,2,526
HEVES,Eger,016,637,359,0,359,0,1,358
HEVES,Eger,017,597,287,0,287,0,1,286
HEVES,Eger,018,648,345,0,345,0,1,344
HEVES,Eger,019,909,419,0,419,0,2,417
HEVES,Eger,020,644,261,0,261,0,3,258
HEVES,Eger,021,1102,613,1,613,0,4,609
HEVES,Eger,022,1085,562,0,562,0,0,562
HEVES,Eger,023,1448,966,1,966,0,3,963
HEVES,Eger,024,901,461,0,461,0,0,461
HEVES,Eger,025,940,479,0,479,0,0,479
HEVES,Eger,026,842,433,0,433,0,0,433
HEVES,Eger,027,838,431,0,430,-1,1,429
HEVES,Eger,028,1063,399,0,399,0,1,398
HEVES,Eger,029,846,428,0,428,0,2,426
HEVES,Eger,030,966,515,0,515,0,1,514
HEVES,Eger,031,714,379,0,378,-1,1,377
HEVES,Eger,032,817,333,0,333,0,0,333
HEVES,Eger,033,802,367,0,366,-1,1,365
HEVES,Eger,034,918,418,0,418,0,3,415
HEVES,Eger,035,735,334,0,334,0,1,333
HEVES,Eger,036,839,369,0,369,0,2,367
HEVES,Eger,037,991,440,0,440,0,0,440
HEVES,Eger,038,939,423,0,423,0,1,422
HEVES,Eger,039,883,387,0,387,0,2,385
HEVES,Eger,040,917,319,2,318,-1,2,316
HEVES,Eger,041,1014,462,0,461,-1,0,461
HEVES,Eger,042,1133,469,0,469,0,1,468
HEVES,Eger,043,772,269,1,267,-2,1,266
HEVES,Eger,044,1090,416,0,416,0,0,416
HEVES,Eger,045,1215,582,0,582,0,3,579
HEVES,Eger,046,818,375,0,375,0,1,374
HEVES,Eger,047,793,347,0,347,0,0,347
HEVES,Egerbakta,001,1181,452,0,452,0,4,448
HEVES,Egerbocs,001,444,184,0,184,0,1,183
HEVES,Egercsehi,001,217,63,0,63,0,2,61
HEVES,Egercsehi,002,418,131,0,131,0,0,131
HEVES,Egercsehi,003,403,115,0,115,0,3,112
HEVES,Egerfarmos,001,539,219,0,219,0,1,218
HEVES,Egerszalók,001,855,456,0,456,0,1,455
HEVES,Egerszalók,002,719,318,1,317,-1,0,317
HEVES,Egerszólát,001,932,422,0,422,0,1,421
HEVES,Erdõkövesd,001,491,258,0,258,0,2,256
HEVES,Erdõtelek,001,815,230,0,230,0,3,227
HEVES,Erdõtelek,002,888,244,0,244,0,1,243
HEVES,Erdõtelek,003,887,241,0,241,0,2,239
HEVES,Erk,001,608,191,0,191,0,3,188
HEVES,Fedémes,001,272,160,0,160,0,1,159
HEVES,Feldebrõ,001,808,331,0,331,0,1,330
HEVES,Felsõtárkány,001,946,466,0,466,0,2,464
HEVES,Felsõtárkány,002,926,316,0,316,0,3,313
HEVES,Felsõtárkány,003,937,514,0,514,0,4,510
HEVES,Füzesabony,001,638,274,0,274,0,4,270
HEVES,Füzesabony,002,650,215,0,214,-1,2,212
HEVES,Füzesabony,003,807,387,0,387,0,1,386
HEVES,Füzesabony,004,966,376,0,376,0,1,375
HEVES,Füzesabony,005,620,207,0,207,0,0,207
HEVES,Füzesabony,006,617,208,0,208,0,1,207
HEVES,Füzesabony,007,892,309,0,309,0,2,307
HEVES,Füzesabony,008,971,352,0,352,0,1,351
HEVES,Gyöngyös,001,620,352,0,352,0,1,351
HEVES,Gyöngyös,002,1045,576,0,576,0,5,571
HEVES,Gyöngyös,003,668,298,0,297,-1,0,297
HEVES,Gyöngyös,004,848,410,0,410,0,1,409
HEVES,Gyöngyös,005,1024,346,0,346,0,7,339
HEVES,Gyöngyös,006,990,520,0,520,0,2,518
HEVES,Gyöngyös,007,885,525,0,525,0,2,523
HEVES,Gyöngyös,008,703,386,0,386,0,1,385
HEVES,Gyöngyös,009,929,499,0,499,0,2,497
HEVES,Gyöngyös,010,774,412,0,411,-1,0,411
HEVES,Gyöngyös,011,1029,526,0,526,0,2,524
HEVES,Gyöngyös,012,707,381,0,381,0,1,380
HEVES,Gyöngyös,013,799,373,0,373,0,2,371
HEVES,Gyöngyös,014,708,382,0,382,0,1,381
HEVES,Gyöngyös,015,706,336,0,336,0,1,335
HEVES,Gyöngyös,016,843,334,0,333,-1,0,333
HEVES,Gyöngyös,017,743,320,0,320,0,0,320
HEVES,Gyöngyös,018,672,297,0,297,0,0,297
HEVES,Gyöngyös,019,809,334,0,334,0,0,334
HEVES,Gyöngyös,020,890,386,0,386,0,2,384
HEVES,Gyöngyös,021,752,289,0,289,0,0,289
HEVES,Gyöngyös,022,888,380,0,379,-1,2,377
HEVES,Gyöngyös,023,986,382,0,382,0,3,379
HEVES,Gyöngyös,024,544,281,0,281,0,0,281
HEVES,Gyöngyös,025,794,326,0,326,0,3,323
HEVES,Gyöngyös,026,613,258,0,258,0,2,256
HEVES,Gyöngyös,027,800,336,0,336,0,0,336
HEVES,Gyöngyös,028,818,363,0,363,0,0,363
HEVES,Gyöngyös,029,748,324,0,324,0,1,323
HEVES,Gyöngyös,030,444,134,0,134,0,0,134
HEVES,Gyöngyöshalász,001,1087,456,0,456,0,2,454
HEVES,Gyöngyöshalász,002,1031,454,0,454,0,2,452
HEVES,Gyöngyösoroszi,001,1105,271,0,271,0,5,266
HEVES,Gyöngyöspata,001,730,261,0,261,0,2,259
HEVES,Gyöngyöspata,002,1270,532,0,532,0,0,532
HEVES,Gyöngyössolymos,001,766,311,0,311,0,0,311
HEVES,Gyöngyössolymos,002,863,411,0,411,0,0,411
HEVES,Gyöngyössolymos,003,843,396,0,396,0,0,396
HEVES,Gyöngyöstarján,001,899,397,0,397,0,2,395
HEVES,Gyöngyöstarján,002,994,391,1,390,-1,1,389
HEVES,Halmajugra,001,313,76,0,76,0,1,75
HEVES,Halmajugra,002,643,150,0,150,0,1,149
HEVES,Hatvan,001,921,526,0,526,0,2,524
HEVES,Hatvan,002,1156,590,0,590,0,3,587
HEVES,Hatvan,003,1115,419,0,419,0,2,417
HEVES,Hatvan,004,897,396,0,396,0,3,393
HEVES,Hatvan,005,980,354,0,354,0,1,353
HEVES,Hatvan,006,955,447,0,447,0,2,445
HEVES,Hatvan,007,1070,455,0,455,0,1,454
HEVES,Hatvan,008,931,429,0,429,0,2,427
HEVES,Hatvan,009,857,382,0,382,0,0,382
HEVES,Hatvan,010,859,388,0,388,0,2,386
HEVES,Hatvan,011,1116,533,0,533,0,2,531
HEVES,Hatvan,012,1254,568,0,568,0,0,568
HEVES,Hatvan,013,709,333,0,333,0,0,333
HEVES,Hatvan,014,1114,521,0,519,-2,1,518
HEVES,Hatvan,015,1295,499,0,499,0,3,496
HEVES,Hatvan,016,596,261,0,261,0,2,259
HEVES,Hatvan,017,1057,404,0,404,0,1,403
HEVES,Heréd,001,805,370,0,370,0,4,366
HEVES,Heréd,002,756,273,0,273,0,1,272
HEVES,Heves,001,1053,440,0,439,-1,4,435
HEVES,Heves,002,1002,475,0,475,0,3,472
HEVES,Heves,003,1122,413,0,413,0,1,412
HEVES,Heves,004,220,88,0,88,0,0,88
HEVES,Heves,005,1081,424,0,424,0,2,422
HEVES,Heves,006,986,295,0,295,0,0,295
HEVES,Heves,007,1098,378,0,378,0,0,378
HEVES,Heves,008,1105,427,0,425,-2,3,422
HEVES,Heves,009,697,152,0,152,0,0,152
HEVES,Hevesaranyos,001,485,175,0,175,0,1,174
HEVES,Hevesvezekény,001,559,213,0,213,0,4,209
HEVES,Hort,001,741,231,0,231,0,0,231
HEVES,Hort,002,734,285,0,285,0,2,283
HEVES,Hort,003,780,263,0,263,0,3,260
HEVES,Hort,004,759,275,0,275,0,1,274
HEVES,Istenmezeje,001,564,195,0,195,0,3,192
HEVES,Istenmezeje,002,538,166,0,166,0,0,166
HEVES,Istenmezeje,003,152,76,0,76,0,1,75
HEVES,Ivád,001,302,147,0,147,0,0,147
HEVES,Karácsond,001,835,334,0,334,0,2,332
HEVES,Karácsond,002,797,234,0,234,0,1,233
HEVES,Karácsond,003,757,298,0,298,0,1,297
HEVES,Kál,001,757,213,0,213,0,1,212
HEVES,Kál,002,806,193,0,193,0,2,191
HEVES,Kál,003,696,235,0,235,0,2,233
HEVES,Kál,004,422,164,0,164,0,0,164
HEVES,Kápolna,001,660,182,0,182,0,0,182
HEVES,Kápolna,002,502,190,0,190,0,4,186
HEVES,Kerecsend,001,879,350,0,350,0,0,350
HEVES,Kerecsend,002,789,214,0,214,0,0,214
HEVES,Kisfüzes,001,113,76,0,76,0,0,76
HEVES,Kisköre,001,848,309,0,309,0,0,309
HEVES,Kisköre,002,595,173,0,173,0,1,172
HEVES,Kisköre,003,770,216,0,216,0,3,213
HEVES,Kisnána,001,854,310,0,309,-1,2,307
HEVES,Kompolt,001,729,177,0,177,0,2,175
HEVES,Kompolt,002,796,332,0,332,0,0,332
HEVES,Kömlõ,001,680,169,0,169,0,0,169
HEVES,Kömlõ,002,676,183,0,183,0,1,182
HEVES,Lõrinci,001,671,266,1,265,-1,2,263
HEVES,Lõrinci,002,816,247,0,247,0,0,247
HEVES,Lõrinci,003,853,298,0,298,0,4,294
HEVES,Lõrinci,004,765,269,0,269,0,0,269
HEVES,Lõrinci,005,772,288,0,288,0,5,283
HEVES,Lõrinci,006,631,277,0,277,0,1,276
HEVES,Ludas,001,610,305,0,305,0,4,301
HEVES,Maklár,001,640,258,0,258,0,0,258
HEVES,Maklár,002,678,282,0,282,0,0,282
HEVES,Maklár,003,668,219,0,219,0,0,219
HEVES,Markaz,001,682,295,0,295,0,2,293
HEVES,Markaz,002,795,382,0,382,0,3,379
HEVES,Mátraballa,001,645,342,0,342,0,6,336
HEVES,Mátraderecske,001,800,329,0,329,0,0,329
HEVES,Mátraderecske,002,765,350,0,350,0,0,350
HEVES,Mátraszentimre,001,453,247,0,247,0,0,247
HEVES,Mezõszemere,001,860,285,0,285,0,0,285
HEVES,Mezõtárkány,001,1207,439,0,439,0,1,438
HEVES,Mikófalva,001,571,212,0,212,0,0,212
HEVES,Mónosbél,001,271,120,0,120,0,0,120
HEVES,Nagyfüged,001,1256,345,0,345,0,8,337
HEVES,Nagykökényes,001,482,244,0,244,0,3,241
HEVES,Nagyréde,001,1020,395,1,394,-1,3,391
HEVES,Nagyréde,002,945,404,0,404,0,2,402
HEVES,Nagyréde,003,738,292,0,292,0,0,292
HEVES,Nagytálya,001,711,341,0,341,0,0,341
HEVES,Nagyút,001,562,227,0,227,0,1,226
HEVES,Nagyvisnyó,001,792,337,0,337,0,4,333
HEVES,Noszvaj,001,791,363,0,363,0,1,362
HEVES,Noszvaj,002,817,416,0,416,0,0,416
HEVES,Novaj,001,519,224,0,224,0,2,222
HEVES,Novaj,002,633,290,0,290,0,4,286
HEVES,Ostoros,001,599,271,0,271,0,1,270
HEVES,Ostoros,002,760,323,0,323,0,0,323
HEVES,Ostoros,003,799,385,0,385,0,3,382
HEVES,Parád,001,608,291,0,291,0,2,289
HEVES,Parád,002,576,200,0,200,0,2,198
HEVES,Parád,003,359,224,1,223,-1,1,222
HEVES,Parád,004,164,86,0,86,0,0,86
HEVES,Parádsasvár,001,388,236,0,236,0,0,236
HEVES,Petõfibánya,001,1082,503,0,503,0,0,503
HEVES,Petõfibánya,002,1113,363,0,363,0,1,362
HEVES,Pély,001,1103,284,0,284,0,4,280
HEVES,Pétervására,001,608,234,0,234,0,1,233
HEVES,Pétervására,002,582,229,0,229,0,3,226
HEVES,Pétervására,003,570,241,0,241,0,0,241
HEVES,Poroszló,001,753,285,0,285,0,3,282
HEVES,Poroszló,002,793,275,0,275,0,3,272
HEVES,Poroszló,003,746,211,0,211,0,1,210
HEVES,Recsk,001,775,295,0,295,0,3,292
HEVES,Recsk,002,811,254,0,254,0,0,254
HEVES,Recsk,003,667,292,0,292,0,2,290
HEVES,Rózsaszentmárton,001,836,319,0,319,0,1,318
HEVES,Rózsaszentmárton,002,804,368,0,368,0,0,368
HEVES,Sarud,001,870,330,0,327,-3,2,325
HEVES,Sirok,001,714,319,0,318,-1,1,317
HEVES,Sirok,002,602,306,0,306,0,2,304
HEVES,Sirok,003,187,93,0,93,0,2,91
HEVES,Szajla,001,175,54,0,54,0,1,53
HEVES,Szajla,002,282,134,0,134,0,1,133
HEVES,Szentdomonkos,001,387,138,0,138,0,0,138
HEVES,Szihalom,001,828,308,0,308,0,3,305
HEVES,Szihalom,002,830,306,0,306,0,1,305
HEVES,Szilvásvárad,001,685,328,0,328,0,0,328
HEVES,Szilvásvárad,002,691,279,0,279,0,2,277
HEVES,Szúcs,001,193,69,0,69,0,0,69
HEVES,Szúcs,002,100,32,0,32,0,1,31
HEVES,Szûcsi,001,764,295,0,295,0,0,295
HEVES,Szûcsi,002,515,204,0,204,0,2,202
HEVES,Tarnabod,001,434,113,0,113,0,0,113
HEVES,Tarnalelesz,001,601,253,0,253,0,5,248
HEVES,Tarnalelesz,002,653,280,0,280,0,2,278
HEVES,Tarnaméra,001,694,287,0,287,0,0,287
HEVES,Tarnaméra,002,693,247,0,247,0,1,246
HEVES,Tarnaörs,001,1280,251,0,251,0,3,248
HEVES,Tarnaszentmária,001,211,105,0,105,0,0,105
HEVES,Tarnaszentmiklós,001,627,186,0,185,-1,6,179
HEVES,Tarnazsadány,001,371,113,0,113,0,3,110
HEVES,Tarnazsadány,002,507,158,0,158,0,1,157
HEVES,Tenk,001,981,320,0,318,-2,5,313
HEVES,Terpes,001,153,75,0,75,0,1,74
HEVES,Tiszanána,001,917,343,0,343,0,0,343
HEVES,Tiszanána,002,908,376,0,376,0,0,376
HEVES,Tófalu,001,456,181,0,181,0,0,181
HEVES,Újlõrincfalva,001,174,91,0,91,0,0,91
HEVES,Vámosgyörk,001,832,365,0,365,0,3,362
HEVES,Vámosgyörk,002,804,355,0,355,0,2,353
HEVES,Váraszó,001,397,205,0,205,0,1,204
HEVES,Verpelét,001,602,232,0,232,0,0,232
HEVES,Verpelét,002,834,178,0,178,0,2,176
HEVES,Verpelét,003,673,231,0,230,-1,1,229
HEVES,Verpelét,004,855,347,0,347,0,0,347
HEVES,Vécs,001,499,189,0,188,-1,0,188
HEVES,Visonta,001,973,394,0,394,0,4,390
HEVES,Visznek,001,887,332,0,332,0,2,330
HEVES,Zagyvaszántó,001,897,374,0,374,0,3,371
HEVES,Zagyvaszántó,002,627,242,0,242,0,2,240
HEVES,Zaránk,001,385,154,0,154,0,0,154
HEVES,Szarvaskõ,001,312,159,0,159,0,0,159
HEVES,Pálosvörösmart,001,529,262,0,262,0,0,262
HEVES,Kerekharaszt,001,810,375,0,375,0,1,374
JÁSZ-NAGYKUN-SZOLNOK,Abádszalók,001,615,177,0,177,0,0,177
JÁSZ-NAGYKUN-SZOLNOK,Abádszalók,002,707,196,0,196,0,5,191
JÁSZ-NAGYKUN-SZOLNOK,Abádszalók,003,691,188,0,188,0,1,187
JÁSZ-NAGYKUN-SZOLNOK,Abádszalók,004,708,155,0,155,0,1,154
JÁSZ-NAGYKUN-SZOLNOK,Abádszalók,005,636,219,0,219,0,1,218
JÁSZ-NAGYKUN-SZOLNOK,Alattyán,001,606,227,0,227,0,0,227
JÁSZ-NAGYKUN-SZOLNOK,Alattyán,002,953,279,0,279,0,2,277
JÁSZ-NAGYKUN-SZOLNOK,Berekfürdõ,001,1104,521,0,521,0,3,518
JÁSZ-NAGYKUN-SZOLNOK,Besenyszög,001,1046,360,1,359,-1,1,358
JÁSZ-NAGYKUN-SZOLNOK,Besenyszög,002,823,337,0,337,0,2,335
JÁSZ-NAGYKUN-SZOLNOK,Besenyszög,003,861,265,0,265,0,2,263
JÁSZ-NAGYKUN-SZOLNOK,Cibakháza,001,989,300,0,300,0,5,295
JÁSZ-NAGYKUN-SZOLNOK,Cibakháza,002,1054,261,0,261,0,1,260
JÁSZ-NAGYKUN-SZOLNOK,Cibakháza,003,855,271,0,271,0,0,271
JÁSZ-NAGYKUN-SZOLNOK,Cibakháza,004,227,27,0,27,0,0,27
JÁSZ-NAGYKUN-SZOLNOK,Csataszög,001,233,113,0,113,0,0,113
JÁSZ-NAGYKUN-SZOLNOK,Cserkeszõlõ,001,1004,478,0,478,0,2,476
JÁSZ-NAGYKUN-SZOLNOK,Cserkeszõlõ,002,594,191,0,191,0,2,189
JÁSZ-NAGYKUN-SZOLNOK,Cserkeszõlõ,003,313,84,0,84,0,0,84
JÁSZ-NAGYKUN-SZOLNOK,Csépa,001,568,191,0,191,0,0,191
JÁSZ-NAGYKUN-SZOLNOK,Csépa,002,698,245,0,245,0,3,242
JÁSZ-NAGYKUN-SZOLNOK,Fegyvernek,001,1119,389,0,389,0,7,382
JÁSZ-NAGYKUN-SZOLNOK,Fegyvernek,002,1119,345,0,345,0,4,341
JÁSZ-NAGYKUN-SZOLNOK,Fegyvernek,003,1060,288,1,287,-1,6,281
JÁSZ-NAGYKUN-SZOLNOK,Fegyvernek,004,1134,305,0,305,0,5,300
JÁSZ-NAGYKUN-SZOLNOK,Fegyvernek,005,782,222,0,222,0,0,222
JÁSZ-NAGYKUN-SZOLNOK,Hunyadfalva,001,142,57,0,57,0,1,56
JÁSZ-NAGYKUN-SZOLNOK,Jánoshida,001,602,200,0,200,0,0,200
JÁSZ-NAGYKUN-SZOLNOK,Jánoshida,002,823,284,0,284,0,3,281
JÁSZ-NAGYKUN-SZOLNOK,Jánoshida,003,601,242,1,241,-1,0,241
JÁSZ-NAGYKUN-SZOLNOK,Jászalsószentgyörgy,001,700,262,0,262,0,1,261
JÁSZ-NAGYKUN-SZOLNOK,Jászalsószentgyörgy,002,685,246,0,246,0,5,241
JÁSZ-NAGYKUN-SZOLNOK,Jászalsószentgyörgy,003,725,273,0,273,0,0,273
JÁSZ-NAGYKUN-SZOLNOK,Jászalsószentgyörgy,004,708,269,0,269,0,2,267
JÁSZ-NAGYKUN-SZOLNOK,Jászapáti,001,915,373,0,373,0,6,367
JÁSZ-NAGYKUN-SZOLNOK,Jászapáti,002,959,340,0,340,0,5,335
JÁSZ-NAGYKUN-SZOLNOK,Jászapáti,003,942,384,0,384,0,5,379
JÁSZ-NAGYKUN-SZOLNOK,Jászapáti,004,998,377,0,377,0,1,376
JÁSZ-NAGYKUN-SZOLNOK,Jászapáti,005,877,355,0,355,0,4,351
JÁSZ-NAGYKUN-SZOLNOK,Jászapáti,006,1042,373,0,373,0,5,368
JÁSZ-NAGYKUN-SZOLNOK,Jászapáti,007,1014,352,1,351,-1,3,348
JÁSZ-NAGYKUN-SZOLNOK,Jászágó,001,563,212,0,212,0,5,207
JÁSZ-NAGYKUN-SZOLNOK,Jászárokszállás,001,1041,391,0,390,-1,1,389
JÁSZ-NAGYKUN-SZOLNOK,Jászárokszállás,002,1279,454,0,454,0,1,453
JÁSZ-NAGYKUN-SZOLNOK,Jászárokszállás,003,1317,444,0,444,0,5,439
JÁSZ-NAGYKUN-SZOLNOK,Jászárokszállás,004,1197,406,0,404,-2,2,402
JÁSZ-NAGYKUN-SZOLNOK,Jászárokszállás,005,1346,360,0,360,0,3,357
JÁSZ-NAGYKUN-SZOLNOK,Jászberény,001,1102,529,0,529,0,2,527
JÁSZ-NAGYKUN-SZOLNOK,Jászberény,002,1023,514,0,514,0,1,513
JÁSZ-NAGYKUN-SZOLNOK,Jászberény,003,1104,478,0,478,0,4,474
JÁSZ-NAGYKUN-SZOLNOK,Jászberény,004,1204,490,0,490,0,2,488
JÁSZ-NAGYKUN-SZOLNOK,Jászberény,005,949,447,0,445,-2,4,441
JÁSZ-NAGYKUN-SZOLNOK,Jászberény,006,1020,342,0,342,0,0,342
JÁSZ-NAGYKUN-SZOLNOK,Jászberény,007,1009,460,0,460,0,1,459
JÁSZ-NAGYKUN-SZOLNOK,Jászberény,008,1048,463,0,461,-2,2,459
JÁSZ-NAGYKUN-SZOLNOK,Jászberény,009,1022,446,0,446,0,2,444
JÁSZ-NAGYKUN-SZOLNOK,Jászberény,010,1046,467,1,464,-3,2,462
JÁSZ-NAGYKUN-SZOLNOK,Jászberény,011,1072,443,0,443,0,2,441
JÁSZ-NAGYKUN-SZOLNOK,Jászberény,012,1129,449,0,449,0,4,445
JÁSZ-NAGYKUN-SZOLNOK,Jászberény,013,1100,468,0,468,0,4,464
JÁSZ-NAGYKUN-SZOLNOK,Jászberény,014,1054,421,0,421,0,2,419
JÁSZ-NAGYKUN-SZOLNOK,Jászberény,015,1216,540,0,540,0,0,540
JÁSZ-NAGYKUN-SZOLNOK,Jászberény,016,1009,397,0,397,0,2,395
JÁSZ-NAGYKUN-SZOLNOK,Jászberény,017,960,393,0,393,0,0,393
JÁSZ-NAGYKUN-SZOLNOK,Jászberény,018,967,388,1,387,-1,1,386
JÁSZ-NAGYKUN-SZOLNOK,Jászberény,019,784,309,0,309,0,2,307
JÁSZ-NAGYKUN-SZOLNOK,Jászberény,020,722,235,0,235,0,4,231
JÁSZ-NAGYKUN-SZOLNOK,Jászberény,021,712,163,0,163,0,0,163
JÁSZ-NAGYKUN-SZOLNOK,Jászboldogháza,001,730,346,0,346,0,0,346
JÁSZ-NAGYKUN-SZOLNOK,Jászboldogháza,002,687,325,0,325,0,5,320
JÁSZ-NAGYKUN-SZOLNOK,Jászdózsa,001,566,208,0,208,0,0,208
JÁSZ-NAGYKUN-SZOLNOK,Jászdózsa,002,601,204,0,204,0,0,204
JÁSZ-NAGYKUN-SZOLNOK,Jászdózsa,003,567,204,0,204,0,0,204
JÁSZ-NAGYKUN-SZOLNOK,Jászfelsõszentgyörgy,001,735,208,0,208,0,2,206
JÁSZ-NAGYKUN-SZOLNOK,Jászfelsõszentgyörgy,002,682,247,0,247,0,2,245
JÁSZ-NAGYKUN-SZOLNOK,Jászfényszaru,001,867,248,0,248,0,3,245
JÁSZ-NAGYKUN-SZOLNOK,Jászfényszaru,002,935,283,0,283,0,2,281
JÁSZ-NAGYKUN-SZOLNOK,Jászfényszaru,003,1006,281,0,281,0,1,280
JÁSZ-NAGYKUN-SZOLNOK,Jászfényszaru,004,925,237,0,237,0,1,236
JÁSZ-NAGYKUN-SZOLNOK,Jászfényszaru,005,897,319,0,319,0,3,316
JÁSZ-NAGYKUN-SZOLNOK,Jászivány,001,330,177,0,177,0,0,177
JÁSZ-NAGYKUN-SZOLNOK,Jászjákóhalma,001,769,310,0,310,0,2,308
JÁSZ-NAGYKUN-SZOLNOK,Jászjákóhalma,002,807,253,0,253,0,4,249
JÁSZ-NAGYKUN-SZOLNOK,Jászjákóhalma,003,722,273,0,272,-1,1,271
JÁSZ-NAGYKUN-SZOLNOK,Jászkisér,001,832,286,0,286,0,2,284
JÁSZ-NAGYKUN-SZOLNOK,Jászkisér,002,836,272,0,272,0,4,268
JÁSZ-NAGYKUN-SZOLNOK,Jászkisér,003,882,170,0,170,0,1,169
JÁSZ-NAGYKUN-SZOLNOK,Jászkisér,004,777,223,0,223,0,3,220
JÁSZ-NAGYKUN-SZOLNOK,Jászkisér,005,811,329,0,329,0,1,328
JÁSZ-NAGYKUN-SZOLNOK,Jászladány,001,722,166,0,166,0,1,165
JÁSZ-NAGYKUN-SZOLNOK,Jászladány,002,808,196,0,196,0,3,193
JÁSZ-NAGYKUN-SZOLNOK,Jászladány,003,610,201,0,201,0,1,200
JÁSZ-NAGYKUN-SZOLNOK,Jászladány,004,623,211,0,211,0,2,209
JÁSZ-NAGYKUN-SZOLNOK,Jászladány,005,687,218,0,218,0,0,218
JÁSZ-NAGYKUN-SZOLNOK,Jászladány,006,697,277,0,277,0,2,275
JÁSZ-NAGYKUN-SZOLNOK,Jászszentandrás,001,969,462,0,462,0,0,462
JÁSZ-NAGYKUN-SZOLNOK,Jászszentandrás,002,1060,483,0,483,0,2,481
JÁSZ-NAGYKUN-SZOLNOK,Jásztelek,001,610,192,0,192,0,1,191
JÁSZ-NAGYKUN-SZOLNOK,Jásztelek,002,576,186,0,186,0,3,183
JÁSZ-NAGYKUN-SZOLNOK,Karcag,001,954,485,0,485,0,2,483
JÁSZ-NAGYKUN-SZOLNOK,Karcag,002,765,329,0,329,0,1,328
JÁSZ-NAGYKUN-SZOLNOK,Karcag,003,1053,545,0,545,0,2,543
JÁSZ-NAGYKUN-SZOLNOK,Karcag,004,972,393,0,393,0,0,393
JÁSZ-NAGYKUN-SZOLNOK,Karcag,005,901,405,0,405,0,1,404
JÁSZ-NAGYKUN-SZOLNOK,Karcag,006,991,337,0,337,0,2,335
JÁSZ-NAGYKUN-SZOLNOK,Karcag,007,948,437,0,437,0,3,434
JÁSZ-NAGYKUN-SZOLNOK,Karcag,008,887,369,0,369,0,0,369
JÁSZ-NAGYKUN-SZOLNOK,Karcag,009,974,517,0,517,0,2,515
JÁSZ-NAGYKUN-SZOLNOK,Karcag,010,1049,443,0,443,0,3,440
JÁSZ-NAGYKUN-SZOLNOK,Karcag,011,1102,460,0,460,0,3,457
JÁSZ-NAGYKUN-SZOLNOK,Karcag,012,1042,369,0,369,0,8,361
JÁSZ-NAGYKUN-SZOLNOK,Karcag,013,1083,377,0,377,0,4,373
JÁSZ-NAGYKUN-SZOLNOK,Karcag,014,1035,333,0,333,0,4,329
JÁSZ-NAGYKUN-SZOLNOK,Karcag,015,1031,353,0,353,0,0,353
JÁSZ-NAGYKUN-SZOLNOK,Karcag,016,1033,452,0,452,0,4,448
JÁSZ-NAGYKUN-SZOLNOK,Kenderes,001,843,317,0,317,0,1,316
JÁSZ-NAGYKUN-SZOLNOK,Kenderes,002,774,256,0,256,0,3,253
JÁSZ-NAGYKUN-SZOLNOK,Kenderes,003,747,227,0,227,0,4,223
JÁSZ-NAGYKUN-SZOLNOK,Kenderes,004,759,199,0,199,0,5,194
JÁSZ-NAGYKUN-SZOLNOK,Kenderes,005,400,156,0,156,0,1,155
JÁSZ-NAGYKUN-SZOLNOK,Kengyel,001,719,263,0,263,0,3,260
JÁSZ-NAGYKUN-SZOLNOK,Kengyel,002,604,202,0,202,0,0,202
JÁSZ-NAGYKUN-SZOLNOK,Kengyel,003,667,142,0,141,-1,3,138
JÁSZ-NAGYKUN-SZOLNOK,Kengyel,004,653,164,0,164,0,1,163
JÁSZ-NAGYKUN-SZOLNOK,Kengyel,005,221,80,0,80,0,0,80
JÁSZ-NAGYKUN-SZOLNOK,Kétpó,001,522,267,0,267,0,1,266
JÁSZ-NAGYKUN-SZOLNOK,Kisújszállás,001,1199,535,0,535,0,1,534
JÁSZ-NAGYKUN-SZOLNOK,Kisújszállás,002,1158,359,0,359,0,2,357
JÁSZ-NAGYKUN-SZOLNOK,Kisújszállás,003,1208,402,0,401,-1,1,400
JÁSZ-NAGYKUN-SZOLNOK,Kisújszállás,004,1082,373,0,373,0,3,370
JÁSZ-NAGYKUN-SZOLNOK,Kisújszállás,005,1116,380,0,380,0,1,379
JÁSZ-NAGYKUN-SZOLNOK,Kisújszállás,006,1009,405,0,405,0,4,401
JÁSZ-NAGYKUN-SZOLNOK,Kisújszállás,007,1085,433,0,433,0,4,429
JÁSZ-NAGYKUN-SZOLNOK,Kisújszállás,008,1115,396,0,395,-1,6,389
JÁSZ-NAGYKUN-SZOLNOK,Kõtelek,001,633,266,0,266,0,1,265
JÁSZ-NAGYKUN-SZOLNOK,Kõtelek,002,570,228,0,228,0,2,226
JÁSZ-NAGYKUN-SZOLNOK,Kuncsorba,001,481,204,0,204,0,2,202
JÁSZ-NAGYKUN-SZOLNOK,Kunhegyes,001,880,268,0,268,0,1,267
JÁSZ-NAGYKUN-SZOLNOK,Kunhegyes,002,716,255,0,255,0,0,255
JÁSZ-NAGYKUN-SZOLNOK,Kunhegyes,003,701,206,0,206,0,0,206
JÁSZ-NAGYKUN-SZOLNOK,Kunhegyes,004,1073,423,0,423,0,1,422
JÁSZ-NAGYKUN-SZOLNOK,Kunhegyes,005,973,225,0,225,0,1,224
JÁSZ-NAGYKUN-SZOLNOK,Kunhegyes,006,908,247,0,247,0,2,245
JÁSZ-NAGYKUN-SZOLNOK,Kunhegyes,007,1105,335,0,335,0,5,330
JÁSZ-NAGYKUN-SZOLNOK,Kunmadaras,001,565,163,0,163,0,1,162
JÁSZ-NAGYKUN-SZOLNOK,Kunmadaras,002,574,144,0,144,0,1,143
JÁSZ-NAGYKUN-SZOLNOK,Kunmadaras,003,582,208,0,208,0,0,208
JÁSZ-NAGYKUN-SZOLNOK,Kunmadaras,004,603,169,0,168,-1,0,168
JÁSZ-NAGYKUN-SZOLNOK,Kunmadaras,005,581,141,0,141,0,0,141
JÁSZ-NAGYKUN-SZOLNOK,Kunmadaras,006,557,128,0,128,0,1,127
JÁSZ-NAGYKUN-SZOLNOK,Kunmadaras,007,592,147,0,147,0,7,140
JÁSZ-NAGYKUN-SZOLNOK,Kunszentmárton,001,626,230,0,230,0,4,226
JÁSZ-NAGYKUN-SZOLNOK,Kunszentmárton,002,755,220,0,220,0,3,217
JÁSZ-NAGYKUN-SZOLNOK,Kunszentmárton,003,680,236,0,236,0,1,235
JÁSZ-NAGYKUN-SZOLNOK,Kunszentmárton,004,669,235,0,235,0,3,232
JÁSZ-NAGYKUN-SZOLNOK,Kunszentmárton,005,667,249,0,249,0,1,248
JÁSZ-NAGYKUN-SZOLNOK,Kunszentmárton,006,770,313,0,313,0,2,311
JÁSZ-NAGYKUN-SZOLNOK,Kunszentmárton,007,795,283,0,283,0,2,281
JÁSZ-NAGYKUN-SZOLNOK,Kunszentmárton,008,1000,315,0,315,0,1,314
JÁSZ-NAGYKUN-SZOLNOK,Kunszentmárton,009,246,96,0,96,0,0,96
JÁSZ-NAGYKUN-SZOLNOK,Kunszentmárton,010,548,172,0,172,0,1,171
JÁSZ-NAGYKUN-SZOLNOK,Martfû,001,694,245,0,245,0,2,243
JÁSZ-NAGYKUN-SZOLNOK,Martfû,002,961,361,0,361,0,0,361
JÁSZ-NAGYKUN-SZOLNOK,Martfû,003,1006,449,0,449,0,0,449
JÁSZ-NAGYKUN-SZOLNOK,Martfû,004,899,389,1,389,0,3,386
JÁSZ-NAGYKUN-SZOLNOK,Martfû,005,814,318,0,317,-1,5,312
JÁSZ-NAGYKUN-SZOLNOK,Martfû,006,1003,427,0,427,0,2,425
JÁSZ-NAGYKUN-SZOLNOK,Mesterszállás,001,575,271,0,271,0,1,270
JÁSZ-NAGYKUN-SZOLNOK,Mezõhék,001,270,78,0,78,0,1,77
JÁSZ-NAGYKUN-SZOLNOK,Mezõtúr,001,782,280,0,280,0,4,276
JÁSZ-NAGYKUN-SZOLNOK,Mezõtúr,002,885,335,0,335,0,0,335
JÁSZ-NAGYKUN-SZOLNOK,Mezõtúr,003,948,413,0,413,0,2,411
JÁSZ-NAGYKUN-SZOLNOK,Mezõtúr,004,927,387,0,387,0,0,387
JÁSZ-NAGYKUN-SZOLNOK,Mezõtúr,005,868,336,0,336,0,2,334
JÁSZ-NAGYKUN-SZOLNOK,Mezõtúr,006,900,261,0,261,0,2,259
JÁSZ-NAGYKUN-SZOLNOK,Mezõtúr,007,820,303,0,303,0,2,301
JÁSZ-NAGYKUN-SZOLNOK,Mezõtúr,008,878,398,0,398,0,2,396
JÁSZ-NAGYKUN-SZOLNOK,Mezõtúr,009,830,300,0,300,0,1,299
JÁSZ-NAGYKUN-SZOLNOK,Mezõtúr,010,865,296,0,296,0,1,295
JÁSZ-NAGYKUN-SZOLNOK,Mezõtúr,011,868,350,0,350,0,0,350
JÁSZ-NAGYKUN-SZOLNOK,Mezõtúr,012,812,303,0,302,-1,6,296
JÁSZ-NAGYKUN-SZOLNOK,Mezõtúr,013,823,301,0,301,0,1,300
JÁSZ-NAGYKUN-SZOLNOK,Mezõtúr,014,829,376,0,376,0,2,374
JÁSZ-NAGYKUN-SZOLNOK,Mezõtúr,015,828,343,0,343,0,0,343
JÁSZ-NAGYKUN-SZOLNOK,Mezõtúr,016,807,397,0,397,0,1,396
JÁSZ-NAGYKUN-SZOLNOK,Nagyiván,001,857,377,0,377,0,2,375
JÁSZ-NAGYKUN-SZOLNOK,Nagykörû,001,624,186,1,184,-2,0,184
JÁSZ-NAGYKUN-SZOLNOK,Nagykörû,002,687,265,0,265,0,1,264
JÁSZ-NAGYKUN-SZOLNOK,Nagyrév,001,543,199,0,199,0,1,198
JÁSZ-NAGYKUN-SZOLNOK,Öcsöd,001,624,181,0,181,0,0,181
JÁSZ-NAGYKUN-SZOLNOK,Öcsöd,002,617,161,0,161,0,1,160
JÁSZ-NAGYKUN-SZOLNOK,Öcsöd,003,694,182,0,182,0,5,177
JÁSZ-NAGYKUN-SZOLNOK,Öcsöd,004,636,176,0,173,-3,3,170
JÁSZ-NAGYKUN-SZOLNOK,Örményes,001,394,124,0,124,0,0,124
JÁSZ-NAGYKUN-SZOLNOK,Örményes,002,429,176,0,176,0,0,176
JÁSZ-NAGYKUN-SZOLNOK,Pusztamonostor,001,1299,453,0,453,0,2,451
JÁSZ-NAGYKUN-SZOLNOK,Rákóczifalva,001,915,349,0,349,0,0,349
JÁSZ-NAGYKUN-SZOLNOK,Rákóczifalva,002,941,339,0,339,0,6,333
JÁSZ-NAGYKUN-SZOLNOK,Rákóczifalva,003,864,351,0,351,0,3,348
JÁSZ-NAGYKUN-SZOLNOK,Rákóczifalva,004,837,387,0,387,0,1,386
JÁSZ-NAGYKUN-SZOLNOK,Rákóczifalva,005,889,284,0,284,0,1,283
JÁSZ-NAGYKUN-SZOLNOK,Rákócziújfalu,001,849,254,0,254,0,2,252
JÁSZ-NAGYKUN-SZOLNOK,Rákócziújfalu,002,777,268,0,268,0,1,267
JÁSZ-NAGYKUN-SZOLNOK,Szajol,001,817,302,0,302,0,2,300
JÁSZ-NAGYKUN-SZOLNOK,Szajol,002,596,207,0,207,0,2,205
JÁSZ-NAGYKUN-SZOLNOK,Szajol,003,721,248,0,248,0,1,247
JÁSZ-NAGYKUN-SZOLNOK,Szajol,004,1013,415,0,415,0,2,413
JÁSZ-NAGYKUN-SZOLNOK,Szászberek,001,815,347,0,347,0,1,346
JÁSZ-NAGYKUN-SZOLNOK,Szelevény,001,638,251,0,251,0,1,250
JÁSZ-NAGYKUN-SZOLNOK,Szelevény,002,184,62,0,62,0,0,62
JÁSZ-NAGYKUN-SZOLNOK,Szolnok,001,832,442,0,442,0,1,441
JÁSZ-NAGYKUN-SZOLNOK,Szolnok,002,867,474,0,474,0,3,471
JÁSZ-NAGYKUN-SZOLNOK,Szolnok,003,1061,514,0,514,0,0,514
JÁSZ-NAGYKUN-SZOLNOK,Szolnok,004,852,424,0,424,0,3,421
JÁSZ-NAGYKUN-SZOLNOK,Szolnok,005,858,444,0,444,0,0,444
JÁSZ-NAGYKUN-SZOLNOK,Szolnok,006,952,441,0,441,0,2,439
JÁSZ-NAGYKUN-SZOLNOK,Szolnok,007,842,415,0,415,0,1,414
JÁSZ-NAGYKUN-SZOLNOK,Szolnok,008,728,315,0,315,0,1,314
JÁSZ-NAGYKUN-SZOLNOK,Szolnok,009,762,324,0,324,0,2,322
JÁSZ-NAGYKUN-SZOLNOK,Szolnok,010,728,350,1,349,-1,1,348
JÁSZ-NAGYKUN-SZOLNOK,Szolnok,011,635,318,0,318,0,1,317
JÁSZ-NAGYKUN-SZOLNOK,Szolnok,012,863,473,0,473,0,1,472
JÁSZ-NAGYKUN-SZOLNOK,Szolnok,013,756,325,0,325,0,1,324
JÁSZ-NAGYKUN-SZOLNOK,Szolnok,014,730,318,0,318,0,0,318
JÁSZ-NAGYKUN-SZOLNOK,Szolnok,015,969,364,0,364,0,1,363
JÁSZ-NAGYKUN-SZOLNOK,Szolnok,016,932,443,0,443,0,1,442
JÁSZ-NAGYKUN-SZOLNOK,Szolnok,017,753,332,0,332,0,1,331
JÁSZ-NAGYKUN-SZOLNOK,Szolnok,018,593,304,0,304,0,2,302
JÁSZ-NAGYKUN-SZOLNOK,Szolnok,019,847,418,0,418,0,0,418
JÁSZ-NAGYKUN-SZOLNOK,Szolnok,020,1385,806,0,806,0,3,803
JÁSZ-NAGYKUN-SZOLNOK,Szolnok,021,792,329,0,329,0,2,327
JÁSZ-NAGYKUN-SZOLNOK,Szolnok,022,651,256,0,256,0,0,256
JÁSZ-NAGYKUN-SZOLNOK,Szolnok,023,622,326,0,326,0,2,324
JÁSZ-NAGYKUN-SZOLNOK,Szolnok,024,833,384,0,384,0,2,382
JÁSZ-NAGYKUN-SZOLNOK,Szolnok,025,484,256,1,256,0,1,255
JÁSZ-NAGYKUN-SZOLNOK,Szolnok,026,739,350,0,350,0,3,347
JÁSZ-NAGYKUN-SZOLNOK,Szolnok,027,673,312,0,312,0,0,312
JÁSZ-NAGYKUN-SZOLNOK,Szolnok,028,787,355,0,355,0,2,353
JÁSZ-NAGYKUN-SZOLNOK,Szolnok,029,656,285,0,285,0,1,284
JÁSZ-NAGYKUN-SZOLNOK,Szolnok,030,971,338,0,338,0,3,335
JÁSZ-NAGYKUN-SZOLNOK,Szolnok,031,683,319,0,319,0,0,319
JÁSZ-NAGYKUN-SZOLNOK,Szolnok,032,607,193,1,192,-1,1,191
JÁSZ-NAGYKUN-SZOLNOK,Szolnok,033,849,357,0,357,0,3,354
JÁSZ-NAGYKUN-SZOLNOK,Szolnok,034,749,272,0,272,0,1,271
JÁSZ-NAGYKUN-SZOLNOK,Szolnok,035,761,287,0,287,0,1,286
JÁSZ-NAGYKUN-SZOLNOK,Szolnok,036,812,293,0,293,0,0,293
JÁSZ-NAGYKUN-SZOLNOK,Szolnok,037,774,328,0,328,0,0,328
JÁSZ-NAGYKUN-SZOLNOK,Szolnok,038,741,276,0,276,0,2,274
JÁSZ-NAGYKUN-SZOLNOK,Szolnok,039,739,314,0,314,0,1,313
JÁSZ-NAGYKUN-SZOLNOK,Szolnok,040,851,321,0,321,0,0,321
JÁSZ-NAGYKUN-SZOLNOK,Szolnok,041,857,317,0,317,0,3,314
JÁSZ-NAGYKUN-SZOLNOK,Szolnok,042,728,232,0,232,0,0,232
JÁSZ-NAGYKUN-SZOLNOK,Szolnok,043,838,296,0,296,0,1,295
JÁSZ-NAGYKUN-SZOLNOK,Szolnok,044,1150,589,0,589,0,0,589
JÁSZ-NAGYKUN-SZOLNOK,Szolnok,045,768,356,0,356,0,1,355
JÁSZ-NAGYKUN-SZOLNOK,Szolnok,046,789,319,0,319,0,0,319
JÁSZ-NAGYKUN-SZOLNOK,Szolnok,047,827,330,0,330,0,1,329
JÁSZ-NAGYKUN-SZOLNOK,Szolnok,048,747,188,0,188,0,1,187
JÁSZ-NAGYKUN-SZOLNOK,Szolnok,049,710,168,0,168,0,0,168
JÁSZ-NAGYKUN-SZOLNOK,Szolnok,050,844,325,0,325,0,1,324
JÁSZ-NAGYKUN-SZOLNOK,Szolnok,051,1193,388,0,388,0,0,388
JÁSZ-NAGYKUN-SZOLNOK,Szolnok,052,699,216,0,216,0,0,216
JÁSZ-NAGYKUN-SZOLNOK,Szolnok,053,792,292,0,292,0,2,290
JÁSZ-NAGYKUN-SZOLNOK,Szolnok,054,1000,420,0,420,0,3,417
JÁSZ-NAGYKUN-SZOLNOK,Szolnok,055,832,380,0,380,0,1,379
JÁSZ-NAGYKUN-SZOLNOK,Szolnok,056,1002,491,0,491,0,7,484
JÁSZ-NAGYKUN-SZOLNOK,Szolnok,057,869,297,0,297,0,0,297
JÁSZ-NAGYKUN-SZOLNOK,Szolnok,058,805,350,0,350,0,0,350
JÁSZ-NAGYKUN-SZOLNOK,Szolnok,059,902,455,0,455,0,2,453
JÁSZ-NAGYKUN-SZOLNOK,Szolnok,060,947,498,0,498,0,0,498
JÁSZ-NAGYKUN-SZOLNOK,Szolnok,061,897,454,0,453,-1,1,452
JÁSZ-NAGYKUN-SZOLNOK,Szolnok,062,888,382,0,382,0,3,379
JÁSZ-NAGYKUN-SZOLNOK,Szolnok,063,763,341,0,341,0,2,339
JÁSZ-NAGYKUN-SZOLNOK,Szolnok,064,900,450,1,449,-1,3,446
JÁSZ-NAGYKUN-SZOLNOK,Szolnok,065,791,380,0,380,0,2,378
JÁSZ-NAGYKUN-SZOLNOK,Szolnok,066,835,357,0,357,0,1,356
JÁSZ-NAGYKUN-SZOLNOK,Szolnok,067,882,416,0,416,0,1,415
JÁSZ-NAGYKUN-SZOLNOK,Szolnok,068,822,362,0,362,0,1,361
JÁSZ-NAGYKUN-SZOLNOK,Szolnok,069,737,332,1,332,0,1,331
JÁSZ-NAGYKUN-SZOLNOK,Szolnok,070,757,343,1,342,-1,0,342
JÁSZ-NAGYKUN-SZOLNOK,Tiszabõ,001,598,260,0,260,0,1,259
JÁSZ-NAGYKUN-SZOLNOK,Tiszabõ,002,660,344,0,344,0,4,340
JÁSZ-NAGYKUN-SZOLNOK,Tiszabura,001,831,314,0,314,0,4,310
JÁSZ-NAGYKUN-SZOLNOK,Tiszabura,002,885,344,0,344,0,3,341
JÁSZ-NAGYKUN-SZOLNOK,Tiszabura,003,194,51,0,51,0,1,50
JÁSZ-NAGYKUN-SZOLNOK,Tiszaderzs,001,891,355,0,355,0,2,353
JÁSZ-NAGYKUN-SZOLNOK,Tiszaföldvár,001,1084,329,0,329,0,2,327
JÁSZ-NAGYKUN-SZOLNOK,Tiszaföldvár,002,1096,262,0,262,0,0,262
JÁSZ-NAGYKUN-SZOLNOK,Tiszaföldvár,003,1117,415,0,415,0,1,414
JÁSZ-NAGYKUN-SZOLNOK,Tiszaföldvár,004,1094,367,0,367,0,0,367
JÁSZ-NAGYKUN-SZOLNOK,Tiszaföldvár,005,1152,311,0,311,0,3,308
JÁSZ-NAGYKUN-SZOLNOK,Tiszaföldvár,006,1074,313,0,312,-1,3,309
JÁSZ-NAGYKUN-SZOLNOK,Tiszaföldvár,007,1038,354,0,354,0,3,351
JÁSZ-NAGYKUN-SZOLNOK,Tiszaföldvár,008,1051,269,0,269,0,3,266
JÁSZ-NAGYKUN-SZOLNOK,Tiszafüred,001,966,394,0,394,0,1,393
JÁSZ-NAGYKUN-SZOLNOK,Tiszafüred,002,1190,469,0,469,0,0,469
JÁSZ-NAGYKUN-SZOLNOK,Tiszafüred,003,1234,435,0,435,0,5,430
JÁSZ-NAGYKUN-SZOLNOK,Tiszafüred,004,1162,331,0,331,0,2,329
JÁSZ-NAGYKUN-SZOLNOK,Tiszafüred,005,1142,404,0,404,0,0,404
JÁSZ-NAGYKUN-SZOLNOK,Tiszafüred,006,1206,581,0,580,-1,4,576
JÁSZ-NAGYKUN-SZOLNOK,Tiszafüred,007,1046,417,0,414,-3,1,413
JÁSZ-NAGYKUN-SZOLNOK,Tiszafüred,008,1113,344,0,344,0,1,343
JÁSZ-NAGYKUN-SZOLNOK,Tiszafüred,009,141,50,0,50,0,0,50
JÁSZ-NAGYKUN-SZOLNOK,Tiszagyenda,001,835,228,0,228,0,0,228
JÁSZ-NAGYKUN-SZOLNOK,Tiszaigar,001,608,189,0,189,0,7,182
JÁSZ-NAGYKUN-SZOLNOK,Tiszainoka,001,310,119,0,119,0,3,116
JÁSZ-NAGYKUN-SZOLNOK,Tiszajenõ,001,841,306,0,306,0,2,304
JÁSZ-NAGYKUN-SZOLNOK,Tiszajenõ,002,412,148,0,148,0,1,147
JÁSZ-NAGYKUN-SZOLNOK,Tiszakürt,001,953,291,0,291,0,3,288
JÁSZ-NAGYKUN-SZOLNOK,Tiszakürt,002,152,64,0,64,0,2,62
JÁSZ-NAGYKUN-SZOLNOK,Tiszaörs,001,1049,372,0,372,0,2,370
JÁSZ-NAGYKUN-SZOLNOK,Tiszapüspöki,001,758,234,0,234,0,2,232
JÁSZ-NAGYKUN-SZOLNOK,Tiszapüspöki,002,821,260,0,260,0,1,259
JÁSZ-NAGYKUN-SZOLNOK,Tiszaroff,001,629,197,1,196,-1,5,191
JÁSZ-NAGYKUN-SZOLNOK,Tiszaroff,002,711,217,0,217,0,1,216
JÁSZ-NAGYKUN-SZOLNOK,Tiszasas,001,870,282,0,282,0,4,278
JÁSZ-NAGYKUN-SZOLNOK,Tiszasüly,001,637,223,0,223,0,0,223
JÁSZ-NAGYKUN-SZOLNOK,Tiszasüly,002,588,166,0,166,0,3,163
JÁSZ-NAGYKUN-SZOLNOK,Tiszaszentimre,001,759,248,0,248,0,3,245
JÁSZ-NAGYKUN-SZOLNOK,Tiszaszentimre,002,659,211,0,211,0,3,208
JÁSZ-NAGYKUN-SZOLNOK,Tiszaszentimre,003,222,62,0,62,0,0,62
JÁSZ-NAGYKUN-SZOLNOK,Tiszatenyõ,001,688,196,0,196,0,2,194
JÁSZ-NAGYKUN-SZOLNOK,Tiszatenyõ,002,651,172,0,172,0,1,171
JÁSZ-NAGYKUN-SZOLNOK,Tiszavárkony,001,1040,361,0,361,0,2,359
JÁSZ-NAGYKUN-SZOLNOK,Tiszavárkony,002,207,71,0,71,0,0,71
JÁSZ-NAGYKUN-SZOLNOK,Tomajmonostora,001,561,259,0,259,0,4,255
JÁSZ-NAGYKUN-SZOLNOK,Tószeg,001,958,306,0,306,0,0,306
JÁSZ-NAGYKUN-SZOLNOK,Tószeg,002,1077,413,1,412,-1,3,409
JÁSZ-NAGYKUN-SZOLNOK,Tószeg,003,837,308,0,308,0,1,307
JÁSZ-NAGYKUN-SZOLNOK,Tószeg,004,855,313,0,313,0,1,312
JÁSZ-NAGYKUN-SZOLNOK,Törökszentmiklós,001,1055,399,0,399,0,3,396
JÁSZ-NAGYKUN-SZOLNOK,Törökszentmiklós,002,987,449,1,448,-1,0,448
JÁSZ-NAGYKUN-SZOLNOK,Törökszentmiklós,003,1123,495,0,495,0,2,493
JÁSZ-NAGYKUN-SZOLNOK,Törökszentmiklós,004,1017,331,0,331,0,1,330
JÁSZ-NAGYKUN-SZOLNOK,Törökszentmiklós,005,1143,374,0,373,-1,1,372
JÁSZ-NAGYKUN-SZOLNOK,Törökszentmiklós,006,1153,400,0,400,0,1,399
JÁSZ-NAGYKUN-SZOLNOK,Törökszentmiklós,007,774,380,0,380,0,2,378
JÁSZ-NAGYKUN-SZOLNOK,Törökszentmiklós,008,718,339,0,339,0,1,338
JÁSZ-NAGYKUN-SZOLNOK,Törökszentmiklós,009,670,310,0,310,0,0,310
JÁSZ-NAGYKUN-SZOLNOK,Törökszentmiklós,010,818,338,0,338,0,0,338
JÁSZ-NAGYKUN-SZOLNOK,Törökszentmiklós,011,990,420,0,420,0,1,419
JÁSZ-NAGYKUN-SZOLNOK,Törökszentmiklós,012,690,248,0,248,0,0,248
JÁSZ-NAGYKUN-SZOLNOK,Törökszentmiklós,013,548,167,0,167,0,4,163
JÁSZ-NAGYKUN-SZOLNOK,Törökszentmiklós,014,781,189,0,189,0,1,188
JÁSZ-NAGYKUN-SZOLNOK,Törökszentmiklós,015,1034,315,0,315,0,3,312
JÁSZ-NAGYKUN-SZOLNOK,Törökszentmiklós,016,1078,365,0,365,0,2,363
JÁSZ-NAGYKUN-SZOLNOK,Törökszentmiklós,017,1028,462,0,462,0,2,460
JÁSZ-NAGYKUN-SZOLNOK,Törökszentmiklós,018,1094,362,0,362,0,0,362
JÁSZ-NAGYKUN-SZOLNOK,Túrkeve,001,711,160,0,160,0,1,159
JÁSZ-NAGYKUN-SZOLNOK,Túrkeve,002,769,215,0,215,0,0,215
JÁSZ-NAGYKUN-SZOLNOK,Túrkeve,003,653,192,0,192,0,0,192
JÁSZ-NAGYKUN-SZOLNOK,Túrkeve,004,687,207,0,207,0,2,205
JÁSZ-NAGYKUN-SZOLNOK,Túrkeve,005,665,239,0,239,0,1,238
JÁSZ-NAGYKUN-SZOLNOK,Túrkeve,006,681,261,0,261,0,2,259
JÁSZ-NAGYKUN-SZOLNOK,Túrkeve,007,695,200,0,200,0,2,198
JÁSZ-NAGYKUN-SZOLNOK,Túrkeve,008,738,177,0,177,0,2,175
JÁSZ-NAGYKUN-SZOLNOK,Túrkeve,009,732,233,0,233,0,2,231
JÁSZ-NAGYKUN-SZOLNOK,Túrkeve,010,747,177,0,177,0,3,174
JÁSZ-NAGYKUN-SZOLNOK,Újszász,001,913,298,0,298,0,1,297
JÁSZ-NAGYKUN-SZOLNOK,Újszász,002,844,283,0,283,0,6,277
JÁSZ-NAGYKUN-SZOLNOK,Újszász,003,721,298,0,298,0,0,298
JÁSZ-NAGYKUN-SZOLNOK,Újszász,004,772,331,0,331,0,4,327
JÁSZ-NAGYKUN-SZOLNOK,Újszász,005,815,291,0,291,0,1,290
JÁSZ-NAGYKUN-SZOLNOK,Újszász,006,856,267,0,267,0,1,266
JÁSZ-NAGYKUN-SZOLNOK,Vezseny,001,513,173,0,173,0,3,170
JÁSZ-NAGYKUN-SZOLNOK,Zagyvarékas,001,597,154,0,154,0,2,152
JÁSZ-NAGYKUN-SZOLNOK,Zagyvarékas,002,608,149,0,149,0,0,149
JÁSZ-NAGYKUN-SZOLNOK,Zagyvarékas,003,594,198,0,198,0,1,197
JÁSZ-NAGYKUN-SZOLNOK,Zagyvarékas,004,575,214,0,214,0,2,212
JÁSZ-NAGYKUN-SZOLNOK,Zagyvarékas,005,436,153,0,153,0,0,153
JÁSZ-NAGYKUN-SZOLNOK,Tiszaszõlõs,001,712,259,0,259,0,2,257
JÁSZ-NAGYKUN-SZOLNOK,Tiszaszõlõs,002,508,170,0,170,0,0,170
KOMÁROM-ESZTERGOM,Aka,001,205,101,0,101,0,0,101
KOMÁROM-ESZTERGOM,Almásfüzitõ,001,588,325,0,325,0,2,323
KOMÁROM-ESZTERGOM,Almásfüzitõ,002,598,301,0,301,0,2,299
KOMÁROM-ESZTERGOM,Almásfüzitõ,003,603,250,1,249,-1,3,246
KOMÁROM-ESZTERGOM,Annavölgy,001,744,249,0,249,0,3,246
KOMÁROM-ESZTERGOM,Ács,001,786,228,0,228,0,1,227
KOMÁROM-ESZTERGOM,Ács,002,743,290,0,290,0,4,286
KOMÁROM-ESZTERGOM,Ács,003,746,261,0,261,0,0,261
KOMÁROM-ESZTERGOM,Ács,004,648,157,0,157,0,1,156
KOMÁROM-ESZTERGOM,Ács,005,654,189,0,189,0,0,189
KOMÁROM-ESZTERGOM,Ács,006,668,243,0,243,0,1,242
KOMÁROM-ESZTERGOM,Ács,007,749,249,0,249,0,0,249
KOMÁROM-ESZTERGOM,Ács,008,697,216,0,216,0,4,212
KOMÁROM-ESZTERGOM,Ácsteszér,001,532,216,0,216,0,3,213
KOMÁROM-ESZTERGOM,Baj,001,763,330,0,329,-1,1,328
KOMÁROM-ESZTERGOM,Baj,002,681,324,0,324,0,3,321
KOMÁROM-ESZTERGOM,Baj,003,876,413,0,413,0,4,409
KOMÁROM-ESZTERGOM,Bajna,001,810,348,0,348,0,2,346
KOMÁROM-ESZTERGOM,Bajna,002,763,314,0,314,0,2,312
KOMÁROM-ESZTERGOM,Bajót,001,1267,469,0,469,0,2,467
KOMÁROM-ESZTERGOM,Bakonybánk,001,339,131,0,131,0,2,129
KOMÁROM-ESZTERGOM,Bakonysárkány,001,759,296,0,296,0,0,296
KOMÁROM-ESZTERGOM,Bakonyszombathely,001,553,171,0,171,0,0,171
KOMÁROM-ESZTERGOM,Bakonyszombathely,002,576,212,0,212,0,1,211
KOMÁROM-ESZTERGOM,Bana,001,689,241,0,241,0,1,240
KOMÁROM-ESZTERGOM,Bana,002,632,211,0,209,-2,1,208
KOMÁROM-ESZTERGOM,Bábolna,001,791,334,0,334,0,1,333
KOMÁROM-ESZTERGOM,Bábolna,002,627,237,0,237,0,0,237
KOMÁROM-ESZTERGOM,Bábolna,003,734,253,0,253,0,1,252
KOMÁROM-ESZTERGOM,Bábolna,004,751,355,0,355,0,1,354
KOMÁROM-ESZTERGOM,Bársonyos,001,635,225,0,225,0,0,225
KOMÁROM-ESZTERGOM,Bokod,001,874,377,0,377,0,0,377
KOMÁROM-ESZTERGOM,Bokod,002,866,312,0,312,0,1,311
KOMÁROM-ESZTERGOM,Csatka,001,197,95,0,95,0,0,95
KOMÁROM-ESZTERGOM,Császár,001,664,281,0,281,0,0,281
KOMÁROM-ESZTERGOM,Császár,002,861,302,0,302,0,1,301
KOMÁROM-ESZTERGOM,Csém,001,349,136,0,136,0,1,135
KOMÁROM-ESZTERGOM,Csép,001,292,96,0,96,0,0,96
KOMÁROM-ESZTERGOM,Csolnok,001,997,417,0,417,0,1,416
KOMÁROM-ESZTERGOM,Csolnok,002,772,286,0,286,0,1,285
KOMÁROM-ESZTERGOM,Csolnok,003,870,334,0,334,0,2,332
KOMÁROM-ESZTERGOM,Dad,001,823,372,0,372,0,0,372
KOMÁROM-ESZTERGOM,Dág,001,750,351,0,351,0,3,348
KOMÁROM-ESZTERGOM,Dorog,001,1046,412,0,412,0,1,411
KOMÁROM-ESZTERGOM,Dorog,002,1176,488,0,488,0,1,487
KOMÁROM-ESZTERGOM,Dorog,003,1053,497,0,497,0,11,486
KOMÁROM-ESZTERGOM,Dorog,004,671,222,0,222,0,0,222
KOMÁROM-ESZTERGOM,Dorog,005,741,289,1,288,-1,1,287
KOMÁROM-ESZTERGOM,Dorog,006,605,207,0,207,0,0,207
KOMÁROM-ESZTERGOM,Dorog,007,745,260,0,260,0,0,260
KOMÁROM-ESZTERGOM,Dorog,008,1389,452,0,452,0,0,452
KOMÁROM-ESZTERGOM,Dorog,009,1043,362,0,362,0,0,362
KOMÁROM-ESZTERGOM,Dorog,010,1255,447,0,447,0,0,447
KOMÁROM-ESZTERGOM,Dömös,001,973,405,0,405,0,0,405
KOMÁROM-ESZTERGOM,Dunaalmás,001,806,370,0,370,0,1,369
KOMÁROM-ESZTERGOM,Dunaalmás,002,461,225,0,225,0,0,225
KOMÁROM-ESZTERGOM,Dunaszentmiklós,001,372,180,0,180,0,1,179
KOMÁROM-ESZTERGOM,Epöl,001,502,285,0,285,0,1,284
KOMÁROM-ESZTERGOM,Esztergom,001,800,396,0,396,0,2,394
KOMÁROM-ESZTERGOM,Esztergom,002,813,450,0,450,0,1,449
KOMÁROM-ESZTERGOM,Esztergom,003,742,366,0,366,0,2,364
KOMÁROM-ESZTERGOM,Esztergom,004,1226,505,0,505,0,4,501
KOMÁROM-ESZTERGOM,Esztergom,005,985,575,0,575,0,2,573
KOMÁROM-ESZTERGOM,Esztergom,006,948,428,0,428,0,0,428
KOMÁROM-ESZTERGOM,Esztergom,007,948,514,0,513,-1,3,510
KOMÁROM-ESZTERGOM,Esztergom,008,661,336,0,336,0,0,336
KOMÁROM-ESZTERGOM,Esztergom,009,583,338,0,338,0,2,336
KOMÁROM-ESZTERGOM,Esztergom,010,706,372,0,372,0,1,371
KOMÁROM-ESZTERGOM,Esztergom,011,710,391,0,391,0,1,390
KOMÁROM-ESZTERGOM,Esztergom,012,1187,520,1,519,-1,5,514
KOMÁROM-ESZTERGOM,Esztergom,013,726,333,0,332,-1,0,332
KOMÁROM-ESZTERGOM,Esztergom,014,875,354,0,354,0,4,350
KOMÁROM-ESZTERGOM,Esztergom,015,927,438,0,438,0,1,437
KOMÁROM-ESZTERGOM,Esztergom,016,637,320,0,319,-1,0,319
KOMÁROM-ESZTERGOM,Esztergom,017,1224,464,0,464,0,3,461
KOMÁROM-ESZTERGOM,Esztergom,018,1176,603,0,603,0,2,601
KOMÁROM-ESZTERGOM,Esztergom,019,790,429,0,429,0,3,426
KOMÁROM-ESZTERGOM,Esztergom,020,955,475,0,475,0,0,475
KOMÁROM-ESZTERGOM,Esztergom,021,245,98,0,98,0,0,98
KOMÁROM-ESZTERGOM,Esztergom,022,755,194,0,194,0,0,194
KOMÁROM-ESZTERGOM,Esztergom,023,985,374,0,374,0,3,371
KOMÁROM-ESZTERGOM,Esztergom,024,774,339,0,339,0,1,338
KOMÁROM-ESZTERGOM,Esztergom,025,831,301,0,301,0,2,299
KOMÁROM-ESZTERGOM,Esztergom,026,887,273,0,273,0,4,269
KOMÁROM-ESZTERGOM,Esztergom,027,785,175,0,175,0,0,175
KOMÁROM-ESZTERGOM,Ete,001,479,238,0,238,0,1,237
KOMÁROM-ESZTERGOM,Gyermely,001,1176,551,0,551,0,3,548
KOMÁROM-ESZTERGOM,Héreg,001,841,315,0,315,0,2,313
KOMÁROM-ESZTERGOM,Kecskéd,001,885,327,0,327,0,2,325
KOMÁROM-ESZTERGOM,Kecskéd,002,777,350,0,350,0,1,349
KOMÁROM-ESZTERGOM,Kerékteleki,001,548,169,0,169,0,0,169
KOMÁROM-ESZTERGOM,Kesztölc,001,686,293,0,293,0,0,293
KOMÁROM-ESZTERGOM,Kesztölc,002,765,319,0,319,0,4,315
KOMÁROM-ESZTERGOM,Kesztölc,003,736,250,0,250,0,2,248
KOMÁROM-ESZTERGOM,Kisbér,001,872,385,0,385,0,3,382
KOMÁROM-ESZTERGOM,Kisbér,002,873,400,0,400,0,5,395
KOMÁROM-ESZTERGOM,Kisbér,003,774,324,0,325,1,10,315
KOMÁROM-ESZTERGOM,Kisbér,004,776,317,0,317,0,3,314
KOMÁROM-ESZTERGOM,Kisbér,005,818,318,3,315,-3,1,314
KOMÁROM-ESZTERGOM,Kisbér,006,365,137,0,137,0,0,137
KOMÁROM-ESZTERGOM,Kisigmánd,001,437,143,0,143,0,0,143
KOMÁROM-ESZTERGOM,Kocs,001,1068,457,0,457,0,2,455
KOMÁROM-ESZTERGOM,Kocs,002,1025,408,0,408,0,5,403
KOMÁROM-ESZTERGOM,Komárom,001,435,196,0,196,0,1,195
KOMÁROM-ESZTERGOM,Komárom,002,974,422,0,422,0,0,422
KOMÁROM-ESZTERGOM,Komárom,003,614,304,0,304,0,0,304
KOMÁROM-ESZTERGOM,Komárom,004,889,384,0,384,0,1,383
KOMÁROM-ESZTERGOM,Komárom,005,1009,436,0,436,0,1,435
KOMÁROM-ESZTERGOM,Komárom,006,880,374,0,374,0,2,372
KOMÁROM-ESZTERGOM,Komárom,007,967,469,0,469,0,0,469
KOMÁROM-ESZTERGOM,Komárom,008,1108,615,0,615,0,0,615
KOMÁROM-ESZTERGOM,Komárom,009,906,482,0,482,0,1,481
KOMÁROM-ESZTERGOM,Komárom,010,1425,681,0,681,0,5,676
KOMÁROM-ESZTERGOM,Komárom,011,577,216,0,216,0,1,215
KOMÁROM-ESZTERGOM,Komárom,012,867,433,0,433,0,2,431
KOMÁROM-ESZTERGOM,Komárom,013,733,316,0,316,0,6,310
KOMÁROM-ESZTERGOM,Komárom,014,773,292,0,292,0,2,290
KOMÁROM-ESZTERGOM,Komárom,015,1097,386,0,386,0,8,378
KOMÁROM-ESZTERGOM,Komárom,016,1194,541,0,541,0,2,539
KOMÁROM-ESZTERGOM,Komárom,017,820,384,0,384,0,7,377
KOMÁROM-ESZTERGOM,Kömlõd,001,857,313,0,313,0,5,308
KOMÁROM-ESZTERGOM,Környe,001,950,481,1,480,-1,2,478
KOMÁROM-ESZTERGOM,Környe,002,889,428,0,428,0,0,428
KOMÁROM-ESZTERGOM,Környe,003,925,314,0,314,0,2,312
KOMÁROM-ESZTERGOM,Környe,004,999,308,0,308,0,0,308
KOMÁROM-ESZTERGOM,Lábatlan,001,694,227,0,227,0,2,225
KOMÁROM-ESZTERGOM,Lábatlan,002,800,274,0,274,0,3,271
KOMÁROM-ESZTERGOM,Lábatlan,003,743,216,0,216,0,1,215
KOMÁROM-ESZTERGOM,Lábatlan,004,961,381,0,381,0,2,379
KOMÁROM-ESZTERGOM,Lábatlan,005,835,363,0,363,0,1,362
KOMÁROM-ESZTERGOM,Leányvár,001,1425,591,0,591,0,4,587
KOMÁROM-ESZTERGOM,Máriahalom,001,545,182,0,182,0,3,179
KOMÁROM-ESZTERGOM,Mocsa,001,855,358,0,358,0,3,355
KOMÁROM-ESZTERGOM,Mocsa,002,888,361,0,361,0,2,359
KOMÁROM-ESZTERGOM,Mogyorósbánya,001,704,288,0,288,0,2,286
KOMÁROM-ESZTERGOM,Nagyigmánd,001,697,300,0,300,0,4,296
KOMÁROM-ESZTERGOM,Nagyigmánd,002,669,275,0,275,0,3,272
KOMÁROM-ESZTERGOM,Nagyigmánd,003,830,328,0,328,0,2,326
KOMÁROM-ESZTERGOM,Nagyigmánd,004,130,33,0,33,0,1,32
KOMÁROM-ESZTERGOM,Nagysáp,001,1150,361,0,361,0,0,361
KOMÁROM-ESZTERGOM,Naszály,001,1073,409,0,409,0,4,405
KOMÁROM-ESZTERGOM,Naszály,002,842,315,0,315,0,4,311
KOMÁROM-ESZTERGOM,Neszmély,001,578,264,0,264,0,0,264
KOMÁROM-ESZTERGOM,Neszmély,002,520,218,0,218,0,1,217
KOMÁROM-ESZTERGOM,Nyergesújfalu,001,787,241,0,241,0,1,240
KOMÁROM-ESZTERGOM,Nyergesújfalu,002,1187,529,1,528,-1,1,527
KOMÁROM-ESZTERGOM,Nyergesújfalu,003,972,476,0,476,0,2,474
KOMÁROM-ESZTERGOM,Nyergesújfalu,004,826,416,0,416,0,0,416
KOMÁROM-ESZTERGOM,Nyergesújfalu,005,737,299,0,299,0,0,299
KOMÁROM-ESZTERGOM,Nyergesújfalu,006,778,283,0,283,0,3,280
KOMÁROM-ESZTERGOM,Nyergesújfalu,007,706,289,0,289,0,3,286
KOMÁROM-ESZTERGOM,Oroszlány,001,919,355,0,355,0,2,353
KOMÁROM-ESZTERGOM,Oroszlány,002,890,385,0,385,0,2,383
KOMÁROM-ESZTERGOM,Oroszlány,003,968,363,0,363,0,3,360
KOMÁROM-ESZTERGOM,Oroszlány,004,1227,464,0,464,0,0,464
KOMÁROM-ESZTERGOM,Oroszlány,005,992,301,0,301,0,3,298
KOMÁROM-ESZTERGOM,Oroszlány,006,763,248,0,248,0,2,246
KOMÁROM-ESZTERGOM,Oroszlány,007,972,280,0,280,0,4,276
KOMÁROM-ESZTERGOM,Oroszlány,008,906,242,0,242,0,2,240
KOMÁROM-ESZTERGOM,Oroszlány,009,817,312,0,312,0,1,311
KOMÁROM-ESZTERGOM,Oroszlány,010,874,316,0,316,0,2,314
KOMÁROM-ESZTERGOM,Oroszlány,011,909,354,0,354,0,5,349
KOMÁROM-ESZTERGOM,Oroszlány,012,830,283,0,283,0,2,281
KOMÁROM-ESZTERGOM,Oroszlány,013,951,343,0,343,0,1,342
KOMÁROM-ESZTERGOM,Oroszlány,014,961,423,0,423,0,0,423
KOMÁROM-ESZTERGOM,Oroszlány,015,943,427,0,427,0,2,425
KOMÁROM-ESZTERGOM,Oroszlány,016,1048,338,0,338,0,0,338
KOMÁROM-ESZTERGOM,Piliscsév,001,1071,415,2,411,-4,1,410
KOMÁROM-ESZTERGOM,Piliscsév,002,978,474,0,474,0,6,468
KOMÁROM-ESZTERGOM,Pilismarót,001,843,383,0,383,0,2,381
KOMÁROM-ESZTERGOM,Pilismarót,002,842,355,0,355,0,1,354
KOMÁROM-ESZTERGOM,Réde,001,1063,369,0,369,0,3,366
KOMÁROM-ESZTERGOM,Sárisáp,001,703,245,0,245,0,0,245
KOMÁROM-ESZTERGOM,Sárisáp,002,779,271,0,271,0,1,270
KOMÁROM-ESZTERGOM,Sárisáp,003,798,266,0,266,0,0,266
KOMÁROM-ESZTERGOM,Súr,001,991,347,0,347,0,3,344
KOMÁROM-ESZTERGOM,Süttõ,001,809,317,0,317,0,1,316
KOMÁROM-ESZTERGOM,Süttõ,002,847,368,0,368,0,3,365
KOMÁROM-ESZTERGOM,Szákszend,001,1195,412,0,412,0,3,409
KOMÁROM-ESZTERGOM,Szárliget,001,967,467,0,467,0,1,466
KOMÁROM-ESZTERGOM,Szárliget,002,978,407,0,407,0,3,404
KOMÁROM-ESZTERGOM,Szomor,001,895,430,0,430,0,4,426
KOMÁROM-ESZTERGOM,Szomód,001,830,347,0,347,0,3,344
KOMÁROM-ESZTERGOM,Szomód,002,921,395,0,395,0,2,393
KOMÁROM-ESZTERGOM,Tardos,001,1367,518,0,518,0,2,516
KOMÁROM-ESZTERGOM,Tarján,001,932,430,0,430,0,1,429
KOMÁROM-ESZTERGOM,Tarján,002,1105,496,0,496,0,4,492
KOMÁROM-ESZTERGOM,Tarján,003,100,28,0,28,0,0,28
KOMÁROM-ESZTERGOM,Tata,001,1100,601,0,599,-2,3,596
KOMÁROM-ESZTERGOM,Tata,002,823,418,0,418,0,0,418
KOMÁROM-ESZTERGOM,Tata,003,772,312,0,312,0,2,310
KOMÁROM-ESZTERGOM,Tata,004,846,355,0,355,0,0,355
KOMÁROM-ESZTERGOM,Tata,005,762,379,0,379,0,0,379
KOMÁROM-ESZTERGOM,Tata,006,778,338,0,338,0,2,336
KOMÁROM-ESZTERGOM,Tata,007,772,358,0,358,0,1,357
KOMÁROM-ESZTERGOM,Tata,008,641,367,0,367,0,0,367
KOMÁROM-ESZTERGOM,Tata,009,680,309,0,309,0,4,305
KOMÁROM-ESZTERGOM,Tata,010,634,301,0,301,0,4,297
KOMÁROM-ESZTERGOM,Tata,011,564,289,0,289,0,1,288
KOMÁROM-ESZTERGOM,Tata,012,1021,483,0,483,0,2,481
KOMÁROM-ESZTERGOM,Tata,013,608,362,0,362,0,1,361
KOMÁROM-ESZTERGOM,Tata,014,756,410,0,410,0,4,406
KOMÁROM-ESZTERGOM,Tata,015,790,470,0,470,0,2,468
KOMÁROM-ESZTERGOM,Tata,016,710,434,1,433,-1,2,431
KOMÁROM-ESZTERGOM,Tata,017,774,398,0,398,0,2,396
KOMÁROM-ESZTERGOM,Tata,018,730,316,0,316,0,1,315
KOMÁROM-ESZTERGOM,Tata,019,736,348,0,348,0,1,347
KOMÁROM-ESZTERGOM,Tata,020,824,477,0,477,0,1,476
KOMÁROM-ESZTERGOM,Tata,021,858,465,0,465,0,1,464
KOMÁROM-ESZTERGOM,Tata,022,1016,399,0,399,0,1,398
KOMÁROM-ESZTERGOM,Tata,023,970,502,0,502,0,4,498
KOMÁROM-ESZTERGOM,Tata,024,496,253,0,253,0,1,252
KOMÁROM-ESZTERGOM,Tatabánya,001,1017,415,0,415,0,1,414
KOMÁROM-ESZTERGOM,Tatabánya,002,1055,456,0,456,0,2,454
KOMÁROM-ESZTERGOM,Tatabánya,003,581,152,0,152,0,2,150
KOMÁROM-ESZTERGOM,Tatabánya,004,548,65,0,65,0,1,64
KOMÁROM-ESZTERGOM,Tatabánya,005,757,118,0,118,0,0,118
KOMÁROM-ESZTERGOM,Tatabánya,006,858,302,0,302,0,2,300
KOMÁROM-ESZTERGOM,Tatabánya,007,884,350,0,350,0,0,350
KOMÁROM-ESZTERGOM,Tatabánya,008,788,296,1,295,-1,2,293
KOMÁROM-ESZTERGOM,Tatabánya,009,869,320,0,320,0,1,319
KOMÁROM-ESZTERGOM,Tatabánya,010,972,465,0,465,0,10,455
KOMÁROM-ESZTERGOM,Tatabánya,011,914,490,0,490,0,1,489
KOMÁROM-ESZTERGOM,Tatabánya,012,1047,452,0,452,0,3,449
KOMÁROM-ESZTERGOM,Tatabánya,013,983,454,1,453,-1,2,451
KOMÁROM-ESZTERGOM,Tatabánya,014,868,317,0,317,0,1,316
KOMÁROM-ESZTERGOM,Tatabánya,015,755,273,0,273,0,2,271
KOMÁROM-ESZTERGOM,Tatabánya,016,668,315,0,315,0,1,314
KOMÁROM-ESZTERGOM,Tatabánya,017,1115,511,0,511,0,9,502
KOMÁROM-ESZTERGOM,Tatabánya,018,1116,579,0,579,0,4,575
KOMÁROM-ESZTERGOM,Tatabánya,019,1067,582,0,582,0,1,581
KOMÁROM-ESZTERGOM,Tatabánya,020,967,438,0,438,0,0,438
KOMÁROM-ESZTERGOM,Tatabánya,021,817,416,0,416,0,1,415
KOMÁROM-ESZTERGOM,Tatabánya,022,923,395,0,395,0,0,395
KOMÁROM-ESZTERGOM,Tatabánya,023,867,370,0,369,-1,4,365
KOMÁROM-ESZTERGOM,Tatabánya,024,860,387,0,387,0,1,386
KOMÁROM-ESZTERGOM,Tatabánya,025,616,308,0,308,0,3,305
KOMÁROM-ESZTERGOM,Tatabánya,026,710,300,0,300,0,1,299
KOMÁROM-ESZTERGOM,Tatabánya,027,855,384,0,384,0,3,381
KOMÁROM-ESZTERGOM,Tatabánya,028,1024,364,0,364,0,3,361
KOMÁROM-ESZTERGOM,Tatabánya,029,859,342,0,342,0,2,340
KOMÁROM-ESZTERGOM,Tatabánya,030,839,332,0,332,0,2,330
KOMÁROM-ESZTERGOM,Tatabánya,031,858,341,0,341,0,5,336
KOMÁROM-ESZTERGOM,Tatabánya,032,824,375,0,375,0,1,374
KOMÁROM-ESZTERGOM,Tatabánya,033,850,382,0,382,0,3,379
KOMÁROM-ESZTERGOM,Tatabánya,034,1011,361,0,361,0,1,360
KOMÁROM-ESZTERGOM,Tatabánya,035,923,365,0,365,0,0,365
KOMÁROM-ESZTERGOM,Tatabánya,036,910,355,0,355,0,0,355
KOMÁROM-ESZTERGOM,Tatabánya,037,1949,646,1,645,-1,1,644
KOMÁROM-ESZTERGOM,Tatabánya,038,958,385,0,385,0,4,381
KOMÁROM-ESZTERGOM,Tatabánya,039,1117,373,0,373,0,2,371
KOMÁROM-ESZTERGOM,Tatabánya,040,872,320,0,320,0,0,320
KOMÁROM-ESZTERGOM,Tatabánya,041,895,335,1,335,0,2,333
KOMÁROM-ESZTERGOM,Tatabánya,042,774,302,0,303,1,9,294
KOMÁROM-ESZTERGOM,Tatabánya,043,821,349,0,349,0,0,349
KOMÁROM-ESZTERGOM,Tatabánya,044,905,426,0,425,-1,2,423
KOMÁROM-ESZTERGOM,Tatabánya,045,844,349,0,348,-1,0,348
KOMÁROM-ESZTERGOM,Tatabánya,046,825,379,0,379,0,0,379
KOMÁROM-ESZTERGOM,Tatabánya,047,971,437,0,437,0,5,432
KOMÁROM-ESZTERGOM,Tatabánya,048,860,383,0,383,0,1,382
KOMÁROM-ESZTERGOM,Tatabánya,049,943,385,1,384,-1,2,382
KOMÁROM-ESZTERGOM,Tatabánya,050,767,333,0,333,0,0,333
KOMÁROM-ESZTERGOM,Tatabánya,051,730,304,0,304,0,0,304
KOMÁROM-ESZTERGOM,Tatabánya,052,770,311,0,311,0,0,311
KOMÁROM-ESZTERGOM,Tatabánya,053,1331,516,0,516,0,1,515
KOMÁROM-ESZTERGOM,Tatabánya,054,966,261,0,261,0,0,261
KOMÁROM-ESZTERGOM,Tatabánya,055,959,263,0,263,0,4,259
KOMÁROM-ESZTERGOM,Tatabánya,056,847,212,0,212,0,2,210
KOMÁROM-ESZTERGOM,Tatabánya,057,943,425,0,425,0,3,422
KOMÁROM-ESZTERGOM,Tatabánya,058,1080,516,0,516,0,0,516
KOMÁROM-ESZTERGOM,Tatabánya,059,1112,529,0,529,0,0,529
KOMÁROM-ESZTERGOM,Tatabánya,060,867,291,0,291,0,1,290
KOMÁROM-ESZTERGOM,Tárkány,001,969,301,0,301,0,1,300
KOMÁROM-ESZTERGOM,Tárkány,002,184,45,0,45,0,2,43
KOMÁROM-ESZTERGOM,Tát,001,557,277,0,277,0,4,273
KOMÁROM-ESZTERGOM,Tát,002,1103,478,0,478,0,1,477
KOMÁROM-ESZTERGOM,Tát,003,753,306,0,306,0,1,305
KOMÁROM-ESZTERGOM,Tát,004,761,299,0,297,-2,1,296
KOMÁROM-ESZTERGOM,Tát,005,768,287,0,287,0,1,286
KOMÁROM-ESZTERGOM,Tát,006,598,280,1,279,-1,1,278
KOMÁROM-ESZTERGOM,Tokod,001,207,65,0,65,0,0,65
KOMÁROM-ESZTERGOM,Tokod,002,687,268,0,268,0,3,265
KOMÁROM-ESZTERGOM,Tokod,003,747,306,0,306,0,2,304
KOMÁROM-ESZTERGOM,Tokod,004,679,248,0,248,0,1,247
KOMÁROM-ESZTERGOM,Tokod,005,1055,417,0,417,0,2,415
KOMÁROM-ESZTERGOM,Tokodaltáró,001,789,240,0,240,0,3,237
KOMÁROM-ESZTERGOM,Tokodaltáró,002,809,275,0,275,0,1,274
KOMÁROM-ESZTERGOM,Tokodaltáró,003,696,254,0,254,0,0,254
KOMÁROM-ESZTERGOM,Úny,001,600,253,0,253,0,1,252
KOMÁROM-ESZTERGOM,Várgesztes,001,493,244,0,244,0,1,243
KOMÁROM-ESZTERGOM,Vérteskethely,001,479,210,0,210,0,3,207
KOMÁROM-ESZTERGOM,Vértessomló,001,1103,505,1,503,-2,4,499
KOMÁROM-ESZTERGOM,Vértesszõlõs,001,854,416,0,416,0,1,415
KOMÁROM-ESZTERGOM,Vértesszõlõs,002,965,292,0,292,0,2,290
KOMÁROM-ESZTERGOM,Vértesszõlõs,003,896,445,0,445,0,0,445
KOMÁROM-ESZTERGOM,Vértestolna,001,449,196,0,196,0,2,194
KOMÁROM-ESZTERGOM,Ászár,001,756,255,0,255,0,4,251
KOMÁROM-ESZTERGOM,Ászár,002,652,240,0,240,0,0,240
NÓGRÁD,Alsópetény,001,480,210,0,210,0,0,210
NÓGRÁD,Alsótold,001,201,109,0,109,0,1,108
NÓGRÁD,Balassagyarmat,001,774,317,0,317,0,0,317
NÓGRÁD,Balassagyarmat,002,1029,479,0,479,0,2,477
NÓGRÁD,Balassagyarmat,003,823,344,0,344,0,0,344
NÓGRÁD,Balassagyarmat,004,648,276,0,276,0,2,274
NÓGRÁD,Balassagyarmat,005,772,370,0,370,0,2,368
NÓGRÁD,Balassagyarmat,006,824,364,0,364,0,1,363
NÓGRÁD,Balassagyarmat,007,765,332,0,332,0,2,330
NÓGRÁD,Balassagyarmat,008,818,277,0,277,0,1,276
NÓGRÁD,Balassagyarmat,009,726,354,0,354,0,1,353
NÓGRÁD,Balassagyarmat,010,874,327,0,327,0,1,326
NÓGRÁD,Balassagyarmat,011,644,297,0,297,0,3,294
NÓGRÁD,Balassagyarmat,012,819,377,0,377,0,0,377
NÓGRÁD,Balassagyarmat,013,727,353,0,353,0,1,352
NÓGRÁD,Balassagyarmat,014,738,347,0,347,0,0,347
NÓGRÁD,Balassagyarmat,015,725,367,0,367,0,1,366
NÓGRÁD,Balassagyarmat,016,756,331,0,331,0,3,328
NÓGRÁD,Bánk,001,612,338,0,338,0,2,336
NÓGRÁD,Bárna,001,796,296,0,296,0,2,294
NÓGRÁD,Bátonyterenye,001,565,192,0,192,0,0,192
NÓGRÁD,Bátonyterenye,002,616,206,0,206,0,0,206
NÓGRÁD,Bátonyterenye,003,772,287,0,287,0,1,286
NÓGRÁD,Bátonyterenye,004,523,168,0,168,0,0,168
NÓGRÁD,Bátonyterenye,005,667,214,0,214,0,1,213
NÓGRÁD,Bátonyterenye,006,595,227,0,227,0,0,227
NÓGRÁD,Bátonyterenye,007,1187,407,0,407,0,2,405
NÓGRÁD,Bátonyterenye,008,613,254,0,253,-1,1,252
NÓGRÁD,Bátonyterenye,009,520,275,0,275,0,1,274
NÓGRÁD,Bátonyterenye,010,689,286,0,286,0,2,284
NÓGRÁD,Bátonyterenye,011,675,271,0,271,0,1,270
NÓGRÁD,Bátonyterenye,012,633,241,0,241,0,0,241
NÓGRÁD,Bátonyterenye,013,559,182,0,182,0,0,182
NÓGRÁD,Bátonyterenye,014,573,172,0,172,0,2,170
NÓGRÁD,Bátonyterenye,015,768,270,0,270,0,0,270
NÓGRÁD,Becske,001,445,161,0,161,0,0,161
NÓGRÁD,Bercel,001,623,288,0,288,0,1,287
NÓGRÁD,Bercel,002,764,349,0,349,0,2,347
NÓGRÁD,Berkenye,001,531,263,0,263,0,1,262
NÓGRÁD,Bér,001,300,129,0,129,0,1,128
NÓGRÁD,Bokor,001,92,56,0,56,0,0,56
NÓGRÁD,Borsosberény,001,763,254,0,254,0,0,254
NÓGRÁD,Buják,001,850,290,0,290,0,0,290
NÓGRÁD,Buják,002,810,276,0,276,0,2,274
NÓGRÁD,Cered,001,885,279,0,279,0,0,279
NÓGRÁD,Cserháthaláp,001,293,156,0,156,0,0,156
NÓGRÁD,Cserhátsurány,001,661,245,0,245,0,0,245
NÓGRÁD,Cserhátszentiván,001,96,64,0,64,0,0,64
NÓGRÁD,Csesztve,001,259,109,2,107,-2,2,105
NÓGRÁD,Csécse,001,740,244,0,244,0,2,242
NÓGRÁD,Csitár,001,328,126,0,126,0,0,126
NÓGRÁD,Debercsény,001,73,45,0,45,0,2,43
NÓGRÁD,Dejtár,001,1138,414,0,414,0,5,409
NÓGRÁD,Diósjenõ,001,742,283,0,283,0,2,281
NÓGRÁD,Diósjenõ,002,784,310,0,310,0,0,310
NÓGRÁD,Diósjenõ,003,740,353,0,353,0,4,349
NÓGRÁD,Dorogháza,001,520,245,1,244,-1,1,243
NÓGRÁD,Dorogháza,002,325,135,0,135,0,0,135
NÓGRÁD,Drégelypalánk,001,1131,415,0,415,0,1,414
NÓGRÁD,Ecseg,001,896,283,0,283,0,5,278
NÓGRÁD,Egyházasdengeleg,001,374,152,0,152,0,0,152
NÓGRÁD,Egyházasgerge,001,532,199,0,199,0,1,198
NÓGRÁD,Endrefalva,001,882,164,0,164,0,0,164
NÓGRÁD,Erdõkürt,001,440,231,0,231,0,0,231
NÓGRÁD,Erdõtarcsa,001,428,156,0,156,0,1,155
NÓGRÁD,Etes,001,718,279,0,279,0,0,279
NÓGRÁD,Etes,002,123,25,0,25,0,0,25
NÓGRÁD,Etes,003,243,56,0,56,0,0,56
NÓGRÁD,Érsekvadkert,001,710,296,0,296,0,5,291
NÓGRÁD,Érsekvadkert,002,835,311,0,311,0,1,310
NÓGRÁD,Érsekvadkert,003,632,284,0,284,0,3,281
NÓGRÁD,Érsekvadkert,004,714,288,0,288,0,0,288
NÓGRÁD,Felsõpetény,001,480,262,0,262,0,1,261
NÓGRÁD,Felsõtold,001,107,53,0,53,0,2,51
NÓGRÁD,Galgaguta,001,515,209,0,209,0,1,208
NÓGRÁD,Garáb,001,43,28,0,28,0,0,28
NÓGRÁD,Herencsény,001,468,177,0,177,0,1,176
NÓGRÁD,Héhalom,001,826,291,0,291,0,2,289
NÓGRÁD,Hollókõ,001,298,198,0,198,0,3,195
NÓGRÁD,Hont,001,422,199,0,199,0,0,199
NÓGRÁD,Horpács,001,149,81,0,81,0,0,81
NÓGRÁD,Hugyag,001,632,162,0,162,0,3,159
NÓGRÁD,Iliny,001,132,77,0,77,0,0,77
NÓGRÁD,Ipolytarnóc,001,356,134,0,134,0,1,133
NÓGRÁD,Ipolyvece,001,654,250,0,250,0,2,248
NÓGRÁD,Jobbágyi,001,836,244,0,244,0,0,244
NÓGRÁD,Jobbágyi,002,750,308,0,308,0,5,303
NÓGRÁD,Karancsalja,001,680,228,0,228,0,1,227
NÓGRÁD,Karancsalja,002,578,213,0,213,0,0,213
NÓGRÁD,Karancsberény,001,700,257,0,257,0,2,255
NÓGRÁD,Karancskeszi,001,681,203,0,203,0,3,200
NÓGRÁD,Karancskeszi,002,579,193,0,193,0,1,192
NÓGRÁD,Karancskeszi,003,176,75,0,75,0,0,75
NÓGRÁD,Karancslapujtõ,001,682,231,0,231,0,3,228
NÓGRÁD,Karancslapujtõ,002,721,247,0,247,0,0,247
NÓGRÁD,Karancslapujtõ,003,681,312,0,312,0,0,312
NÓGRÁD,Karancsság,001,936,216,0,216,0,2,214
NÓGRÁD,Kazár,001,574,157,1,157,0,4,153
NÓGRÁD,Kazár,002,614,180,0,180,0,0,180
NÓGRÁD,Kazár,003,244,86,0,86,0,3,83
NÓGRÁD,Kálló,001,1066,358,0,358,0,1,357
NÓGRÁD,Keszeg,001,560,257,0,257,0,1,256
NÓGRÁD,Kétbodony,001,398,189,0,189,0,2,187
NÓGRÁD,Kisbágyon,001,335,128,0,128,0,1,127
NÓGRÁD,Kisbárkány,001,141,94,0,94,0,0,94
NÓGRÁD,Kisecset,001,152,94,0,94,0,4,90
NÓGRÁD,Kishartyán,001,469,193,0,193,0,2,191
NÓGRÁD,Kozárd,001,142,88,0,88,0,0,88
NÓGRÁD,Kutasó,001,88,57,0,57,0,0,57
NÓGRÁD,Legénd,001,373,148,0,148,0,7,141
NÓGRÁD,Litke,001,612,164,0,164,0,1,163
NÓGRÁD,Lucfalva,001,480,206,0,206,0,0,206
NÓGRÁD,Ludányhalászi,001,641,215,0,215,0,2,213
NÓGRÁD,Ludányhalászi,002,395,112,0,112,0,3,109
NÓGRÁD,Magyargéc,001,467,195,0,195,0,1,194
NÓGRÁD,Magyargéc,002,147,39,0,39,0,0,39
NÓGRÁD,Magyarnándor,001,918,345,0,345,0,3,342
NÓGRÁD,Márkháza,001,186,91,0,91,0,0,91
NÓGRÁD,Mátramindszent,001,652,274,0,274,0,3,271
NÓGRÁD,Mátranovák,001,914,356,0,356,0,1,355
NÓGRÁD,Mátranovák,002,481,154,0,154,0,3,151
NÓGRÁD,Mátraszele,001,760,294,1,294,0,3,291
NÓGRÁD,Mátraszõlõs,001,1217,411,0,411,0,1,410
NÓGRÁD,Mátraterenye,001,874,301,0,301,0,2,299
NÓGRÁD,Mátraterenye,002,577,196,0,196,0,0,196
NÓGRÁD,Mátraverebély,001,619,184,0,184,0,4,180
NÓGRÁD,Mátraverebély,002,643,133,0,133,0,3,130
NÓGRÁD,Mátraverebély,003,223,90,0,90,0,0,90
NÓGRÁD,Mihálygerge,001,474,208,0,208,0,0,208
NÓGRÁD,Mohora,001,754,251,0,251,0,2,249
NÓGRÁD,Nagybárkány,001,480,200,0,200,0,0,200
NÓGRÁD,Nagykeresztúr,001,216,97,0,97,0,1,96
NÓGRÁD,Nagylóc,001,631,197,0,197,0,0,197
NÓGRÁD,Nagylóc,002,471,149,0,149,0,0,149
NÓGRÁD,Nagylóc,003,55,39,0,39,0,0,39
NÓGRÁD,Nagyoroszi,001,743,258,0,258,0,2,256
NÓGRÁD,Nagyoroszi,002,852,333,0,333,0,7,326
NÓGRÁD,Nemti,001,607,254,0,254,0,0,254
NÓGRÁD,Nézsa,001,957,365,0,365,0,8,357
NÓGRÁD,Nógrád,001,782,415,0,415,0,1,414
NÓGRÁD,Nógrád,002,494,252,0,252,0,0,252
NÓGRÁD,Nógrádkövesd,001,530,210,0,210,0,0,210
NÓGRÁD,Nógrádmarcal,001,376,143,0,143,0,0,143
NÓGRÁD,Nógrádmegyer,001,608,174,0,174,0,3,171
NÓGRÁD,Nógrádmegyer,002,632,144,0,144,0,1,143
NÓGRÁD,Nógrádsáp,001,754,314,0,314,0,1,313
NÓGRÁD,Nógrádsipek,001,606,261,0,261,0,0,261
NÓGRÁD,Nógrádszakál,001,464,178,0,178,0,2,176
NÓGRÁD,Nõtincs,001,975,434,0,434,0,1,433
NÓGRÁD,Õrhalom,001,800,331,0,330,-1,0,330
NÓGRÁD,Õsagárd,001,277,142,0,142,0,1,141
NÓGRÁD,Palotás,001,656,281,0,281,0,4,277
NÓGRÁD,Palotás,002,667,249,0,249,0,0,249
NÓGRÁD,Patak,001,734,363,0,363,0,2,361
NÓGRÁD,Patvarc,001,604,272,0,272,0,5,267
NÓGRÁD,Pásztó,001,953,402,0,402,0,5,397
NÓGRÁD,Pásztó,002,973,332,0,332,0,4,328
NÓGRÁD,Pásztó,003,776,363,0,363,0,0,363
NÓGRÁD,Pásztó,004,765,378,0,378,0,1,377
NÓGRÁD,Pásztó,005,1012,412,0,412,0,0,412
NÓGRÁD,Pásztó,006,938,393,0,393,0,5,388
NÓGRÁD,Pásztó,007,1066,524,0,524,0,2,522
NÓGRÁD,Pásztó,008,772,319,0,319,0,7,312
NÓGRÁD,Pásztó,009,308,171,0,171,0,1,170
NÓGRÁD,Piliny,001,454,173,0,173,0,1,172
NÓGRÁD,Pusztaberki,001,123,70,0,70,0,0,70
NÓGRÁD,Rétság,001,1178,500,0,500,0,3,497
NÓGRÁD,Rétság,002,1077,472,0,472,0,3,469
NÓGRÁD,Rimóc,001,741,177,0,177,0,1,176
NÓGRÁD,Rimóc,002,566,238,1,237,-1,1,236
NÓGRÁD,Romhány,001,940,366,0,366,0,1,365
NÓGRÁD,Romhány,002,891,302,0,302,0,3,299
NÓGRÁD,Salgótarján,001,860,357,0,357,0,2,355
NÓGRÁD,Salgótarján,002,729,323,0,323,0,1,322
NÓGRÁD,Salgótarján,003,862,354,0,354,0,2,352
NÓGRÁD,Salgótarján,004,740,358,0,358,0,0,358
NÓGRÁD,Salgótarján,005,810,423,0,423,0,1,422
NÓGRÁD,Salgótarján,006,776,382,0,382,0,1,381
NÓGRÁD,Salgótarján,007,750,338,1,337,-1,0,337
NÓGRÁD,Salgótarján,008,541,196,0,196,0,0,196
NÓGRÁD,Salgótarján,009,221,88,0,88,0,0,88
NÓGRÁD,Salgótarján,010,213,97,0,97,0,0,97
NÓGRÁD,Salgótarján,011,113,39,0,39,0,0,39
NÓGRÁD,Salgótarján,012,119,61,0,61,0,0,61
NÓGRÁD,Salgótarján,013,670,242,0,242,0,2,240
NÓGRÁD,Salgótarján,014,748,271,0,271,0,2,269
NÓGRÁD,Salgótarján,015,595,151,0,151,0,1,150
NÓGRÁD,Salgótarján,016,1103,367,0,366,-1,3,363
NÓGRÁD,Salgótarján,017,880,462,0,462,0,2,460
NÓGRÁD,Salgótarján,018,1117,512,0,512,0,2,510
NÓGRÁD,Salgótarján,019,511,216,0,216,0,2,214
NÓGRÁD,Salgótarján,020,594,243,0,243,0,0,243
NÓGRÁD,Salgótarján,021,919,486,0,486,0,1,485
NÓGRÁD,Salgótarján,022,771,350,0,350,0,1,349
NÓGRÁD,Salgótarján,023,589,272,0,272,0,1,271
NÓGRÁD,Salgótarján,024,621,252,0,252,0,1,251
NÓGRÁD,Salgótarján,025,825,340,0,340,0,3,337
NÓGRÁD,Salgótarján,026,1044,356,0,356,0,0,356
NÓGRÁD,Salgótarján,027,919,262,0,262,0,1,261
NÓGRÁD,Salgótarján,028,877,382,0,382,0,0,382
NÓGRÁD,Salgótarján,029,748,286,0,285,-1,0,285
NÓGRÁD,Salgótarján,030,563,248,0,248,0,1,247
NÓGRÁD,Salgótarján,031,735,371,0,371,0,0,371
NÓGRÁD,Salgótarján,032,719,177,0,177,0,2,175
NÓGRÁD,Salgótarján,033,658,224,0,224,0,5,219
NÓGRÁD,Salgótarján,034,786,231,0,230,-1,0,230
NÓGRÁD,Salgótarján,035,864,258,0,258,0,1,257
NÓGRÁD,Salgótarján,036,793,156,0,156,0,0,156
NÓGRÁD,Salgótarján,037,596,249,0,248,-1,5,243
NÓGRÁD,Salgótarján,038,1285,518,0,517,-1,3,514
NÓGRÁD,Salgótarján,039,887,299,1,297,-2,1,296
NÓGRÁD,Salgótarján,040,764,297,0,297,0,1,296
NÓGRÁD,Ságújfalu,001,765,214,0,214,0,3,211
NÓGRÁD,Sámsonháza,001,219,118,1,117,-1,1,116
NÓGRÁD,Sóshartyán,001,642,168,0,168,0,0,168
NÓGRÁD,Szalmatercs,001,355,123,0,123,0,1,122
NÓGRÁD,Szanda,001,367,141,0,141,0,0,141
NÓGRÁD,Szanda,002,147,78,0,78,0,2,76
NÓGRÁD,Szarvasgede,001,334,129,0,129,0,1,128
NÓGRÁD,Szátok,001,365,103,0,103,0,1,102
NÓGRÁD,Szendehely,001,1035,494,0,494,0,4,490
NÓGRÁD,Szendehely,002,253,122,0,122,0,1,121
NÓGRÁD,Szente,001,266,123,0,123,0,1,122
NÓGRÁD,Szécsénke,001,173,107,0,107,0,0,107
NÓGRÁD,Szécsény,001,1069,483,0,483,0,2,481
NÓGRÁD,Szécsény,002,1053,453,0,453,0,1,452
NÓGRÁD,Szécsény,003,1084,469,0,469,0,3,466
NÓGRÁD,Szécsény,004,1143,472,0,472,0,2,470
NÓGRÁD,Szécsény,005,146,79,0,79,0,2,77
NÓGRÁD,Szécsény,006,210,82,0,82,0,1,81
NÓGRÁD,Szécsényfelfalu,001,327,143,0,143,0,0,143
NÓGRÁD,Szilaspogony,001,223,101,0,101,0,0,101
NÓGRÁD,Szirák,001,835,195,0,195,0,1,194
NÓGRÁD,Szuha,001,389,189,0,189,0,1,188
NÓGRÁD,Szuha,002,68,44,0,44,0,0,44
NÓGRÁD,Szurdokpüspöki,001,915,355,0,355,0,3,352
NÓGRÁD,Szurdokpüspöki,002,663,260,0,260,0,4,256
NÓGRÁD,Szügy,001,629,279,0,279,0,5,274
NÓGRÁD,Szügy,002,544,229,2,227,-2,1,226
NÓGRÁD,Tar,001,829,239,0,239,0,0,239
NÓGRÁD,Tar,002,691,251,0,251,0,0,251
NÓGRÁD,Tereske,001,535,242,0,242,0,1,241
NÓGRÁD,Terény,001,296,168,0,168,0,0,168
NÓGRÁD,Tolmács,001,604,254,0,254,0,0,254
NÓGRÁD,Vanyarc,001,997,350,0,350,0,2,348
NÓGRÁD,Varsány,001,579,232,0,232,0,1,231
NÓGRÁD,Varsány,002,714,325,0,325,0,2,323
NÓGRÁD,Vizslás,001,1068,312,0,310,-2,0,310
NÓGRÁD,Zabar,001,331,101,0,101,0,1,100
NÓGRÁD,Rákóczibánya,001,496,182,0,182,0,1,181
NÓGRÁD,Ipolyszög,001,491,199,0,199,0,4,195
NÓGRÁD,Somoskõújfalu,001,993,404,0,404,0,2,402
NÓGRÁD,Somoskõújfalu,002,821,357,0,357,0,0,357
PEST,Abony,001,734,172,0,172,0,0,172
PEST,Abony,002,768,276,0,276,0,2,274
PEST,Abony,003,736,211,0,211,0,2,209
PEST,Abony,004,728,238,0,238,0,3,235
PEST,Abony,005,721,226,0,226,0,0,226
PEST,Abony,006,695,237,0,237,0,1,236
PEST,Abony,007,714,237,0,237,0,0,237
PEST,Abony,008,725,247,0,247,0,1,246
PEST,Abony,009,722,237,0,237,0,3,234
PEST,Abony,010,746,217,0,217,0,0,217
PEST,Abony,011,743,295,0,295,0,0,295
PEST,Abony,012,702,246,0,246,0,0,246
PEST,Abony,013,735,271,0,271,0,0,271
PEST,Abony,014,708,215,0,215,0,3,212
PEST,Abony,015,694,267,0,267,0,1,266
PEST,Abony,016,701,290,0,290,0,0,290
PEST,Acsa,001,1132,351,0,351,0,3,348
PEST,Albertirsa,001,578,266,0,265,-1,4,261
PEST,Albertirsa,002,695,367,0,367,0,4,363
PEST,Albertirsa,003,625,216,0,216,0,0,216
PEST,Albertirsa,004,638,204,0,204,0,1,203
PEST,Albertirsa,005,673,251,0,251,0,0,251
PEST,Albertirsa,006,662,219,0,219,0,2,217
PEST,Albertirsa,007,709,251,0,251,0,6,245
PEST,Albertirsa,008,684,231,0,230,-1,1,229
PEST,Albertirsa,009,653,250,0,250,0,1,249
PEST,Albertirsa,010,640,184,0,184,0,2,182
PEST,Albertirsa,011,627,241,0,241,0,1,240
PEST,Albertirsa,012,623,217,0,217,0,2,215
PEST,Albertirsa,013,601,233,0,233,0,0,233
PEST,Albertirsa,014,610,231,0,231,0,3,228
PEST,Albertirsa,015,626,229,0,229,0,0,229
PEST,Albertirsa,016,635,179,1,179,0,0,179
PEST,Alsónémedi,001,758,320,0,320,0,3,317
PEST,Alsónémedi,002,785,336,0,336,0,5,331
PEST,Alsónémedi,003,798,325,0,325,0,2,323
PEST,Alsónémedi,004,707,293,0,293,0,2,291
PEST,Alsónémedi,005,1020,430,0,430,0,3,427
PEST,Apaj,001,944,271,0,271,0,0,271
PEST,Aszód,001,820,303,0,302,-1,3,299
PEST,Aszód,002,784,359,0,359,0,3,356
PEST,Aszód,003,776,350,0,350,0,2,348
PEST,Aszód,004,859,427,0,427,0,2,425
PEST,Aszód,005,800,378,0,378,0,1,377
PEST,Aszód,006,835,325,0,325,0,0,325
PEST,Áporka,001,1007,384,0,384,0,0,384
PEST,Bag,001,785,384,0,384,0,1,383
PEST,Bag,002,768,323,0,323,0,0,323
PEST,Bag,003,806,344,0,344,0,2,342
PEST,Bag,004,698,325,0,325,0,1,324
PEST,Bernecebaráti,001,691,318,1,317,-1,4,313
PEST,Bénye,001,982,422,0,421,-1,5,416
PEST,Biatorbágy,001,1405,700,0,699,-1,3,696
PEST,Biatorbágy,002,1211,571,0,571,0,4,567
PEST,Biatorbágy,003,1263,646,0,645,-1,1,644
PEST,Biatorbágy,004,1195,727,0,726,-1,1,725
PEST,Biatorbágy,005,1302,770,0,768,-2,2,766
PEST,Biatorbágy,006,1114,581,0,581,0,2,579
PEST,Biatorbágy,007,1468,605,0,605,0,2,603
PEST,Biatorbágy,008,1258,701,0,701,0,5,696
PEST,Budajenõ,001,786,481,0,481,0,2,479
PEST,Budajenõ,002,760,445,0,445,0,0,445
PEST,Budakalász,001,1078,591,0,591,0,2,589
PEST,Budakalász,002,1058,507,0,507,0,5,502
PEST,Budakalász,003,1125,628,0,628,0,4,624
PEST,Budakalász,004,1228,672,0,671,-1,1,670
PEST,Budakalász,005,1126,587,0,587,0,2,585
PEST,Budakalász,006,1036,623,0,623,0,0,623
PEST,Budakalász,007,1041,582,0,582,0,1,581
PEST,Budakalász,008,1033,571,0,571,0,3,568
PEST,Budakeszi,001,683,458,0,458,0,4,454
PEST,Budakeszi,002,595,342,0,342,0,0,342
PEST,Budakeszi,003,989,615,0,615,0,1,614
PEST,Budakeszi,004,653,369,0,369,0,1,368
PEST,Budakeszi,005,1027,526,1,524,-2,1,523
PEST,Budakeszi,006,803,488,0,487,-1,1,486
PEST,Budakeszi,007,643,432,0,432,0,4,428
PEST,Budakeszi,008,701,483,0,482,-1,3,479
PEST,Budakeszi,009,682,390,0,390,0,0,390
PEST,Budakeszi,010,614,329,0,329,0,3,326
PEST,Budakeszi,011,598,376,0,376,0,0,376
PEST,Budakeszi,012,674,444,0,444,0,0,444
PEST,Budakeszi,013,714,426,0,426,0,4,422
PEST,Budakeszi,014,682,410,0,410,0,1,409
PEST,Budakeszi,015,800,431,0,431,0,2,429
PEST,Budakeszi,016,638,326,0,326,0,0,326
PEST,Budaörs,001,1164,694,1,691,-3,4,687
PEST,Budaörs,002,1135,605,0,605,0,3,602
PEST,Budaörs,003,1123,630,0,630,0,3,627
PEST,Budaörs,004,1037,600,0,599,-1,5,594
PEST,Budaörs,005,1152,692,0,692,0,3,689
PEST,Budaörs,006,1031,622,1,620,-2,1,619
PEST,Budaörs,007,1127,681,1,681,0,0,681
PEST,Budaörs,008,1107,689,1,689,0,2,687
PEST,Budaörs,009,1069,490,0,490,0,4,486
PEST,Budaörs,010,1075,548,0,547,-1,2,545
PEST,Budaörs,011,1067,482,0,482,0,0,482
PEST,Budaörs,012,1108,508,0,508,0,3,505
PEST,Budaörs,013,1618,987,0,986,-1,4,982
PEST,Budaörs,014,1114,528,0,525,-3,16,509
PEST,Budaörs,015,975,544,0,542,-2,0,542
PEST,Budaörs,016,1037,614,0,614,0,2,612
PEST,Budaörs,017,1263,766,0,765,-1,2,763
PEST,Budaörs,018,1339,793,0,791,-2,1,790
PEST,Budaörs,019,905,521,0,521,0,3,518
PEST,Budaörs,020,1098,679,0,679,0,0,679
PEST,Bugyi,001,719,264,0,264,0,3,261
PEST,Bugyi,002,742,250,0,250,0,0,250
PEST,Bugyi,003,664,259,0,259,0,0,259
PEST,Bugyi,004,737,261,0,261,0,4,257
PEST,Bugyi,005,883,295,0,295,0,2,293
PEST,Bugyi,006,211,55,0,55,0,0,55
PEST,Bugyi,007,210,35,0,35,0,0,35
PEST,Cegléd,001,759,397,0,397,0,2,395
PEST,Cegléd,002,977,514,0,514,0,3,511
PEST,Cegléd,003,1037,520,0,519,-1,2,517
PEST,Cegléd,004,771,339,0,339,0,2,337
PEST,Cegléd,005,1112,440,0,440,0,5,435
PEST,Cegléd,006,754,376,0,376,0,1,375
PEST,Cegléd,007,616,256,0,256,0,1,255
PEST,Cegléd,008,631,310,0,310,0,1,309
PEST,Cegléd,009,907,482,0,482,0,1,481
PEST,Cegléd,010,953,441,0,441,0,4,437
PEST,Cegléd,011,654,314,0,315,1,11,304
PEST,Cegléd,012,651,309,1,308,-1,0,308
PEST,Cegléd,013,1248,490,0,490,0,1,489
PEST,Cegléd,014,1016,366,0,366,0,2,364
PEST,Cegléd,015,854,458,0,458,0,3,455
PEST,Cegléd,016,829,409,0,409,0,1,408
PEST,Cegléd,017,905,327,0,327,0,0,327
PEST,Cegléd,018,723,160,0,160,0,4,156
PEST,Cegléd,019,202,34,0,34,0,0,34
PEST,Cegléd,020,1187,329,0,329,0,1,328
PEST,Cegléd,021,962,283,0,283,0,3,280
PEST,Cegléd,022,1073,390,0,390,0,0,390
PEST,Cegléd,023,1111,470,0,470,0,0,470
PEST,Cegléd,024,842,302,0,302,0,1,301
PEST,Cegléd,025,908,291,0,291,0,3,288
PEST,Cegléd,026,1096,241,0,241,0,1,240
PEST,Cegléd,027,1094,351,0,351,0,4,347
PEST,Cegléd,028,793,355,0,355,0,1,354
PEST,Cegléd,029,650,204,0,204,0,0,204
PEST,Cegléd,030,696,277,0,277,0,0,277
PEST,Cegléd,031,932,497,0,496,-1,1,495
PEST,Cegléd,032,1428,419,0,419,0,0,419
PEST,Cegléd,033,1063,369,0,369,0,1,368
PEST,Ceglédbercel,001,807,306,0,306,0,2,304
PEST,Ceglédbercel,002,757,296,0,296,0,3,293
PEST,Ceglédbercel,003,726,259,0,259,0,0,259
PEST,Ceglédbercel,004,700,302,0,302,0,1,301
PEST,Ceglédbercel,005,631,251,1,250,-1,0,250
PEST,Csemõ,001,1244,440,0,440,0,3,437
PEST,Csemõ,002,854,210,0,210,0,1,209
PEST,Csemõ,003,1281,288,0,288,0,3,285
PEST,Csévharaszt,001,875,282,0,282,0,3,279
PEST,Csévharaszt,002,788,241,0,241,0,0,241
PEST,Csobánka,001,933,258,0,258,0,0,258
PEST,Csobánka,002,925,484,1,483,-1,4,479
PEST,Csobánka,003,892,461,0,461,0,0,461
PEST,Csomád,001,1284,568,0,568,0,3,565
PEST,Csömör,001,1229,678,0,678,0,3,675
PEST,Csömör,002,980,538,0,538,0,2,536
PEST,Csömör,003,1014,563,0,563,0,1,562
PEST,Csömör,004,998,427,2,425,-2,5,420
PEST,Csömör,005,932,412,0,412,0,3,409
PEST,Csömör,006,1147,549,0,549,0,4,545
PEST,Csömör,007,1173,625,0,625,0,1,624
PEST,Csõvár,001,527,237,0,237,0,2,235
PEST,Dabas,001,854,298,0,298,0,0,298
PEST,Dabas,002,852,414,0,414,0,1,413
PEST,Dabas,003,929,392,0,392,0,1,391
PEST,Dabas,004,825,326,0,326,0,2,324
PEST,Dabas,005,818,335,0,335,0,1,334
PEST,Dabas,006,843,376,0,376,0,1,375
PEST,Dabas,007,938,406,0,406,0,2,404
PEST,Dabas,008,866,371,0,371,0,0,371
PEST,Dabas,009,788,396,0,396,0,4,392
PEST,Dabas,010,824,312,0,312,0,0,312
PEST,Dabas,011,844,359,0,359,0,1,358
PEST,Dabas,012,876,381,0,381,0,2,379
PEST,Dabas,013,853,288,0,288,0,1,287
PEST,Dabas,014,792,307,0,307,0,1,306
PEST,Dabas,015,1111,378,0,378,0,2,376
PEST,Dabas,016,638,220,0,220,0,2,218
PEST,Dánszentmiklós,001,798,247,0,247,0,0,247
PEST,Dánszentmiklós,002,1126,355,0,355,0,2,353
PEST,Dánszentmiklós,003,325,105,0,105,0,1,104
PEST,Dány,001,803,339,0,339,0,0,339
PEST,Dány,002,857,408,0,408,0,0,408
PEST,Dány,003,891,365,0,365,0,0,365
PEST,Dány,004,1016,345,0,345,0,4,341
PEST,Délegyháza,001,1210,383,0,383,0,0,383
PEST,Délegyháza,002,1269,495,0,495,0,1,494
PEST,Délegyháza,003,1211,420,0,420,0,0,420
PEST,Diósd,001,1145,692,0,692,0,2,690
PEST,Diósd,002,930,479,0,479,0,1,478
PEST,Diósd,003,946,508,0,508,0,1,507
PEST,Diósd,004,955,451,0,451,0,1,450
PEST,Diósd,005,958,542,0,542,0,3,539
PEST,Diósd,006,964,509,0,509,0,0,509
PEST,Diósd,007,976,548,1,547,-1,1,546
PEST,Diósd,008,937,527,0,527,0,4,523
PEST,Domony,001,572,183,0,183,0,3,180
PEST,Domony,002,765,374,0,374,0,1,373
PEST,Domony,003,373,164,0,164,0,1,163
PEST,Dömsöd,001,905,276,0,276,0,2,274
PEST,Dömsöd,002,987,326,0,326,0,0,326
PEST,Dömsöd,003,1096,385,0,385,0,4,381
PEST,Dömsöd,004,947,386,1,385,-1,0,385
PEST,Dömsöd,005,927,273,0,273,0,2,271
PEST,Dunabogdány,001,809,452,0,452,0,5,447
PEST,Dunabogdány,002,909,448,0,448,0,0,448
PEST,Dunabogdány,003,849,413,0,413,0,0,413
PEST,Dunaharaszti,001,1353,519,0,520,1,13,507
PEST,Dunaharaszti,002,1017,398,0,398,0,2,396
PEST,Dunaharaszti,003,988,431,0,431,0,2,429
PEST,Dunaharaszti,004,949,459,0,459,0,1,458
PEST,Dunaharaszti,005,970,425,0,421,-4,0,421
PEST,Dunaharaszti,006,1014,507,0,506,-1,4,502
PEST,Dunaharaszti,007,875,441,0,440,-1,2,438
PEST,Dunaharaszti,008,1510,718,0,716,-2,3,713
PEST,Dunaharaszti,009,1005,443,0,443,0,2,441
PEST,Dunaharaszti,010,1051,494,0,492,-2,0,492
PEST,Dunaharaszti,011,1177,541,0,541,0,3,538
PEST,Dunaharaszti,012,1223,488,0,488,0,1,487
PEST,Dunaharaszti,013,1129,469,1,468,-1,4,464
PEST,Dunaharaszti,014,1209,481,0,481,0,3,478
PEST,Dunaharaszti,015,1103,491,0,489,-2,3,486
PEST,Dunaharaszti,016,975,433,0,433,0,3,430
PEST,Dunakeszi,001,1003,470,0,469,-1,2,467
PEST,Dunakeszi,002,1135,611,0,611,0,0,611
PEST,Dunakeszi,003,1060,591,0,591,0,3,588
PEST,Dunakeszi,004,1066,503,1,502,-1,1,501
PEST,Dunakeszi,005,1075,458,0,458,0,1,457
PEST,Dunakeszi,006,928,421,0,421,0,0,421
PEST,Dunakeszi,007,1110,574,0,574,0,3,571
PEST,Dunakeszi,008,1192,646,0,646,0,1,645
PEST,Dunakeszi,009,1116,585,0,585,0,1,584
PEST,Dunakeszi,010,1182,519,0,519,0,2,517
PEST,Dunakeszi,011,1338,780,0,780,0,7,773
PEST,Dunakeszi,012,1171,530,0,530,0,4,526
PEST,Dunakeszi,013,963,583,0,583,0,1,582
PEST,Dunakeszi,014,1034,563,0,563,0,4,559
PEST,Dunakeszi,015,1031,581,0,580,-1,1,579
PEST,Dunakeszi,016,1153,601,0,601,0,3,598
PEST,Dunakeszi,017,992,498,0,497,-1,2,495
PEST,Dunakeszi,018,928,477,0,477,0,3,474
PEST,Dunakeszi,019,1261,594,0,594,0,2,592
PEST,Dunakeszi,020,989,559,0,558,-1,3,555
PEST,Dunakeszi,021,1092,510,0,510,0,5,505
PEST,Dunakeszi,022,1168,535,0,535,0,3,532
PEST,Dunakeszi,023,1215,468,0,468,0,2,466
PEST,Dunakeszi,024,1042,413,0,413,0,0,413
PEST,Dunakeszi,025,1098,521,0,520,-1,1,519
PEST,Dunakeszi,026,1364,660,0,660,0,0,660
PEST,Dunakeszi,027,1203,529,0,529,0,0,529
PEST,Dunakeszi,028,1201,534,2,534,0,4,530
PEST,Dunakeszi,029,1162,533,0,530,-3,1,529
PEST,Dunakeszi,030,981,466,0,466,0,4,462
PEST,Dunavarsány,001,978,403,0,403,0,2,401
PEST,Dunavarsány,002,1088,474,0,474,0,4,470
PEST,Dunavarsány,003,1138,422,0,422,0,1,421
PEST,Dunavarsány,004,1129,360,0,360,0,3,357
PEST,Dunavarsány,005,1072,435,0,435,0,3,432
PEST,Dunavarsány,006,1064,380,0,380,0,5,375
PEST,Ecser,001,967,452,0,452,0,2,450
PEST,Ecser,002,658,294,0,294,0,0,294
PEST,Ecser,003,834,396,0,396,0,0,396
PEST,Ecser,004,705,329,0,329,0,2,327
PEST,Erdõkertes,001,1227,532,0,532,0,1,531
PEST,Erdõkertes,002,1193,478,0,478,0,3,475
PEST,Erdõkertes,003,1076,432,0,432,0,3,429
PEST,Erdõkertes,004,1103,443,0,443,0,2,441
PEST,Erdõkertes,005,1085,429,0,429,0,1,428
PEST,Erdõkertes,006,1018,339,0,339,0,0,339
PEST,Érd,001,1180,398,0,396,-2,2,394
PEST,Érd,002,1078,471,0,471,0,5,466
PEST,Érd,003,968,552,0,552,0,3,549
PEST,Érd,004,961,448,0,448,0,0,448
PEST,Érd,005,1501,830,1,831,1,11,820
PEST,Érd,006,1180,570,0,570,0,0,570
PEST,Érd,007,1210,568,0,568,0,0,568
PEST,Érd,008,1151,452,0,449,-3,1,448
PEST,Érd,009,955,312,0,312,0,1,311
PEST,Érd,010,1188,370,1,370,0,2,368
PEST,Érd,011,959,421,0,421,0,2,419
PEST,Érd,012,1242,583,0,583,0,4,579
PEST,Érd,013,979,493,0,493,0,1,492
PEST,Érd,014,963,516,0,516,0,3,513
PEST,Érd,015,1175,654,0,654,0,2,652
PEST,Érd,016,1123,586,0,586,0,2,584
PEST,Érd,017,980,453,0,453,0,3,450
PEST,Érd,018,1008,585,0,585,0,5,580
PEST,Érd,019,1135,531,0,531,0,3,528
PEST,Érd,020,1292,566,0,565,-1,0,565
PEST,Érd,021,981,375,0,375,0,2,373
PEST,Érd,022,1028,455,1,453,-2,3,450
PEST,Érd,023,1062,567,0,567,0,2,565
PEST,Érd,024,1056,595,0,595,0,2,593
PEST,Érd,025,1166,515,0,515,0,1,514
PEST,Érd,026,1136,500,0,500,0,0,500
PEST,Érd,027,1201,592,0,592,0,0,592
PEST,Érd,028,1134,498,0,498,0,1,497
PEST,Érd,029,1161,682,0,682,0,4,678
PEST,Érd,030,956,453,0,453,0,3,450
PEST,Érd,031,1041,528,0,527,-1,4,523
PEST,Érd,032,1127,578,0,578,0,4,574
PEST,Érd,033,1290,520,0,520,0,0,520
PEST,Érd,034,1079,370,0,370,0,0,370
PEST,Érd,035,1122,498,0,498,0,2,496
PEST,Érd,036,1133,519,0,519,0,1,518
PEST,Érd,037,1103,559,0,559,0,2,557
PEST,Érd,038,1177,570,0,569,-1,1,568
PEST,Érd,039,1078,480,0,480,0,2,478
PEST,Érd,040,1094,552,0,552,0,0,552
PEST,Érd,041,1018,500,0,500,0,1,499
PEST,Érd,042,1139,594,0,594,0,2,592
PEST,Érd,043,1204,587,0,586,-1,1,585
PEST,Érd,044,1016,486,0,486,0,0,486
PEST,Érd,045,1202,619,0,619,0,1,618
PEST,Érd,046,1220,653,0,653,0,2,651
PEST,Érd,047,1187,591,0,591,0,0,591
PEST,Érd,048,1265,565,0,565,0,2,563
PEST,Farmos,001,1166,444,0,444,0,2,442
PEST,Farmos,002,843,267,0,267,0,1,266
PEST,Farmos,003,840,192,0,192,0,1,191
PEST,Felsõpakony,001,894,311,0,311,0,4,307
PEST,Felsõpakony,002,953,393,0,393,0,0,393
PEST,Felsõpakony,003,1089,407,0,407,0,0,407
PEST,Fót,001,1120,631,0,631,0,2,629
PEST,Fót,002,884,456,0,456,0,4,452
PEST,Fót,003,956,471,0,471,0,0,471
PEST,Fót,004,949,469,0,468,-1,4,464
PEST,Fót,005,1056,487,0,487,0,1,486
PEST,Fót,006,993,457,0,457,0,0,457
PEST,Fót,007,995,449,0,449,0,3,446
PEST,Fót,008,847,391,0,391,0,3,388
PEST,Fót,009,1194,450,0,450,0,3,447
PEST,Fót,010,1087,528,0,528,0,3,525
PEST,Fót,011,856,388,0,388,0,1,387
PEST,Fót,012,937,346,0,346,0,0,346
PEST,Fót,013,1161,581,0,581,0,1,580
PEST,Fót,014,995,444,0,445,1,11,434
PEST,Fót,015,868,379,0,378,-1,3,375
PEST,Fót,016,1044,483,0,483,0,1,482
PEST,Galgagyörk,001,789,355,0,355,0,3,352
PEST,Galgahévíz,001,705,374,0,374,0,4,370
PEST,Galgahévíz,002,692,296,0,296,0,1,295
PEST,Galgahévíz,003,727,217,0,217,0,1,216
PEST,Galgamácsa,001,937,361,0,361,0,5,356
PEST,Galgamácsa,002,616,230,0,230,0,0,230
PEST,Gomba,001,1226,454,0,454,0,0,454
PEST,Gomba,002,1111,370,0,370,0,6,364
PEST,Gomba,003,111,36,0,36,0,2,34
PEST,Göd,001,776,461,0,461,0,0,461
PEST,Göd,002,830,470,1,469,-1,2,467
PEST,Göd,003,882,525,0,525,0,2,523
PEST,Göd,004,1029,520,0,520,0,5,515
PEST,Göd,005,909,462,0,462,0,2,460
PEST,Göd,006,914,540,0,540,0,2,538
PEST,Göd,007,1084,500,0,500,0,9,491
PEST,Göd,008,1194,602,0,602,0,1,601
PEST,Göd,009,280,96,0,96,0,1,95
PEST,Göd,010,758,338,0,335,-3,1,334
PEST,Göd,011,873,491,0,491,0,1,490
PEST,Göd,012,1098,707,0,707,0,1,706
PEST,Göd,013,816,435,0,435,0,1,434
PEST,Göd,014,1303,677,0,677,0,7,670
PEST,Göd,015,1206,607,0,607,0,3,604
PEST,Göd,016,1170,562,0,562,0,3,559
PEST,Göd,017,904,479,0,479,0,1,478
PEST,Gödöllõ,001,814,453,0,453,0,1,452
PEST,Gödöllõ,002,826,306,0,306,0,0,306
PEST,Gödöllõ,003,1289,566,0,566,0,3,563
PEST,Gödöllõ,004,836,470,0,470,0,2,468
PEST,Gödöllõ,005,889,419,0,419,0,3,416
PEST,Gödöllõ,006,1097,576,0,576,0,6,570
PEST,Gödöllõ,007,906,352,0,352,0,1,351
PEST,Gödöllõ,008,850,433,0,433,0,2,431
PEST,Gödöllõ,009,950,495,0,495,0,0,495
PEST,Gödöllõ,010,294,142,0,142,0,2,140
PEST,Gödöllõ,011,1089,589,1,589,0,6,583
PEST,Gödöllõ,012,1070,575,0,575,0,1,574
PEST,Gödöllõ,013,884,446,0,446,0,0,446
PEST,Gödöllõ,014,877,411,0,411,0,0,411
PEST,Gödöllõ,015,846,390,0,386,-4,2,384
PEST,Gödöllõ,016,961,500,0,500,0,2,498
PEST,Gödöllõ,017,1297,835,0,834,-1,2,832
PEST,Gödöllõ,018,744,324,0,323,-1,0,323
PEST,Gödöllõ,019,785,388,0,388,0,1,387
PEST,Gödöllõ,020,793,415,0,415,0,2,413
PEST,Gödöllõ,021,997,483,0,483,0,1,482
PEST,Gödöllõ,022,618,352,0,352,0,0,352
PEST,Gödöllõ,023,699,369,0,369,0,0,369
PEST,Gödöllõ,024,1155,701,2,698,-3,3,695
PEST,Gödöllõ,025,803,450,1,449,-1,0,449
PEST,Gödöllõ,026,813,474,0,474,0,0,474
PEST,Gödöllõ,027,888,424,0,422,-2,3,419
PEST,Gödöllõ,028,1073,579,0,579,0,0,579
PEST,Gyál,001,1097,472,0,472,0,4,468
PEST,Gyál,002,1127,505,0,504,-1,0,504
PEST,Gyál,003,1186,438,0,438,0,2,436
PEST,Gyál,004,1273,470,0,470,0,2,468
PEST,Gyál,005,1167,416,0,416,0,0,416
PEST,Gyál,006,1137,385,0,385,0,1,384
PEST,Gyál,007,1086,390,0,390,0,0,390
PEST,Gyál,008,960,339,0,339,0,1,338
PEST,Gyál,009,1282,400,1,399,-1,2,397
PEST,Gyál,010,1123,385,0,385,0,2,383
PEST,Gyál,011,1004,436,0,436,0,1,435
PEST,Gyál,012,934,328,0,328,0,1,327
PEST,Gyál,013,879,307,0,307,0,0,307
PEST,Gyál,014,979,354,0,354,0,1,353
PEST,Gyál,015,1025,360,0,360,0,0,360
PEST,Gyál,016,849,275,0,275,0,2,273
PEST,Gyál,017,1226,488,0,488,0,0,488
PEST,Gyál,018,972,385,0,386,1,11,375
PEST,Gyömrõ,001,1014,365,0,365,0,2,363
PEST,Gyömrõ,002,987,437,0,437,0,3,434
PEST,Gyömrõ,003,1069,564,0,564,0,1,563
PEST,Gyömrõ,004,819,312,0,312,0,0,312
PEST,Gyömrõ,005,809,385,0,385,0,0,385
PEST,Gyömrõ,006,823,314,0,314,0,0,314
PEST,Gyömrõ,007,806,342,0,342,0,1,341
PEST,Gyömrõ,008,1023,394,0,394,0,1,393
PEST,Gyömrõ,009,901,299,0,299,0,1,298
PEST,Gyömrõ,010,759,365,0,365,0,0,365
PEST,Gyömrõ,011,769,319,0,318,-1,1,317
PEST,Gyömrõ,012,874,418,0,418,0,0,418
PEST,Gyömrõ,013,782,342,0,342,0,1,341
PEST,Gyömrõ,014,825,332,0,332,0,0,332
PEST,Gyömrõ,015,845,385,0,385,0,3,382
PEST,Gyömrõ,016,1339,566,0,565,-1,1,564
PEST,Halásztelek,001,1124,501,0,499,-2,1,498
PEST,Halásztelek,002,993,454,0,454,0,1,453
PEST,Halásztelek,003,1088,488,0,488,0,0,488
PEST,Halásztelek,004,1012,424,0,424,0,3,421
PEST,Halásztelek,005,1015,435,0,434,-1,2,432
PEST,Halásztelek,006,1163,521,0,521,0,1,520
PEST,Halásztelek,007,1202,543,0,543,0,3,540
PEST,Halásztelek,008,1083,469,0,469,0,1,468
PEST,Herceghalom,001,924,527,0,527,0,0,527
PEST,Herceghalom,002,934,561,1,560,-1,0,560
PEST,Hernád,001,974,302,0,302,0,2,300
PEST,Hernád,002,1234,397,0,397,0,0,397
PEST,Hernád,003,1112,380,0,380,0,6,374
PEST,Hévízgyörk,001,964,465,0,465,0,5,460
PEST,Hévízgyörk,002,795,360,0,360,0,0,360
PEST,Hévízgyörk,003,816,424,0,424,0,5,419
PEST,Iklad,001,897,408,0,408,0,1,407
PEST,Iklad,002,762,295,0,295,0,1,294
PEST,Inárcs,001,1057,423,0,423,0,5,418
PEST,Inárcs,002,824,334,0,334,0,1,333
PEST,Inárcs,003,959,363,0,363,0,0,363
PEST,Inárcs,004,878,342,0,342,0,3,339
PEST,Ipolydamásd,001,317,144,0,144,0,0,144
PEST,Ipolytölgyes,001,234,101,0,101,0,1,100
PEST,Isaszeg,001,1367,576,0,576,0,3,573
PEST,Isaszeg,002,1166,441,0,441,0,0,441
PEST,Isaszeg,003,1159,389,0,388,-1,1,387
PEST,Isaszeg,004,1373,481,0,481,0,0,481
PEST,Isaszeg,005,1071,506,0,505,-1,3,502
PEST,Isaszeg,006,1042,519,0,519,0,2,517
PEST,Isaszeg,007,1035,375,1,374,-1,0,374
PEST,Isaszeg,008,1036,388,0,388,0,0,388
PEST,Jászkarajenõ,001,786,198,0,198,0,0,198
PEST,Jászkarajenõ,002,675,215,0,215,0,2,213
PEST,Jászkarajenõ,003,642,239,0,239,0,3,236
PEST,Kakucs,001,785,296,0,296,0,3,293
PEST,Kakucs,002,619,254,0,254,0,0,254
PEST,Kakucs,003,883,337,0,337,0,0,337
PEST,Kartal,001,849,320,0,320,0,4,316
PEST,Kartal,002,817,286,0,286,0,1,285
PEST,Kartal,003,828,332,0,332,0,1,331
PEST,Kartal,004,782,285,0,285,0,0,285
PEST,Kartal,005,738,298,0,298,0,1,297
PEST,Kartal,006,752,253,0,253,0,3,250
PEST,Káva,001,532,219,0,219,0,2,217
PEST,Kemence,001,828,420,0,420,0,2,418
PEST,Kerepes,001,1067,465,0,465,0,1,464
PEST,Kerepes,002,993,474,0,473,-1,1,472
PEST,Kerepes,003,1120,591,0,591,0,2,589
PEST,Kerepes,004,1226,449,0,449,0,2,447
PEST,Kerepes,005,960,411,0,410,-1,3,407
PEST,Kerepes,006,1035,539,0,539,0,3,536
PEST,Kerepes,007,955,476,0,476,0,3,473
PEST,Kerepes,008,1017,501,0,501,0,1,500
PEST,Kiskunlacháza,001,1032,344,0,344,0,2,342
PEST,Kiskunlacháza,002,993,380,0,380,0,0,380
PEST,Kiskunlacháza,003,1128,378,0,378,0,2,376
PEST,Kiskunlacháza,004,1099,419,0,419,0,2,417
PEST,Kiskunlacháza,005,1064,337,0,337,0,0,337
PEST,Kiskunlacháza,006,1092,374,0,374,0,1,373
PEST,Kiskunlacháza,007,892,307,0,307,0,0,307
PEST,Kismaros,001,1025,575,0,575,0,1,574
PEST,Kismaros,002,884,526,0,526,0,2,524
PEST,Kisnémedi,001,576,245,0,245,0,2,243
PEST,Kisoroszi,001,822,475,1,475,0,3,472
PEST,Kistarcsa,001,1358,670,0,670,0,0,670
PEST,Kistarcsa,002,1285,700,0,700,0,4,696
PEST,Kistarcsa,003,1267,580,0,580,0,4,576
PEST,Kistarcsa,004,1235,535,0,535,0,2,533
PEST,Kistarcsa,005,1348,703,0,704,1,10,694
PEST,Kistarcsa,006,1166,578,0,578,0,5,573
PEST,Kistarcsa,007,1135,565,0,565,0,10,555
PEST,Kistarcsa,008,1346,597,0,597,0,0,597
PEST,Kocsér,001,665,291,0,291,0,0,291
PEST,Kocsér,002,766,287,0,287,0,2,285
PEST,Kosd,001,1175,547,0,547,0,1,546
PEST,Kosd,002,845,399,0,399,0,4,395
PEST,Kóka,001,622,236,0,236,0,1,235
PEST,Kóka,002,726,267,0,267,0,3,264
PEST,Kóka,003,1155,370,0,369,-1,2,367
PEST,Kóka,004,1070,308,0,308,0,0,308
PEST,Kóspallag,001,607,289,0,289,0,0,289
PEST,Kõröstetétlen,001,656,274,0,274,0,4,270
PEST,Leányfalu,001,1060,600,0,600,0,1,599
PEST,Leányfalu,002,1081,520,0,520,0,1,519
PEST,Leányfalu,003,951,567,0,567,0,3,564
PEST,Letkés,001,917,437,0,437,0,2,435
PEST,Lórév,001,255,118,0,118,0,2,116
PEST,Maglód,001,1115,525,0,525,0,2,523
PEST,Maglód,002,1267,564,0,564,0,3,561
PEST,Maglód,003,1357,518,0,518,0,5,513
PEST,Maglód,004,1286,553,0,553,0,1,552
PEST,Maglód,005,1185,446,0,446,0,0,446
PEST,Maglód,006,1130,469,0,469,0,0,469
PEST,Maglód,007,1182,484,0,483,-1,1,482
PEST,Maglód,008,1382,680,0,680,0,0,680
PEST,Majosháza,001,1376,615,0,614,-1,3,611
PEST,Makád,001,1058,370,0,370,0,3,367
PEST,Márianosztra,001,693,271,0,271,0,2,269
PEST,Mende,001,777,275,0,275,0,1,274
PEST,Mende,002,774,360,0,360,0,0,360
PEST,Mende,003,846,287,0,287,0,1,286
PEST,Mende,004,986,407,0,407,0,2,405
PEST,Mikebuda,001,595,187,0,187,0,0,187
PEST,Mogyoród,001,1091,563,0,563,0,3,560
PEST,Mogyoród,002,1157,508,0,507,-1,1,506
PEST,Mogyoród,003,1135,587,0,587,0,3,584
PEST,Mogyoród,004,1103,480,0,478,-2,2,476
PEST,Mogyoród,005,1030,450,0,450,0,4,446
PEST,Monor,001,821,366,0,366,0,2,364
PEST,Monor,002,896,224,0,224,0,1,223
PEST,Monor,003,925,357,0,357,0,1,356
PEST,Monor,004,985,348,2,346,-2,0,346
PEST,Monor,005,865,362,0,362,0,2,360
PEST,Monor,006,877,344,0,344,0,1,343
PEST,Monor,007,1007,367,0,366,-1,1,365
PEST,Monor,008,825,281,0,281,0,0,281
PEST,Monor,009,913,374,0,374,0,2,372
PEST,Monor,010,931,383,0,383,0,0,383
PEST,Monor,011,920,443,0,442,-1,1,441
PEST,Monor,012,890,437,0,437,0,0,437
PEST,Monor,013,985,434,0,434,0,1,433
PEST,Monor,014,861,404,1,403,-1,2,401
PEST,Monor,015,918,341,0,340,-1,2,338
PEST,Monor,016,1002,324,0,324,0,1,323
PEST,Nagybörzsöny,001,541,251,0,251,0,3,248
PEST,Nagykáta,001,606,288,0,288,0,1,287
PEST,Nagykáta,002,863,298,0,297,-1,0,297
PEST,Nagykáta,003,712,267,0,267,0,2,265
PEST,Nagykáta,004,1032,519,0,519,0,7,512
PEST,Nagykáta,005,1166,420,0,420,0,4,416
PEST,Nagykáta,006,1163,479,0,479,0,1,478
PEST,Nagykáta,007,673,167,0,167,0,1,166
PEST,Nagykáta,008,1152,337,0,337,0,1,336
PEST,Nagykáta,009,693,249,0,249,0,1,248
PEST,Nagykáta,010,632,253,0,253,0,2,251
PEST,Nagykáta,011,670,262,0,262,0,2,260
PEST,Nagykáta,012,615,221,0,221,0,1,220
PEST,Nagykovácsi,001,707,385,0,385,0,0,385
PEST,Nagykovácsi,002,953,565,0,565,0,4,561
PEST,Nagykovácsi,003,815,459,0,459,0,1,458
PEST,Nagykovácsi,004,863,518,0,518,0,3,515
PEST,Nagykovácsi,005,839,549,0,549,0,2,547
PEST,Nagykovácsi,006,857,527,0,527,0,2,525
PEST,Nagykovácsi,007,887,478,0,478,0,0,478
PEST,Nagykõrös,001,1219,418,0,418,0,2,416
PEST,Nagykõrös,002,1117,502,0,502,0,2,500
PEST,Nagykõrös,003,1102,438,0,438,0,4,434
PEST,Nagykõrös,004,1084,434,0,433,-1,3,430
PEST,Nagykõrös,005,1102,393,0,393,0,3,390
PEST,Nagykõrös,006,1091,437,0,437,0,1,436
PEST,Nagykõrös,007,877,294,0,294,0,5,289
PEST,Nagykõrös,008,775,285,0,285,0,1,284
PEST,Nagykõrös,009,783,308,0,308,0,0,308
PEST,Nagykõrös,010,791,338,0,337,-1,1,336
PEST,Nagykõrös,011,734,266,0,266,0,0,266
PEST,Nagykõrös,012,759,343,0,343,0,0,343
PEST,Nagykõrös,013,1087,319,0,319,0,2,317
PEST,Nagykõrös,014,1061,331,0,331,0,3,328
PEST,Nagykõrös,015,744,345,0,345,0,2,343
PEST,Nagykõrös,016,814,218,0,218,0,0,218
PEST,Nagykõrös,017,1008,339,0,339,0,1,338
PEST,Nagykõrös,018,888,274,0,274,0,5,269
PEST,Nagykõrös,019,920,396,0,396,0,0,396
PEST,Nagykõrös,020,976,268,0,268,0,1,267
PEST,Nagymaros,001,975,435,0,435,0,4,431
PEST,Nagymaros,002,1037,490,0,490,0,0,490
PEST,Nagymaros,003,948,603,0,603,0,0,603
PEST,Nagymaros,004,1082,567,1,567,0,5,562
PEST,Nagytarcsa,001,843,376,0,376,0,1,375
PEST,Nagytarcsa,002,855,395,0,394,-1,4,390
PEST,Nagytarcsa,003,947,472,0,472,0,1,471
PEST,Nagytarcsa,004,1052,527,1,525,-2,8,517
PEST,Nyáregyháza,001,1065,297,0,297,0,1,296
PEST,Nyáregyháza,002,1057,378,0,378,0,4,374
PEST,Nyáregyháza,003,969,310,0,310,0,4,306
PEST,Nyársapát,001,808,184,1,184,0,1,183
PEST,Nyársapát,002,740,206,0,206,0,1,205
PEST,Ócsa,001,817,275,0,275,0,1,274
PEST,Ócsa,002,937,370,0,370,0,2,368
PEST,Ócsa,003,823,342,0,342,0,2,340
PEST,Ócsa,004,1017,357,0,357,0,2,355
PEST,Ócsa,005,736,283,0,283,0,1,282
PEST,Ócsa,006,987,400,0,399,-1,0,399
PEST,Ócsa,007,714,299,0,299,0,2,297
PEST,Ócsa,008,153,59,0,59,0,1,58
PEST,Ócsa,009,445,115,1,114,-1,2,112
PEST,Ócsa,010,983,360,0,360,0,1,359
PEST,Örkény,001,713,260,0,260,0,0,260
PEST,Örkény,002,1067,181,0,181,0,3,178
PEST,Örkény,003,942,313,0,313,0,0,313
PEST,Örkény,004,1018,328,0,328,0,2,326
PEST,Õrbottyán,001,824,359,0,359,0,1,358
PEST,Õrbottyán,002,950,419,0,419,0,0,419
PEST,Õrbottyán,003,799,369,0,369,0,4,365
PEST,Õrbottyán,004,825,380,0,380,0,1,379
PEST,Õrbottyán,005,789,355,0,355,0,1,354
PEST,Õrbottyán,006,787,354,0,354,0,3,351
PEST,Õrbottyán,007,944,400,0,400,0,2,398
PEST,Pánd,001,707,221,0,221,0,1,220
PEST,Pánd,002,799,182,0,182,0,2,180
PEST,Páty,001,978,452,0,452,0,1,451
PEST,Páty,002,1140,621,0,621,0,8,613
PEST,Páty,003,1297,658,1,659,1,16,643
PEST,Páty,004,1285,512,0,511,-1,1,510
PEST,Páty,005,1288,702,0,702,0,3,699
PEST,Penc,001,1223,520,0,520,0,1,519
PEST,Perbál,001,870,414,0,414,0,2,412
PEST,Perbál,002,784,358,0,358,0,0,358
PEST,Perõcsény,001,295,168,0,168,0,2,166
PEST,Pécel,001,835,393,0,392,-1,1,391
PEST,Pécel,002,797,391,0,391,0,0,391
PEST,Pécel,003,763,314,0,314,0,0,314
PEST,Pécel,004,823,413,0,412,-1,1,411
PEST,Pécel,005,842,265,0,265,0,2,263
PEST,Pécel,006,682,293,0,293,0,4,289
PEST,Pécel,007,877,371,1,369,-2,0,369
PEST,Pécel,008,844,487,0,487,0,4,483
PEST,Pécel,009,802,382,0,382,0,0,382
PEST,Pécel,010,812,384,0,384,0,5,379
PEST,Pécel,011,769,300,0,300,0,0,300
PEST,Pécel,012,861,372,0,371,-1,2,369
PEST,Pécel,013,775,325,0,324,-1,1,323
PEST,Pécel,014,731,307,0,307,0,3,304
PEST,Pécel,015,717,320,0,320,0,4,316
PEST,Pécel,016,809,286,0,286,0,0,286
PEST,Péteri,001,1075,406,0,406,0,1,405
PEST,Péteri,002,847,332,1,331,-1,1,330
PEST,Pilis,001,1178,294,0,294,0,0,294
PEST,Pilis,002,1183,433,0,433,0,3,430
PEST,Pilis,003,1058,428,0,428,0,2,426
PEST,Pilis,004,1181,500,0,499,-1,1,498
PEST,Pilis,005,1144,393,0,393,0,1,392
PEST,Pilis,006,1170,298,0,298,0,1,297
PEST,Pilis,007,1156,323,0,323,0,7,316
PEST,Pilis,008,680,199,0,199,0,1,198
PEST,Pilis,009,662,192,0,192,0,1,191
PEST,Pilisborosjenõ,001,1141,657,0,657,0,2,655
PEST,Pilisborosjenõ,002,1376,789,0,789,0,1,788
PEST,Pilisborosjenõ,003,490,215,0,215,0,0,215
PEST,Piliscsaba,001,1169,597,0,597,0,2,595
PEST,Piliscsaba,002,1116,362,0,362,0,0,362
PEST,Piliscsaba,003,974,569,0,568,-1,1,567
PEST,Piliscsaba,004,783,510,0,510,0,5,505
PEST,Piliscsaba,005,1223,688,0,689,1,10,679
PEST,Piliscsaba,006,922,584,0,584,0,1,583
PEST,Pilisjászfalu,001,1318,625,0,625,0,2,623
PEST,Pilisszántó,001,939,457,0,457,0,0,457
PEST,Pilisszántó,002,1193,536,0,536,0,1,535
PEST,Pilisszentiván,001,1189,645,0,645,0,3,642
PEST,Pilisszentiván,002,1245,688,0,688,0,4,684
PEST,Pilisszentiván,003,1067,550,0,550,0,5,545
PEST,Pilisszentkereszt,001,938,490,0,490,0,2,488
PEST,Pilisszentkereszt,002,817,408,0,408,0,1,407
PEST,Pilisszentlászló,001,933,410,0,410,0,3,407
PEST,Pilisvörösvár,001,1645,809,0,809,0,0,809
PEST,Pilisvörösvár,002,1477,556,0,556,0,4,552
PEST,Pilisvörösvár,003,1469,691,0,691,0,6,685
PEST,Pilisvörösvár,004,1375,682,0,682,0,4,678
PEST,Pilisvörösvár,005,1342,577,0,577,0,1,576
PEST,Pilisvörösvár,006,1452,701,0,701,0,4,697
PEST,Pilisvörösvár,007,1404,735,1,733,-2,1,732
PEST,Pilisvörösvár,008,1468,607,0,607,0,1,606
PEST,Pomáz,001,870,419,0,419,0,0,419
PEST,Pomáz,002,828,440,0,440,0,3,437
PEST,Pomáz,003,890,361,0,361,0,1,360
PEST,Pomáz,004,768,212,0,212,0,2,210
PEST,Pomáz,005,906,478,0,478,0,1,477
PEST,Pomáz,006,912,506,0,506,0,1,505
PEST,Pomáz,007,859,370,0,370,0,1,369
PEST,Pomáz,008,1229,718,0,717,-1,3,714
PEST,Pomáz,009,955,515,0,515,0,0,515
PEST,Pomáz,010,791,422,0,422,0,1,421
PEST,Pomáz,011,804,469,0,469,0,0,469
PEST,Pomáz,012,877,477,0,477,0,4,473
PEST,Pomáz,013,826,424,0,424,0,0,424
PEST,Pomáz,014,838,455,0,455,0,1,454
PEST,Pomáz,015,878,476,0,476,0,5,471
PEST,Pomáz,016,832,433,0,433,0,4,429
PEST,Pócsmegyer,001,1087,496,0,496,0,1,495
PEST,Pócsmegyer,002,970,501,0,501,0,5,496
PEST,Pusztavacs,001,1093,351,0,351,0,1,350
PEST,Pusztazámor,001,949,377,0,377,0,1,376
PEST,Püspökhatvan,001,1113,529,0,529,0,0,529
PEST,Püspökszilágy,001,569,280,0,280,0,0,280
PEST,Ráckeve,001,1090,593,0,592,-1,5,587
PEST,Ráckeve,002,1075,384,0,384,0,1,383
PEST,Ráckeve,003,986,404,0,404,0,2,402
PEST,Ráckeve,004,1058,453,0,453,0,0,453
PEST,Ráckeve,005,1013,288,0,288,0,2,286
PEST,Ráckeve,006,1034,225,0,225,0,0,225
PEST,Ráckeve,007,1076,489,0,489,0,1,488
PEST,Ráckeve,008,1139,478,0,478,0,1,477
PEST,Rád,001,1468,702,0,701,-1,2,699
PEST,Solymár,001,940,512,0,512,0,2,510
PEST,Solymár,002,1093,663,0,663,0,2,661
PEST,Solymár,003,1014,630,0,630,0,2,628
PEST,Solymár,004,1076,693,2,690,-3,2,688
PEST,Solymár,005,1299,732,0,732,0,2,730
PEST,Solymár,006,1132,713,0,712,-1,5,707
PEST,Solymár,007,1070,641,0,642,1,12,630
PEST,Solymár,008,959,497,0,497,0,3,494
PEST,Sóskút,001,1100,450,0,450,0,1,449
PEST,Sóskút,002,797,386,0,386,0,1,385
PEST,Sóskút,003,857,373,0,373,0,1,372
PEST,Sülysáp,001,855,322,0,322,0,4,318
PEST,Sülysáp,002,990,387,0,387,0,0,387
PEST,Sülysáp,003,907,386,0,386,0,1,385
PEST,Sülysáp,004,1142,493,0,493,0,3,490
PEST,Sülysáp,005,846,372,0,372,0,4,368
PEST,Sülysáp,006,943,396,0,396,0,4,392
PEST,Sülysáp,007,1051,354,0,354,0,1,353
PEST,Szada,001,1450,746,0,746,0,2,744
PEST,Szada,002,1369,644,0,645,1,11,634
PEST,Szada,003,1282,594,0,594,0,5,589
PEST,Százhalombatta,001,796,344,0,344,0,1,343
PEST,Százhalombatta,002,847,325,0,325,0,5,320
PEST,Százhalombatta,003,788,307,0,307,0,0,307
PEST,Százhalombatta,004,871,338,0,338,0,1,337
PEST,Százhalombatta,005,901,357,0,357,0,3,354
PEST,Százhalombatta,006,801,340,0,340,0,1,339
PEST,Százhalombatta,007,906,417,0,417,0,1,416
PEST,Százhalombatta,008,1100,545,0,545,0,1,544
PEST,Százhalombatta,009,1011,422,0,422,0,0,422
PEST,Százhalombatta,010,967,512,1,512,0,1,511
PEST,Százhalombatta,011,993,534,0,533,-1,1,532
PEST,Százhalombatta,012,1069,575,0,575,0,5,570
PEST,Százhalombatta,013,833,424,0,423,-1,1,422
PEST,Százhalombatta,014,865,504,0,503,-1,3,500
PEST,Százhalombatta,015,1113,527,0,527,0,1,526
PEST,Százhalombatta,016,1101,562,0,562,0,0,562
PEST,Szentendre,001,1029,635,0,635,0,2,633
PEST,Szentendre,002,1455,868,0,868,0,3,865
PEST,Szentendre,003,1020,463,1,462,-1,2,460
PEST,Szentendre,004,999,509,0,509,0,0,509
PEST,Szentendre,005,990,534,0,534,0,0,534
PEST,Szentendre,006,1018,620,0,620,0,3,617
PEST,Szentendre,007,1016,450,0,450,0,4,446
PEST,Szentendre,008,1053,580,0,580,0,0,580
PEST,Szentendre,009,1053,496,0,496,0,2,494
PEST,Szentendre,010,1075,576,0,576,0,4,572
PEST,Szentendre,011,1005,638,0,638,0,3,635
PEST,Szentendre,012,980,570,0,570,0,0,570
PEST,Szentendre,013,1035,601,0,601,0,0,601
PEST,Szentendre,014,1001,552,0,552,0,0,552
PEST,Szentendre,015,1057,555,0,555,0,0,555
PEST,Szentendre,016,1042,521,0,521,0,1,520
PEST,Szentendre,017,1104,601,0,599,-2,1,598
PEST,Szentendre,018,1229,633,0,633,0,2,631
PEST,Szentendre,019,1251,640,0,640,0,1,639
PEST,Szentendre,020,1164,555,0,555,0,1,554
PEST,Szentlõrinckáta,001,807,239,0,239,0,1,238
PEST,Szentlõrinckáta,002,745,213,0,213,0,2,211
PEST,Szentmártonkáta,001,974,287,0,287,0,0,287
PEST,Szentmártonkáta,002,941,341,0,341,0,3,338
PEST,Szentmártonkáta,003,1131,286,0,286,0,1,285
PEST,Szentmártonkáta,004,980,340,0,340,0,1,339
PEST,Szigetbecse,001,1129,502,0,502,0,4,498
PEST,Szigetcsép,001,1095,439,0,439,0,0,439
PEST,Szigetcsép,002,979,416,0,416,0,2,414
PEST,Szigethalom,001,765,284,0,284,0,3,281
PEST,Szigethalom,002,852,267,0,267,0,1,266
PEST,Szigethalom,003,900,358,0,358,0,0,358
PEST,Szigethalom,004,957,419,0,419,0,0,419
PEST,Szigethalom,005,832,295,0,295,0,0,295
PEST,Szigethalom,006,1001,340,0,340,0,2,338
PEST,Szigethalom,007,767,193,0,193,0,0,193
PEST,Szigethalom,008,778,250,0,250,0,1,249
PEST,Szigethalom,009,906,297,0,297,0,1,296
PEST,Szigethalom,010,916,383,0,383,0,0,383
PEST,Szigethalom,011,801,291,0,291,0,1,290
PEST,Szigethalom,012,856,319,0,319,0,1,318
PEST,Szigethalom,013,897,277,0,277,0,1,276
PEST,Szigethalom,014,1054,361,0,361,0,3,358
PEST,Szigethalom,015,951,274,0,274,0,0,274
PEST,Szigethalom,016,998,369,0,369,0,1,368
PEST,Szigetmonostor,001,1116,577,0,577,0,1,576
PEST,Szigetmonostor,002,1133,477,1,476,-1,4,472
PEST,Szigetszentmárton,001,935,393,0,393,0,0,393
PEST,Szigetszentmárton,002,1004,469,0,469,0,3,466
PEST,Szigetszentmiklós,001,998,403,0,403,0,0,403
PEST,Szigetszentmiklós,002,1094,469,0,469,0,0,469
PEST,Szigetszentmiklós,003,1005,321,0,321,0,4,317
PEST,Szigetszentmiklós,004,807,282,0,282,0,0,282
PEST,Szigetszentmiklós,005,1013,480,0,480,0,0,480
PEST,Szigetszentmiklós,006,936,428,0,428,0,0,428
PEST,Szigetszentmiklós,007,1010,356,0,356,0,1,355
PEST,Szigetszentmiklós,008,1016,506,0,506,0,3,503
PEST,Szigetszentmiklós,009,1402,492,0,491,-1,2,489
PEST,Szigetszentmiklós,010,989,320,0,320,0,2,318
PEST,Szigetszentmiklós,011,883,310,0,310,0,2,308
PEST,Szigetszentmiklós,012,657,243,0,242,-1,2,240
PEST,Szigetszentmiklós,013,969,425,0,425,0,2,423
PEST,Szigetszentmiklós,014,836,421,0,421,0,2,419
PEST,Szigetszentmiklós,015,982,399,0,399,0,3,396
PEST,Szigetszentmiklós,016,995,512,0,512,0,3,509
PEST,Szigetszentmiklós,017,769,353,0,353,0,1,352
PEST,Szigetszentmiklós,018,740,355,0,355,0,2,353
PEST,Szigetszentmiklós,019,918,424,0,424,0,1,423
PEST,Szigetszentmiklós,020,1124,543,0,543,0,2,541
PEST,Szigetszentmiklós,021,985,442,0,442,0,1,441
PEST,Szigetszentmiklós,022,941,367,0,367,0,0,367
PEST,Szigetszentmiklós,023,869,350,1,349,-1,13,336
PEST,Szigetszentmiklós,024,1231,627,0,627,0,3,624
PEST,Szigetszentmiklós,025,1097,462,0,462,0,0,462
PEST,Szigetszentmiklós,026,1227,367,0,367,0,1,366
PEST,Szigetszentmiklós,027,1258,416,0,416,0,6,410
PEST,Szigetszentmiklós,028,1072,512,0,512,0,1,511
PEST,Szigetszentmiklós,029,1106,412,0,411,-1,4,407
PEST,Szigetszentmiklós,030,1010,403,0,402,-1,3,399
PEST,Szigetújfalu,001,1046,453,0,453,0,3,450
PEST,Szigetújfalu,002,765,351,0,351,0,0,351
PEST,Szob,001,670,275,0,275,0,2,273
PEST,Szob,002,667,273,0,273,0,0,273
PEST,Szob,003,860,411,0,411,0,2,409
PEST,Szokolya,001,701,296,0,296,0,3,293
PEST,Szokolya,002,846,347,0,347,0,1,346
PEST,Szõd,001,1250,587,0,576,-11,3,573
PEST,Szõd,002,1160,482,0,482,0,4,478
PEST,Szõdliget,001,1047,579,0,579,0,3,576
PEST,Szõdliget,002,1087,542,0,541,-1,2,539
PEST,Szõdliget,003,812,388,0,388,0,2,386
PEST,Szõdliget,004,757,431,0,431,0,1,430
PEST,Tahitótfalu,001,1065,500,0,500,0,2,498
PEST,Tahitótfalu,002,1163,522,0,522,0,1,521
PEST,Tahitótfalu,003,1342,725,0,722,-3,0,722
PEST,Tahitótfalu,004,1307,627,0,627,0,1,626
PEST,Taksony,001,769,363,0,363,0,1,362
PEST,Taksony,002,1005,415,0,415,0,3,412
PEST,Taksony,003,794,372,0,372,0,0,372
PEST,Taksony,004,837,315,0,315,0,2,313
PEST,Taksony,005,905,391,0,391,0,4,387
PEST,Taksony,006,809,375,0,375,0,0,375
PEST,Tatárszentgyörgy,001,789,256,0,256,0,5,251
PEST,Tatárszentgyörgy,002,657,191,0,191,0,10,181
PEST,Táborfalva,001,978,327,0,327,0,0,327
PEST,Táborfalva,002,897,256,0,256,0,0,256
PEST,Táborfalva,003,876,244,0,244,0,0,244
PEST,Tápióbicske,001,874,329,0,329,0,3,326
PEST,Tápióbicske,002,924,346,0,346,0,2,344
PEST,Tápióbicske,003,989,250,0,250,0,2,248
PEST,Tápiógyörgye,001,601,177,0,177,0,2,175
PEST,Tápiógyörgye,002,834,266,0,266,0,3,263
PEST,Tápiógyörgye,003,617,214,0,214,0,2,212
PEST,Tápiógyörgye,004,653,180,0,180,0,0,180
PEST,Tápióság,001,544,154,0,154,0,0,154
PEST,Tápióság,002,883,327,0,327,0,0,327
PEST,Tápióság,003,830,289,0,289,0,3,286
PEST,Tápiószecsõ,001,792,269,0,268,-1,0,268
PEST,Tápiószecsõ,002,567,131,0,131,0,0,131
PEST,Tápiószecsõ,003,721,234,0,234,0,2,232
PEST,Tápiószecsõ,004,714,326,0,326,0,2,324
PEST,Tápiószecsõ,005,835,395,0,395,0,3,392
PEST,Tápiószecsõ,006,795,302,0,302,0,1,301
PEST,Tápiószecsõ,007,632,206,0,206,0,1,205
PEST,Tápiószele,001,868,260,0,260,0,1,259
PEST,Tápiószele,002,826,209,0,209,0,2,207
PEST,Tápiószele,003,694,210,0,210,0,2,208
PEST,Tápiószele,004,850,194,0,194,0,2,192
PEST,Tápiószele,005,862,232,0,232,0,3,229
PEST,Tápiószele,006,747,272,0,272,0,2,270
PEST,Tápiószentmárton,001,991,450,0,450,0,0,450
PEST,Tápiószentmárton,002,932,458,0,458,0,5,453
PEST,Tápiószentmárton,003,970,455,0,455,0,0,455
PEST,Tápiószentmárton,004,1200,325,0,325,0,3,322
PEST,Tápiószentmárton,005,429,140,2,138,-2,4,134
PEST,Tápiószõlõs,001,615,155,1,154,-1,0,154
PEST,Tápiószõlõs,002,579,192,0,192,0,4,188
PEST,Tápiószõlõs,003,634,211,0,211,0,0,211
PEST,Tápiószõlõs,004,620,211,0,211,0,0,211
PEST,Tárnok,001,1215,456,0,456,0,1,455
PEST,Tárnok,002,949,445,0,447,2,18,429
PEST,Tárnok,003,1259,628,0,628,0,1,627
PEST,Tárnok,004,1207,462,0,462,0,0,462
PEST,Tárnok,005,1106,477,0,477,0,5,472
PEST,Tárnok,006,1069,518,0,518,0,1,517
PEST,Tárnok,007,1087,511,0,510,-1,1,509
PEST,Telki,001,856,581,0,581,0,1,580
PEST,Telki,002,763,458,0,458,0,3,455
PEST,Telki,003,627,385,0,385,0,2,383
PEST,Telki,004,709,470,0,469,-1,2,467
PEST,Tésa,001,79,49,0,49,0,0,49
PEST,Tinnye,001,1379,603,0,603,0,2,601
PEST,Tóalmás,001,976,305,0,305,0,1,304
PEST,Tóalmás,002,969,358,0,358,0,1,357
PEST,Tóalmás,003,996,306,0,306,0,2,304
PEST,Tök,001,1082,529,0,529,0,0,529
PEST,Tököl,001,820,267,0,267,0,1,266
PEST,Tököl,002,830,281,0,281,0,1,280
PEST,Tököl,003,1113,450,0,450,0,4,446
PEST,Tököl,004,1227,506,0,505,-1,2,503
PEST,Tököl,005,1076,393,0,393,0,0,393
PEST,Tököl,006,1131,493,0,493,0,1,492
PEST,Tököl,007,1163,452,0,452,0,0,452
PEST,Tököl,008,975,350,0,350,0,1,349
PEST,Törökbálint,001,650,323,0,323,0,1,322
PEST,Törökbálint,002,576,277,0,277,0,0,277
PEST,Törökbálint,003,816,427,0,427,0,2,425
PEST,Törökbálint,004,655,310,0,310,0,1,309
PEST,Törökbálint,005,672,370,0,370,0,0,370
PEST,Törökbálint,006,677,398,0,398,0,1,397
PEST,Törökbálint,007,587,259,0,259,0,0,259
PEST,Törökbálint,008,621,353,0,352,-1,1,351
PEST,Törökbálint,009,720,438,0,437,-1,1,436
PEST,Törökbálint,010,841,505,0,505,0,1,504
PEST,Törökbálint,011,757,259,0,259,0,0,259
PEST,Törökbálint,012,752,298,0,298,0,2,296
PEST,Törökbálint,013,604,345,1,344,-1,2,342
PEST,Törökbálint,014,588,268,0,268,0,0,268
PEST,Törökbálint,015,677,313,0,313,0,2,311
PEST,Törökbálint,016,669,381,0,381,0,1,380
PEST,Törtel,001,880,249,0,249,0,9,240
PEST,Törtel,002,840,313,0,313,0,0,313
PEST,Törtel,003,844,245,0,245,0,3,242
PEST,Törtel,004,741,238,0,238,0,0,238
PEST,Tura,001,743,375,0,375,0,0,375
PEST,Tura,002,1019,139,0,139,0,1,138
PEST,Tura,003,952,363,0,363,0,1,362
PEST,Tura,004,659,209,0,209,0,3,206
PEST,Tura,005,720,294,0,294,0,2,292
PEST,Tura,006,701,312,0,312,0,1,311
PEST,Tura,007,617,288,0,288,0,0,288
PEST,Tura,008,758,296,0,296,0,1,295
PEST,Újhartyán,001,692,333,0,333,0,0,333
PEST,Újhartyán,002,760,361,0,361,0,0,361
PEST,Újhartyán,003,799,369,0,369,0,0,369
PEST,Újlengyel,001,717,267,0,267,0,1,266
PEST,Újlengyel,002,719,306,0,306,0,4,302
PEST,Újszilvás,001,680,226,0,226,0,2,224
PEST,Újszilvás,002,735,282,0,282,0,1,281
PEST,Újszilvás,003,737,182,0,182,0,1,181
PEST,Úri,001,1046,428,0,428,0,1,427
PEST,Úri,002,1056,428,0,428,0,3,425
PEST,Üllõ,001,1181,481,0,480,-1,1,479
PEST,Üllõ,002,1304,527,0,527,0,2,525
PEST,Üllõ,003,1062,340,0,340,0,2,338
PEST,Üllõ,004,1028,286,0,286,0,0,286
PEST,Üllõ,005,1033,344,0,344,0,0,344
PEST,Üllõ,006,1215,514,0,514,0,0,514
PEST,Üllõ,007,1140,475,0,474,-1,0,474
PEST,Üllõ,008,1498,567,0,567,0,2,565
PEST,Üröm,001,1049,612,0,612,0,5,607
PEST,Üröm,002,1224,631,0,631,0,3,628
PEST,Üröm,003,1048,577,0,577,0,1,576
PEST,Üröm,004,1377,754,0,751,-3,3,748
PEST,Üröm,005,1161,655,0,655,0,0,655
PEST,Valkó,001,1060,330,0,330,0,6,324
PEST,Valkó,002,871,256,0,256,0,0,256
PEST,Vasad,001,780,329,0,329,0,2,327
PEST,Vasad,002,774,266,0,266,0,2,264
PEST,Vác,001,892,327,0,327,0,0,327
PEST,Vác,002,1194,578,0,578,0,0,578
PEST,Vác,003,692,357,0,357,0,1,356
PEST,Vác,004,1028,482,0,482,0,1,481
PEST,Vác,005,945,488,0,488,0,2,486
PEST,Vác,006,891,471,0,471,0,2,469
PEST,Vác,007,767,398,0,398,0,5,393
PEST,Vác,008,816,464,0,464,0,1,463
PEST,Vác,009,840,440,0,440,0,1,439
PEST,Vác,010,894,479,0,479,0,2,477
PEST,Vác,011,1316,761,0,761,0,6,755
PEST,Vác,012,663,377,0,377,0,2,375
PEST,Vác,013,682,299,0,299,0,0,299
PEST,Vác,014,813,373,0,373,0,0,373
PEST,Vác,015,1018,480,0,480,0,9,471
PEST,Vác,016,659,280,0,280,0,1,279
PEST,Vác,017,778,332,0,332,0,2,330
PEST,Vác,018,977,311,0,311,0,2,309
PEST,Vác,019,593,354,0,354,0,1,353
PEST,Vác,020,951,547,0,547,0,0,547
PEST,Vác,021,1015,536,0,536,0,5,531
PEST,Vác,022,645,341,0,341,0,0,341
PEST,Vác,023,970,524,0,524,0,2,522
PEST,Vác,024,1163,558,0,558,0,1,557
PEST,Vác,025,1095,544,0,544,0,3,541
PEST,Vác,026,655,318,0,318,0,3,315
PEST,Vác,027,840,335,0,335,0,0,335
PEST,Vác,028,882,485,0,485,0,1,484
PEST,Vác,029,1155,480,0,480,0,3,477
PEST,Vác,030,1249,697,0,697,0,2,695
PEST,Vácduka,001,1213,555,0,554,-1,1,553
PEST,Vácegres,001,715,258,0,258,0,1,257
PEST,Váchartyán,001,736,331,0,331,0,1,330
PEST,Váchartyán,002,761,333,0,333,0,0,333
PEST,Váckisújfalu,001,392,185,0,185,0,1,184
PEST,Vácrátót,001,690,332,0,332,0,4,328
PEST,Vácrátót,002,805,386,0,386,0,0,386
PEST,Vácszentlászló,001,882,314,0,314,0,2,312
PEST,Vácszentlászló,002,844,319,0,319,0,1,318
PEST,Vámosmikola,001,614,256,0,256,0,1,255
PEST,Vámosmikola,002,588,237,0,237,0,5,232
PEST,Vecsés,001,574,275,0,275,0,0,275
PEST,Vecsés,002,585,267,0,267,0,1,266
PEST,Vecsés,003,620,305,0,305,0,0,305
PEST,Vecsés,004,603,279,0,279,0,0,279
PEST,Vecsés,005,813,473,0,473,0,2,471
PEST,Vecsés,006,675,318,0,318,0,2,316
PEST,Vecsés,007,670,247,0,247,0,2,245
PEST,Vecsés,008,598,224,0,224,0,0,224
PEST,Vecsés,009,607,231,0,231,0,2,229
PEST,Vecsés,010,627,232,0,232,0,2,230
PEST,Vecsés,011,625,268,0,268,0,1,267
PEST,Vecsés,012,725,302,0,302,0,2,300
PEST,Vecsés,013,738,286,0,286,0,0,286
PEST,Vecsés,014,762,301,0,301,0,0,301
PEST,Vecsés,015,797,369,0,369,0,4,365
PEST,Vecsés,016,614,282,0,282,0,1,281
PEST,Vecsés,017,662,269,0,269,0,1,268
PEST,Vecsés,018,624,281,0,281,0,4,277
PEST,Vecsés,019,734,295,0,295,0,0,295
PEST,Vecsés,020,712,310,0,309,-1,1,308
PEST,Vecsés,021,798,268,0,268,0,0,268
PEST,Vecsés,022,874,319,0,319,0,1,318
PEST,Vecsés,023,792,309,0,309,0,1,308
PEST,Vecsés,024,818,318,0,318,0,0,318
PEST,Veresegyház,001,965,446,0,446,0,0,446
PEST,Veresegyház,002,841,411,0,411,0,1,410
PEST,Veresegyház,003,1182,567,0,567,0,5,562
PEST,Veresegyház,004,973,399,0,399,0,0,399
PEST,Veresegyház,005,789,342,0,342,0,1,341
PEST,Veresegyház,006,816,381,0,381,0,2,379
PEST,Veresegyház,007,884,505,0,505,0,0,505
PEST,Veresegyház,008,899,437,0,437,0,2,435
PEST,Veresegyház,009,934,443,0,443,0,1,442
PEST,Veresegyház,010,1007,530,0,530,0,2,528
PEST,Veresegyház,011,858,466,0,466,0,1,465
PEST,Veresegyház,012,878,453,0,453,0,2,451
PEST,Veresegyház,013,780,387,0,387,0,0,387
PEST,Veresegyház,014,972,434,0,434,0,0,434
PEST,Veresegyház,015,833,372,1,371,-1,0,371
PEST,Veresegyház,016,821,339,0,339,0,1,338
PEST,Verõce,001,946,541,0,541,0,2,539
PEST,Verõce,002,1085,577,0,577,0,5,572
PEST,Verõce,003,971,501,0,501,0,2,499
PEST,Verseg,001,1086,385,0,385,0,1,384
PEST,Visegrád,001,891,565,0,563,-2,6,557
PEST,Visegrád,002,653,312,0,312,0,1,311
PEST,Zebegény,001,1047,597,0,597,0,5,592
PEST,Zsámbék,001,1154,645,0,645,0,4,641
PEST,Zsámbék,002,1203,543,0,542,-1,0,542
PEST,Zsámbék,003,920,434,0,433,-1,2,431
PEST,Zsámbék,004,995,494,2,492,-2,6,486
PEST,Zsámbok,001,969,404,0,404,0,0,404
PEST,Zsámbok,002,1036,361,0,361,0,2,359
PEST,Csörög,001,868,246,0,246,0,1,245
PEST,Csörög,002,757,299,0,299,0,1,298
PEST,Remeteszõlõs,001,742,497,0,497,0,1,496
PEST,Monorierdõ,001,1094,397,0,397,0,0,397
PEST,Monorierdõ,002,776,289,0,289,0,2,287
PEST,Monorierdõ,003,952,316,0,316,0,6,310
PEST,Monorierdõ,004,950,277,0,277,0,2,275
SOMOGY,Alsóbogát,001,204,84,0,84,0,1,83
SOMOGY,Andocs,001,711,262,0,262,0,2,260
SOMOGY,Andocs,002,89,40,0,40,0,0,40
SOMOGY,Ádánd,001,773,279,0,279,0,1,278
SOMOGY,Ádánd,002,972,314,0,314,0,3,311
SOMOGY,Babócsa,001,640,193,0,193,0,0,193
SOMOGY,Babócsa,002,565,151,0,151,0,1,150
SOMOGY,Bakháza,001,154,49,0,49,0,0,49
SOMOGY,Balatonberény,001,935,505,0,505,0,3,502
SOMOGY,Balatonboglár,001,1160,671,0,670,-1,0,670
SOMOGY,Balatonboglár,002,778,323,0,323,0,1,322
SOMOGY,Balatonboglár,003,833,405,0,405,0,2,403
SOMOGY,Balatonboglár,004,851,381,0,381,0,1,380
SOMOGY,Balatonboglár,005,783,389,0,389,0,0,389
SOMOGY,Balatonboglár,006,574,225,0,225,0,0,225
SOMOGY,Balatonendréd,001,1111,429,0,429,0,0,429
SOMOGY,Balatonfenyves,001,1037,618,0,616,-2,1,615
SOMOGY,Balatonfenyves,002,856,372,0,372,0,1,371
SOMOGY,Balatonfenyves,003,106,47,0,47,0,0,47
SOMOGY,Balatonföldvár,001,1081,666,0,665,-1,2,663
SOMOGY,Balatonföldvár,002,1011,542,0,542,0,1,541
SOMOGY,Balatonkeresztúr,001,683,325,0,325,0,3,322
SOMOGY,Balatonkeresztúr,002,720,320,0,320,0,0,320
SOMOGY,Balatonlelle,001,847,318,0,318,0,0,318
SOMOGY,Balatonlelle,002,1081,600,0,600,0,3,597
SOMOGY,Balatonlelle,003,738,346,1,345,-1,1,344
SOMOGY,Balatonlelle,004,698,319,0,319,0,0,319
SOMOGY,Balatonlelle,005,850,365,0,365,0,3,362
SOMOGY,Balatonmáriafürdõ,001,710,398,1,397,-1,4,393
SOMOGY,Balatonõszöd,001,448,224,0,224,0,1,223
SOMOGY,Balatonszabadi,001,703,354,0,354,0,0,354
SOMOGY,Balatonszabadi,002,568,197,0,197,0,1,196
SOMOGY,Balatonszabadi,003,515,177,0,177,0,0,177
SOMOGY,Balatonszabadi,004,578,246,0,246,0,1,245
SOMOGY,Balatonszárszó,001,1081,664,0,664,0,3,661
SOMOGY,Balatonszárszó,002,897,401,0,401,0,0,401
SOMOGY,Balatonszemes,001,879,461,0,461,0,2,459
SOMOGY,Balatonszemes,002,703,407,0,407,0,1,406
SOMOGY,Balatonszentgyörgy,001,667,327,0,327,0,1,326
SOMOGY,Balatonszentgyörgy,002,636,282,0,282,0,1,281
SOMOGY,Balatonújlak,001,421,206,0,206,0,0,206
SOMOGY,Barcs,001,1021,382,0,382,0,0,382
SOMOGY,Barcs,002,960,439,0,439,0,5,434
SOMOGY,Barcs,003,555,246,0,246,0,1,245
SOMOGY,Barcs,004,1152,266,0,266,0,4,262
SOMOGY,Barcs,005,1061,362,0,362,0,0,362
SOMOGY,Barcs,006,1125,521,0,521,0,5,516
SOMOGY,Barcs,007,1079,410,0,410,0,4,406
SOMOGY,Barcs,008,1101,416,0,416,0,1,415
SOMOGY,Barcs,009,519,207,0,207,0,0,207
SOMOGY,Barcs,010,252,91,0,91,0,0,91
SOMOGY,Baté,001,640,235,0,235,0,2,233
SOMOGY,Bábonymegyer,001,624,176,0,176,0,2,174
SOMOGY,Bálványos,001,486,153,0,153,0,0,153
SOMOGY,Bárdudvarnok,001,928,339,0,339,0,5,334
SOMOGY,Bedegkér,001,302,91,0,91,0,2,89
SOMOGY,Beleg,001,451,130,0,130,0,2,128
SOMOGY,Berzence,001,848,345,0,345,0,1,344
SOMOGY,Berzence,002,1058,349,0,349,0,0,349
SOMOGY,Bélavár,001,285,120,0,120,0,0,120
SOMOGY,Bodrog,001,307,134,0,134,0,2,132
SOMOGY,Bolhás,001,349,119,0,119,0,0,119
SOMOGY,Bolhó,001,544,147,0,147,0,1,146
SOMOGY,Bonnya,001,208,77,0,77,0,0,77
SOMOGY,Böhönye,001,902,292,0,292,0,2,290
SOMOGY,Böhönye,002,912,322,0,322,0,2,320
SOMOGY,Bõszénfa,001,407,183,0,183,0,0,183
SOMOGY,Buzsák,001,629,242,0,242,0,1,241
SOMOGY,Buzsák,002,407,155,0,155,0,2,153
SOMOGY,Büssü,001,220,45,0,45,0,0,45
SOMOGY,Csákány,001,192,46,0,46,0,0,46
SOMOGY,Cserénfa,001,171,93,0,93,0,0,93
SOMOGY,Csokonyavisonta,001,608,214,0,213,-1,0,213
SOMOGY,Csokonyavisonta,002,614,186,0,186,0,1,185
SOMOGY,Csoma,001,367,180,0,180,0,0,180
SOMOGY,Csombárd,001,209,76,0,76,0,1,75
SOMOGY,Csököly,001,781,226,0,226,0,2,224
SOMOGY,Csömend,001,220,98,0,98,0,1,97
SOMOGY,Csurgó,001,580,209,0,209,0,0,209
SOMOGY,Csurgó,002,716,241,0,241,0,2,239
SOMOGY,Csurgó,003,788,313,0,313,0,1,312
SOMOGY,Csurgó,004,802,339,0,339,0,1,338
SOMOGY,Csurgó,005,618,280,0,280,0,2,278
SOMOGY,Csurgó,006,554,225,0,225,0,0,225
SOMOGY,Csurgónagymarton,001,129,52,0,52,0,0,52
SOMOGY,Darány,001,702,246,0,246,0,2,244
SOMOGY,Drávagárdony,001,110,53,0,53,0,2,51
SOMOGY,Drávatamási,001,194,94,0,94,0,0,94
SOMOGY,Ecseny,001,149,88,0,88,0,0,88
SOMOGY,Edde,001,147,58,0,58,0,0,58
SOMOGY,Felsõmocsolád,001,296,116,0,116,0,0,116
SOMOGY,Fiad,001,104,45,0,45,0,0,45
SOMOGY,Fonó,001,244,90,0,90,0,0,90
SOMOGY,Fonyód,001,1287,736,0,735,-1,2,733
SOMOGY,Fonyód,002,1067,544,0,544,0,2,542
SOMOGY,Fonyód,003,1087,522,0,522,0,2,520
SOMOGY,Fonyód,004,1036,401,0,401,0,3,398
SOMOGY,Fõnyed,001,61,30,0,30,0,0,30
SOMOGY,Gadács,001,76,42,0,42,0,0,42
SOMOGY,Gadány,001,275,96,0,96,0,2,94
SOMOGY,Gamás,001,473,170,0,170,0,1,169
SOMOGY,Gamás,002,90,27,0,27,0,0,27
SOMOGY,Gálosfa,001,188,81,0,81,0,0,81
SOMOGY,Gige,001,276,81,0,81,0,2,79
SOMOGY,Gölle,001,615,202,0,202,0,1,201
SOMOGY,Gölle,002,82,27,0,27,0,0,27
SOMOGY,Görgeteg,001,393,117,0,117,0,1,116
SOMOGY,Görgeteg,002,494,111,0,111,0,0,111
SOMOGY,Gyékényes,001,809,320,0,320,0,1,319
SOMOGY,Gyugy,001,234,96,0,96,0,1,95
SOMOGY,Hajmás,001,175,61,0,61,0,0,61
SOMOGY,Hács,001,292,99,0,99,0,1,98
SOMOGY,Háromfa,001,570,187,0,187,0,3,184
SOMOGY,Hedrehely,001,308,85,0,85,0,1,84
SOMOGY,Hencse,001,284,99,0,99,0,1,98
SOMOGY,Heresznye,001,205,72,0,72,0,0,72
SOMOGY,Hetes,001,950,395,0,395,0,2,393
SOMOGY,Hollád,001,192,76,0,76,0,1,75
SOMOGY,Homokszentgyörgy,001,865,200,0,200,0,0,200
SOMOGY,Hosszúvíz,001,38,18,0,18,0,0,18
SOMOGY,Igal,001,1073,446,0,446,0,2,444
SOMOGY,Iharos,001,377,131,0,131,0,0,131
SOMOGY,Iharosberény,001,979,297,0,297,0,1,296
SOMOGY,Inke,001,974,242,0,242,0,3,239
SOMOGY,Istvándi,001,378,98,1,98,0,0,98
SOMOGY,Jákó,001,498,189,0,189,0,1,188
SOMOGY,Juta,001,973,422,0,422,0,2,420
SOMOGY,Kadarkút,001,670,213,0,212,-1,3,209
SOMOGY,Kadarkút,002,648,192,0,192,0,2,190
SOMOGY,Kadarkút,003,705,227,0,227,0,1,226
SOMOGY,Kapoly,001,528,171,0,171,0,0,171
SOMOGY,Kaposfõ,001,676,276,0,276,0,3,273
SOMOGY,Kaposfõ,002,628,198,0,198,0,3,195
SOMOGY,Kaposgyarmat,001,84,47,0,47,0,0,47
SOMOGY,Kaposhomok,001,352,122,0,122,0,0,122
SOMOGY,Kaposkeresztúr,001,244,58,0,58,0,0,58
SOMOGY,Kaposmérõ,001,682,254,0,254,0,0,254
SOMOGY,Kaposmérõ,002,636,233,0,233,0,4,229
SOMOGY,Kaposmérõ,003,628,278,0,278,0,4,274
SOMOGY,Kaposszerdahely,001,841,354,0,354,0,6,348
SOMOGY,Kaposújlak,001,578,263,0,263,0,0,263
SOMOGY,Kaposvár,001,1031,431,0,431,0,2,429
SOMOGY,Kaposvár,002,686,307,0,307,0,1,306
SOMOGY,Kaposvár,003,830,292,0,292,0,0,292
SOMOGY,Kaposvár,004,664,272,0,272,0,2,270
SOMOGY,Kaposvár,005,954,411,0,411,0,0,411
SOMOGY,Kaposvár,006,1020,491,0,491,0,1,490
SOMOGY,Kaposvár,007,1011,455,0,454,-1,0,454
SOMOGY,Kaposvár,008,860,309,0,309,0,2,307
SOMOGY,Kaposvár,009,761,269,0,269,0,0,269
SOMOGY,Kaposvár,010,602,275,0,275,0,0,275
SOMOGY,Kaposvár,011,685,312,0,312,0,0,312
SOMOGY,Kaposvár,012,909,423,0,423,0,0,423
SOMOGY,Kaposvár,013,737,290,0,290,0,0,290
SOMOGY,Kaposvár,014,611,282,1,282,0,2,280
SOMOGY,Kaposvár,015,789,364,0,364,0,6,358
SOMOGY,Kaposvár,016,1144,508,0,508,0,2,506
SOMOGY,Kaposvár,017,1069,567,1,566,-1,2,564
SOMOGY,Kaposvár,018,756,334,0,334,0,1,333
SOMOGY,Kaposvár,019,595,216,0,216,0,2,214
SOMOGY,Kaposvár,020,739,285,0,285,0,0,285
SOMOGY,Kaposvár,021,1037,479,0,479,0,5,474
SOMOGY,Kaposvár,022,1060,433,0,433,0,3,430
SOMOGY,Kaposvár,023,1106,547,0,547,0,1,546
SOMOGY,Kaposvár,024,1323,499,0,497,-2,9,488
SOMOGY,Kaposvár,025,717,308,0,308,0,1,307
SOMOGY,Kaposvár,026,770,361,0,361,0,2,359
SOMOGY,Kaposvár,027,739,281,0,281,0,0,281
SOMOGY,Kaposvár,028,690,290,0,290,0,1,289
SOMOGY,Kaposvár,029,767,298,0,296,-2,0,296
SOMOGY,Kaposvár,030,1122,496,0,496,0,2,494
SOMOGY,Kaposvár,031,995,417,0,417,0,1,416
SOMOGY,Kaposvár,032,785,277,0,277,0,0,277
SOMOGY,Kaposvár,033,877,377,0,377,0,1,376
SOMOGY,Kaposvár,034,750,396,0,396,0,1,395
SOMOGY,Kaposvár,035,758,394,0,394,0,3,391
SOMOGY,Kaposvár,036,1143,572,0,570,-2,1,569
SOMOGY,Kaposvár,037,911,421,0,420,-1,0,420
SOMOGY,Kaposvár,038,929,436,0,436,0,2,434
SOMOGY,Kaposvár,039,1095,470,0,470,0,0,470
SOMOGY,Kaposvár,040,821,444,0,444,0,3,441
SOMOGY,Kaposvár,041,884,441,0,441,0,3,438
SOMOGY,Kaposvár,042,838,469,0,469,0,3,466
SOMOGY,Kaposvár,043,864,490,1,489,-1,3,486
SOMOGY,Kaposvár,044,815,449,0,449,0,3,446
SOMOGY,Kaposvár,045,865,414,1,412,-2,2,410
SOMOGY,Kaposvár,046,794,394,0,394,0,0,394
SOMOGY,Kaposvár,047,668,363,0,359,-4,8,351
SOMOGY,Kaposvár,048,611,328,0,327,-1,0,327
SOMOGY,Kaposvár,049,682,364,0,364,0,1,363
SOMOGY,Kaposvár,050,937,441,0,441,0,4,437
SOMOGY,Kaposvár,051,819,274,0,274,0,3,271
SOMOGY,Kaposvár,052,1228,570,0,570,0,1,569
SOMOGY,Kaposvár,053,631,265,0,265,0,1,264
SOMOGY,Kaposvár,054,1034,318,0,317,-1,9,308
SOMOGY,Kaposvár,055,933,184,0,184,0,4,180
SOMOGY,Kaposvár,056,737,327,0,327,0,2,325
SOMOGY,Kaposvár,057,1082,474,0,474,0,0,474
SOMOGY,Kaposvár,058,876,341,0,341,0,1,340
SOMOGY,Kaposvár,059,1047,580,0,579,-1,2,577
SOMOGY,Karád,001,565,249,0,249,0,1,248
SOMOGY,Karád,002,622,213,0,213,0,0,213
SOMOGY,Kastélyosdombó,001,178,61,0,61,0,1,60
SOMOGY,Kaszó,001,89,56,0,56,0,0,56
SOMOGY,Kazsok,001,226,87,0,87,0,3,84
SOMOGY,Kálmáncsa,001,457,131,0,131,0,1,130
SOMOGY,Kánya,001,347,116,0,116,0,0,116
SOMOGY,Kára,001,43,25,0,25,0,1,24
SOMOGY,Kelevíz,001,260,102,0,102,0,1,101
SOMOGY,Kercseliget,001,287,92,0,92,0,0,92
SOMOGY,Kereki,001,447,172,0,172,0,0,172
SOMOGY,Kéthely,001,588,191,0,191,0,0,191
SOMOGY,Kéthely,002,507,218,0,218,0,1,217
SOMOGY,Kéthely,003,613,244,0,244,0,2,242
SOMOGY,Kisasszond,001,143,49,0,49,0,0,49
SOMOGY,Kisbajom,001,303,89,0,89,0,2,87
SOMOGY,Kisbárapáti,001,308,117,0,117,0,4,113
SOMOGY,Kisberény,001,120,41,0,41,0,0,41
SOMOGY,Kisgyalán,001,185,77,0,77,0,0,77
SOMOGY,Kiskorpád,001,706,219,0,219,0,0,219
SOMOGY,Komlósd,001,148,73,0,73,0,1,72
SOMOGY,Kötcse,001,419,164,0,164,0,2,162
SOMOGY,Kõkút,001,277,67,0,67,0,3,64
SOMOGY,Kõkút,002,131,32,0,32,0,1,31
SOMOGY,Kõröshegy,001,1234,543,0,543,0,2,541
SOMOGY,Kutas,001,520,183,0,183,0,2,181
SOMOGY,Kutas,002,575,166,0,166,0,0,166
SOMOGY,Lad,001,477,168,0,168,0,0,168
SOMOGY,Lakócsa,001,440,92,0,92,0,0,92
SOMOGY,Lábod,001,808,222,0,222,0,0,222
SOMOGY,Lábod,002,701,261,0,261,0,2,259
SOMOGY,Látrány,001,542,215,0,215,0,0,215
SOMOGY,Látrány,002,623,228,1,227,-1,1,226
SOMOGY,Lengyeltóti,001,788,317,0,317,0,0,317
SOMOGY,Lengyeltóti,002,751,236,0,236,0,0,236
SOMOGY,Lengyeltóti,003,841,212,0,212,0,4,208
SOMOGY,Libickozma,001,29,20,0,20,0,0,20
SOMOGY,Lulla,001,185,75,0,75,0,0,75
SOMOGY,Magyaratád,001,530,209,0,209,0,2,207
SOMOGY,Magyaratád,002,153,77,0,77,0,0,77
SOMOGY,Magyaregres,001,484,188,0,188,0,1,187
SOMOGY,Marcali,001,1000,332,0,332,0,1,331
SOMOGY,Marcali,002,176,67,0,67,0,0,67
SOMOGY,Marcali,003,907,395,0,395,0,2,393
SOMOGY,Marcali,004,1171,438,0,438,0,1,437
SOMOGY,Marcali,005,1143,498,0,498,0,3,495
SOMOGY,Marcali,006,1087,461,0,461,0,2,459
SOMOGY,Marcali,007,1157,411,0,411,0,2,409
SOMOGY,Marcali,008,854,362,0,362,0,1,361
SOMOGY,Marcali,009,1115,398,0,398,0,2,396
SOMOGY,Marcali,010,385,156,0,156,0,2,154
SOMOGY,Marcali,011,75,36,0,36,0,0,36
SOMOGY,Marcali,012,283,85,0,85,0,0,85
SOMOGY,Mernye,001,513,237,0,237,0,1,236
SOMOGY,Mernye,002,452,151,0,151,0,1,150
SOMOGY,Mernye,003,112,38,0,38,0,0,38
SOMOGY,Mesztegnyõ,001,594,205,0,205,0,1,204
SOMOGY,Mesztegnyõ,002,413,201,0,201,0,1,200
SOMOGY,Mezõcsokonya,001,948,223,0,223,0,0,223
SOMOGY,Mike,001,480,127,0,127,0,4,123
SOMOGY,Miklósi,001,167,78,0,78,0,1,77
SOMOGY,Mosdós,001,754,278,0,278,0,3,275
SOMOGY,Nagyatád,001,217,71,0,71,0,0,71
SOMOGY,Nagyatád,002,1046,469,0,469,0,2,467
SOMOGY,Nagyatád,003,1081,457,0,457,0,2,455
SOMOGY,Nagyatád,004,1236,509,0,509,0,4,505
SOMOGY,Nagyatád,005,1065,499,0,498,-1,2,496
SOMOGY,Nagyatád,006,1108,494,0,494,0,4,490
SOMOGY,Nagyatád,007,1128,425,0,425,0,0,425
SOMOGY,Nagyatád,008,1050,433,0,433,0,1,432
SOMOGY,Nagyatád,009,896,305,0,305,0,0,305
SOMOGY,Nagybajom,001,862,259,0,259,0,6,253
SOMOGY,Nagybajom,002,814,215,0,215,0,2,213
SOMOGY,Nagybajom,003,796,166,0,166,0,2,164
SOMOGY,Nagyberény,001,1106,310,0,310,0,4,306
SOMOGY,Nagyberki,001,1131,387,0,387,0,0,387
SOMOGY,Nagycsepely,001,286,148,0,148,0,4,144
SOMOGY,Nagykorpád,001,414,136,0,136,0,0,136
SOMOGY,Nagyszakácsi,001,319,104,0,104,0,0,104
SOMOGY,Nágocs,001,486,153,0,153,0,0,153
SOMOGY,Nemesdéd,001,505,117,0,117,0,1,116
SOMOGY,Nemeskisfalud,001,79,40,0,40,0,1,39
SOMOGY,Nemesvid,001,501,163,0,163,0,2,161
SOMOGY,Nikla,001,528,200,0,200,0,1,199
SOMOGY,Nyim,001,270,105,0,105,0,1,104
SOMOGY,Orci,001,441,197,0,197,0,0,197
SOMOGY,Ordacsehi,001,662,264,0,264,0,2,262
SOMOGY,Osztopán,001,585,207,0,207,0,3,204
SOMOGY,Öreglak,001,558,161,0,160,-1,3,157
SOMOGY,Öreglak,002,583,174,0,174,0,1,173
SOMOGY,Ötvöskónyi,001,639,160,0,160,0,1,159
SOMOGY,Õrtilos,001,98,30,0,30,0,0,30
SOMOGY,Õrtilos,002,298,133,0,133,0,0,133
SOMOGY,Pamuk,001,199,80,0,80,0,0,80
SOMOGY,Patalom,001,255,129,0,129,0,4,125
SOMOGY,Patca,001,50,25,0,25,0,0,25
SOMOGY,Patosfa,001,202,64,0,64,0,2,62
SOMOGY,Pálmajor,001,216,73,0,73,0,0,73
SOMOGY,Péterhida,001,130,56,0,55,-1,1,54
SOMOGY,Pogányszentpéter,001,389,116,0,116,0,0,116
SOMOGY,Polány,001,171,74,0,74,0,0,74
SOMOGY,Porrog,001,158,84,0,84,0,1,83
SOMOGY,Porrogszentkirály,001,220,83,0,83,0,0,83
SOMOGY,Porrogszentpál,001,73,35,0,35,0,0,35
SOMOGY,Potony,001,155,55,0,55,0,0,55
SOMOGY,Pusztakovácsi,001,461,173,0,173,0,0,173
SOMOGY,Pusztakovácsi,002,114,34,0,34,0,0,34
SOMOGY,Pusztaszemes,001,318,130,0,130,0,2,128
SOMOGY,Ráksi,001,375,146,0,146,0,1,145
SOMOGY,Rinyabesenyõ,001,144,40,0,40,0,2,38
SOMOGY,Rinyakovácsi,001,123,61,1,60,-1,0,60
SOMOGY,Rinyaszentkirály,001,310,64,0,64,0,1,63
SOMOGY,Rinyaújlak,001,237,68,1,67,-1,0,67
SOMOGY,Rinyaújnép,001,33,12,0,12,0,0,12
SOMOGY,Ságvár,001,764,313,0,313,0,3,310
SOMOGY,Ságvár,002,775,248,0,248,0,1,247
SOMOGY,Sántos,001,418,182,0,182,0,0,182
SOMOGY,Sávoly,001,347,118,0,118,0,0,118
SOMOGY,Segesd,001,900,194,0,194,0,5,189
SOMOGY,Segesd,002,1004,263,0,263,0,0,263
SOMOGY,Sérsekszõlõs,001,119,55,0,55,0,0,55
SOMOGY,Simonfa,001,305,123,0,123,0,1,122
SOMOGY,Siófok,001,262,127,0,127,0,1,126
SOMOGY,Siófok,002,649,310,0,310,0,2,308
SOMOGY,Siófok,003,574,283,0,283,0,0,283
SOMOGY,Siófok,004,1080,802,0,802,0,1,801
SOMOGY,Siófok,005,1210,594,0,594,0,3,591
SOMOGY,Siófok,006,831,440,0,440,0,0,440
SOMOGY,Siófok,007,952,460,0,459,-1,0,459
SOMOGY,Siófok,008,847,440,0,439,-1,2,437
SOMOGY,Siófok,009,967,534,0,534,0,2,532
SOMOGY,Siófok,010,1112,523,0,523,0,2,521
SOMOGY,Siófok,011,656,326,0,326,0,0,326
SOMOGY,Siófok,012,582,307,0,307,0,0,307
SOMOGY,Siófok,013,905,409,0,409,0,0,409
SOMOGY,Siófok,014,776,360,0,360,0,1,359
SOMOGY,Siófok,015,826,390,0,390,0,2,388
SOMOGY,Siófok,016,841,440,0,440,0,2,438
SOMOGY,Siófok,017,1170,421,0,421,0,1,420
SOMOGY,Siófok,018,1076,438,0,438,0,1,437
SOMOGY,Siófok,019,1167,431,0,431,0,1,430
SOMOGY,Siófok,020,1301,521,0,521,0,6,515
SOMOGY,Siófok,021,1326,580,0,579,-1,0,579
SOMOGY,Siófok,022,275,130,0,130,0,0,130
SOMOGY,Siófok,023,695,318,0,318,0,0,318
SOMOGY,Siófok,024,646,337,0,337,0,0,337
SOMOGY,Siójut,001,529,169,0,169,0,2,167
SOMOGY,Som,001,553,200,0,200,0,2,198
SOMOGY,Somodor,001,323,97,0,97,0,0,97
SOMOGY,Somogyacsa,001,127,44,0,44,0,0,44
SOMOGY,Somogyaracs,001,108,32,0,32,0,0,32
SOMOGY,Somogyaszaló,001,464,187,0,187,0,0,187
SOMOGY,Somogyaszaló,002,146,55,0,55,0,0,55
SOMOGY,Somogybabod,001,401,154,0,154,0,0,154
SOMOGY,Somogybükkösd,001,69,34,0,34,0,0,34
SOMOGY,Somogycsicsó,001,115,59,0,59,0,0,59
SOMOGY,Somogydöröcske,001,116,47,0,47,0,4,43
SOMOGY,Somogyegres,001,162,60,0,60,0,1,59
SOMOGY,Somogyfajsz,001,392,165,0,165,0,1,164
SOMOGY,Somogygeszti,001,333,83,0,83,0,3,80
SOMOGY,Somogyjád,001,546,208,0,208,0,2,206
SOMOGY,Somogyjád,002,737,251,0,251,0,0,251
SOMOGY,Somogymeggyes,001,398,143,0,143,0,0,143
SOMOGY,Somogysámson,001,487,160,0,160,0,2,158
SOMOGY,Somogysárd,001,1027,260,0,260,0,4,256
SOMOGY,Somogysimonyi,001,53,32,0,32,0,0,32
SOMOGY,Somogyszentpál,001,472,141,0,141,0,1,140
SOMOGY,Somogyszil,001,547,176,0,176,0,1,175
SOMOGY,Somogyszob,001,558,227,0,227,0,0,227
SOMOGY,Somogyszob,002,720,221,0,221,0,2,219
SOMOGY,Somogytúr,001,364,136,0,136,0,0,136
SOMOGY,Somogyudvarhely,001,441,169,0,169,0,2,167
SOMOGY,Somogyudvarhely,002,414,146,0,146,0,1,145
SOMOGY,Somogyvámos,001,599,195,0,195,0,2,193
SOMOGY,Somogyvár,001,768,327,0,327,0,4,323
SOMOGY,Somogyvár,002,465,150,0,150,0,1,149
SOMOGY,Somogyvár,003,112,36,0,36,0,0,36
SOMOGY,Somogyzsitfa,001,258,75,0,75,0,0,75
SOMOGY,Somogyzsitfa,002,167,69,0,69,0,2,67
SOMOGY,Szabadi,001,250,112,0,112,0,1,111
SOMOGY,Szabás,001,430,131,0,131,0,1,130
SOMOGY,Szántód,001,627,371,0,371,0,4,367
SOMOGY,Szegerdõ,001,152,77,0,77,0,1,76
SOMOGY,Szenna,001,572,278,0,278,0,3,275
SOMOGY,Szenta,001,318,144,0,144,0,2,142
SOMOGY,Szentbalázs,001,267,143,0,143,0,1,142
SOMOGY,Szentborbás,001,97,44,0,44,0,0,44
SOMOGY,Szentgáloskér,001,392,142,0,142,0,0,142
SOMOGY,Szenyér,001,240,87,0,87,0,2,85
SOMOGY,Szilvásszentmárton,001,161,66,0,66,0,1,65
SOMOGY,Szorosad,001,79,46,0,46,0,0,46
SOMOGY,Szólád,001,490,244,0,242,-2,0,242
SOMOGY,Szõkedencs,001,203,81,0,81,0,0,81
SOMOGY,Szõlõsgyörök,001,471,176,0,176,0,0,176
SOMOGY,Szõlõsgyörök,002,520,180,0,180,0,0,180
SOMOGY,Szulok,001,494,216,0,216,0,1,215
SOMOGY,Tab,001,659,224,0,224,0,1,223
SOMOGY,Tab,002,717,300,0,300,0,3,297
SOMOGY,Tab,003,630,207,0,207,0,0,207
SOMOGY,Tab,004,746,277,0,277,0,1,276
SOMOGY,Tab,005,757,322,0,322,0,0,322
SOMOGY,Tapsony,001,497,151,0,151,0,0,151
SOMOGY,Tarany,001,465,146,0,146,0,4,142
SOMOGY,Tarany,002,458,131,0,131,0,1,130
SOMOGY,Taszár,001,784,329,0,329,0,4,325
SOMOGY,Taszár,002,846,305,0,305,0,2,303
SOMOGY,Táska,001,283,127,0,127,0,1,126
SOMOGY,Teleki,001,163,53,0,53,0,0,53
SOMOGY,Tengõd,001,348,97,0,97,0,1,96
SOMOGY,Tikos,001,101,26,0,26,0,1,25
SOMOGY,Torvaj,001,195,83,0,83,0,0,83
SOMOGY,Tótújfalu,001,185,82,0,82,0,0,82
SOMOGY,Törökkoppány,001,346,123,0,123,0,0,123
SOMOGY,Újvárfalva,001,92,36,0,36,0,0,36
SOMOGY,Újvárfalva,002,99,53,0,53,0,0,53
SOMOGY,Varászló,001,114,50,0,50,0,0,50
SOMOGY,Várda,001,381,172,0,172,0,1,171
SOMOGY,Vése,001,586,180,0,180,0,0,180
SOMOGY,Visnye,001,170,61,0,61,0,0,61
SOMOGY,Visz,001,152,85,0,85,0,0,85
SOMOGY,Vízvár,001,465,143,0,143,0,0,143
SOMOGY,Vörs,001,349,170,0,170,0,3,167
SOMOGY,Zala,001,216,91,0,91,0,1,90
SOMOGY,Zamárdi,001,1233,741,0,741,0,1,740
SOMOGY,Zamárdi,002,1122,550,0,550,0,2,548
SOMOGY,Zákány,001,406,175,0,175,0,0,175
SOMOGY,Zákány,002,509,228,0,228,0,5,223
SOMOGY,Zics,001,278,108,2,107,-1,1,106
SOMOGY,Zimány,001,437,149,0,149,0,2,147
SOMOGY,Zselickisfalud,001,196,73,0,73,0,2,71
SOMOGY,Zselickislak,001,357,147,0,147,0,0,147
SOMOGY,Zselicszentpál,001,345,169,0,169,0,1,168
SOMOGY,Zákányfalu,001,426,139,0,139,0,0,139
SOMOGY,Balatonvilágos,001,1235,623,0,623,0,5,618
SZABOLCS-SZATMÁR-BEREG,Ajak,001,990,418,0,418,0,1,417
SZABOLCS-SZATMÁR-BEREG,Ajak,002,936,457,0,457,0,5,452
SZABOLCS-SZATMÁR-BEREG,Ajak,003,1161,398,0,398,0,2,396
SZABOLCS-SZATMÁR-BEREG,Anarcs,001,810,261,0,261,0,2,259
SZABOLCS-SZATMÁR-BEREG,Anarcs,002,792,163,0,163,0,0,163
SZABOLCS-SZATMÁR-BEREG,Apagy,001,651,227,0,227,0,0,227
SZABOLCS-SZATMÁR-BEREG,Apagy,002,626,198,0,198,0,6,192
SZABOLCS-SZATMÁR-BEREG,Apagy,003,661,194,0,194,0,3,191
SZABOLCS-SZATMÁR-BEREG,Aranyosapáti,001,755,264,0,264,0,0,264
SZABOLCS-SZATMÁR-BEREG,Aranyosapáti,002,787,301,0,301,0,1,300
SZABOLCS-SZATMÁR-BEREG,Baktalórántháza,001,750,561,0,561,0,25,536
SZABOLCS-SZATMÁR-BEREG,Baktalórántháza,002,840,607,0,607,0,5,602
SZABOLCS-SZATMÁR-BEREG,Baktalórántháza,003,1169,894,0,894,0,19,875
SZABOLCS-SZATMÁR-BEREG,Balkány,001,826,303,0,303,0,1,302
SZABOLCS-SZATMÁR-BEREG,Balkány,002,988,337,0,337,0,2,335
SZABOLCS-SZATMÁR-BEREG,Balkány,003,1117,364,0,364,0,4,360
SZABOLCS-SZATMÁR-BEREG,Balkány,004,345,104,1,103,-1,1,102
SZABOLCS-SZATMÁR-BEREG,Balkány,005,647,164,0,164,0,7,157
SZABOLCS-SZATMÁR-BEREG,Balkány,006,1047,241,0,241,0,0,241
SZABOLCS-SZATMÁR-BEREG,Balsa,001,618,257,0,257,0,1,256
SZABOLCS-SZATMÁR-BEREG,Barabás,001,824,369,0,369,0,8,361
SZABOLCS-SZATMÁR-BEREG,Bátorliget,001,556,215,0,215,0,6,209
SZABOLCS-SZATMÁR-BEREG,Benk,001,382,172,0,172,0,1,171
SZABOLCS-SZATMÁR-BEREG,Beregdaróc,001,788,387,0,387,0,9,378
SZABOLCS-SZATMÁR-BEREG,Beregsurány,001,764,345,0,345,0,7,338
SZABOLCS-SZATMÁR-BEREG,Berkesz,001,621,316,0,316,0,2,314
SZABOLCS-SZATMÁR-BEREG,Besenyõd,001,570,261,0,261,0,3,258
SZABOLCS-SZATMÁR-BEREG,Beszterec,001,775,196,0,196,0,1,195
SZABOLCS-SZATMÁR-BEREG,Biri,001,1117,379,0,379,0,7,372
SZABOLCS-SZATMÁR-BEREG,Botpalád,001,688,243,0,243,0,6,237
SZABOLCS-SZATMÁR-BEREG,Bököny,001,575,214,0,214,0,7,207
SZABOLCS-SZATMÁR-BEREG,Bököny,002,635,194,0,194,0,0,194
SZABOLCS-SZATMÁR-BEREG,Bököny,003,604,191,0,191,0,1,190
SZABOLCS-SZATMÁR-BEREG,Bököny,004,622,150,0,150,0,3,147
SZABOLCS-SZATMÁR-BEREG,Buj,001,593,250,0,249,-1,4,245
SZABOLCS-SZATMÁR-BEREG,Buj,002,666,212,0,212,0,0,212
SZABOLCS-SZATMÁR-BEREG,Buj,003,549,176,0,176,0,0,176
SZABOLCS-SZATMÁR-BEREG,Cégénydányád,001,533,252,0,252,0,0,252
SZABOLCS-SZATMÁR-BEREG,Csaholc,001,426,247,0,247,0,3,244
SZABOLCS-SZATMÁR-BEREG,Csaroda,001,507,221,0,221,0,1,220
SZABOLCS-SZATMÁR-BEREG,Császló,001,309,128,0,128,0,0,128
SZABOLCS-SZATMÁR-BEREG,Csegöld,001,556,233,1,232,-1,2,230
SZABOLCS-SZATMÁR-BEREG,Csenger,001,748,269,0,269,0,1,268
SZABOLCS-SZATMÁR-BEREG,Csenger,002,822,363,0,363,0,1,362
SZABOLCS-SZATMÁR-BEREG,Csenger,003,929,392,0,392,0,8,384
SZABOLCS-SZATMÁR-BEREG,Csenger,004,733,345,0,345,0,4,341
SZABOLCS-SZATMÁR-BEREG,Csenger,005,830,324,0,324,0,3,321
SZABOLCS-SZATMÁR-BEREG,Csengersima,001,671,272,0,272,0,4,268
SZABOLCS-SZATMÁR-BEREG,Csengerújfalu,001,663,401,0,400,-1,5,395
SZABOLCS-SZATMÁR-BEREG,Darnó,001,132,46,0,46,0,0,46
SZABOLCS-SZATMÁR-BEREG,Demecser,001,619,285,0,285,0,0,285
SZABOLCS-SZATMÁR-BEREG,Demecser,002,903,375,0,375,0,7,368
SZABOLCS-SZATMÁR-BEREG,Demecser,003,981,318,0,318,0,5,313
SZABOLCS-SZATMÁR-BEREG,Demecser,004,661,278,0,278,0,1,277
SZABOLCS-SZATMÁR-BEREG,Demecser,005,235,78,0,78,0,1,77
SZABOLCS-SZATMÁR-BEREG,Dombrád,001,1062,278,0,278,0,1,277
SZABOLCS-SZATMÁR-BEREG,Dombrád,002,1026,380,0,379,-1,7,372
SZABOLCS-SZATMÁR-BEREG,Dombrád,003,921,367,0,367,0,1,366
SZABOLCS-SZATMÁR-BEREG,Döge,001,902,270,0,270,0,3,267
SZABOLCS-SZATMÁR-BEREG,Döge,002,864,283,0,283,0,5,278
SZABOLCS-SZATMÁR-BEREG,Encsencs,001,669,254,0,254,0,1,253
SZABOLCS-SZATMÁR-BEREG,Encsencs,002,745,337,0,337,0,1,336
SZABOLCS-SZATMÁR-BEREG,Eperjeske,001,896,312,0,312,0,10,302
SZABOLCS-SZATMÁR-BEREG,Érpatak,001,641,246,0,246,0,3,243
SZABOLCS-SZATMÁR-BEREG,Érpatak,002,683,229,0,229,0,4,225
SZABOLCS-SZATMÁR-BEREG,Fábiánháza,001,490,118,0,118,0,2,116
SZABOLCS-SZATMÁR-BEREG,Fábiánháza,002,712,251,0,251,0,2,249
SZABOLCS-SZATMÁR-BEREG,Fábiánháza,003,177,55,0,55,0,0,55
SZABOLCS-SZATMÁR-BEREG,Fehérgyarmat,001,933,429,0,429,0,2,427
SZABOLCS-SZATMÁR-BEREG,Fehérgyarmat,002,995,529,0,529,0,2,527
SZABOLCS-SZATMÁR-BEREG,Fehérgyarmat,003,877,377,0,377,0,3,374
SZABOLCS-SZATMÁR-BEREG,Fehérgyarmat,004,900,444,0,444,0,1,443
SZABOLCS-SZATMÁR-BEREG,Fehérgyarmat,005,925,482,0,482,0,1,481
SZABOLCS-SZATMÁR-BEREG,Fehérgyarmat,006,952,433,0,433,0,4,429
SZABOLCS-SZATMÁR-BEREG,Fehérgyarmat,007,966,340,0,340,0,0,340
SZABOLCS-SZATMÁR-BEREG,Fényeslitke,001,1048,503,0,503,0,2,501
SZABOLCS-SZATMÁR-BEREG,Fényeslitke,002,1011,336,0,336,0,3,333
SZABOLCS-SZATMÁR-BEREG,Fülesd,001,367,146,0,146,0,1,145
SZABOLCS-SZATMÁR-BEREG,Fülpösdaróc,001,241,150,0,150,0,3,147
SZABOLCS-SZATMÁR-BEREG,Gacsály,001,650,190,0,190,0,0,190
SZABOLCS-SZATMÁR-BEREG,Garbolc,001,115,74,0,74,0,0,74
SZABOLCS-SZATMÁR-BEREG,Gávavencsellõ,001,923,302,0,302,0,6,296
SZABOLCS-SZATMÁR-BEREG,Gávavencsellõ,002,933,342,0,342,0,6,336
SZABOLCS-SZATMÁR-BEREG,Gávavencsellõ,003,893,296,0,296,0,3,293
SZABOLCS-SZATMÁR-BEREG,Gelénes,001,507,200,0,200,0,7,193
SZABOLCS-SZATMÁR-BEREG,Gemzse,001,642,255,0,255,0,1,254
SZABOLCS-SZATMÁR-BEREG,Geszteréd,001,752,290,0,290,0,0,290
SZABOLCS-SZATMÁR-BEREG,Geszteréd,002,711,225,0,224,-1,1,223
SZABOLCS-SZATMÁR-BEREG,Géberjén,001,426,218,0,218,0,2,216
SZABOLCS-SZATMÁR-BEREG,Gégény,001,831,251,0,251,0,2,249
SZABOLCS-SZATMÁR-BEREG,Gégény,002,732,202,0,202,0,0,202
SZABOLCS-SZATMÁR-BEREG,Gulács,001,820,373,0,373,0,7,366
SZABOLCS-SZATMÁR-BEREG,Gyõröcske,001,109,46,0,46,0,0,46
SZABOLCS-SZATMÁR-BEREG,Gyõrtelek,001,1233,441,0,441,0,6,435
SZABOLCS-SZATMÁR-BEREG,Gyulaháza,001,776,216,0,216,0,1,215
SZABOLCS-SZATMÁR-BEREG,Gyulaháza,002,815,170,0,170,0,0,170
SZABOLCS-SZATMÁR-BEREG,Gyügye,001,227,110,0,110,0,1,109
SZABOLCS-SZATMÁR-BEREG,Gyüre,001,985,426,0,426,0,1,425
SZABOLCS-SZATMÁR-BEREG,Hermánszeg,001,229,88,0,88,0,1,87
SZABOLCS-SZATMÁR-BEREG,Hetefejércse,001,247,104,0,104,0,0,104
SZABOLCS-SZATMÁR-BEREG,Hodász,001,885,198,0,198,0,3,195
SZABOLCS-SZATMÁR-BEREG,Hodász,002,756,151,0,150,-1,2,148
SZABOLCS-SZATMÁR-BEREG,Hodász,003,793,141,0,141,0,1,140
SZABOLCS-SZATMÁR-BEREG,Ibrány,001,1002,312,0,312,0,0,312
SZABOLCS-SZATMÁR-BEREG,Ibrány,002,962,356,0,356,0,0,356
SZABOLCS-SZATMÁR-BEREG,Ibrány,003,1053,304,0,304,0,1,303
SZABOLCS-SZATMÁR-BEREG,Ibrány,004,1071,193,0,193,0,0,193
SZABOLCS-SZATMÁR-BEREG,Ibrány,005,1067,278,0,278,0,1,277
SZABOLCS-SZATMÁR-BEREG,Ibrány,006,177,60,0,60,0,2,58
SZABOLCS-SZATMÁR-BEREG,Ilk,001,971,463,0,463,0,7,456
SZABOLCS-SZATMÁR-BEREG,Jánd,001,633,329,0,329,0,3,326
SZABOLCS-SZATMÁR-BEREG,Jánkmajtis,001,1374,622,0,622,0,5,617
SZABOLCS-SZATMÁR-BEREG,Jármi,001,1044,367,0,367,0,2,365
SZABOLCS-SZATMÁR-BEREG,Jéke,001,632,225,0,225,0,8,217
SZABOLCS-SZATMÁR-BEREG,Kállósemjén,001,619,202,0,202,0,0,202
SZABOLCS-SZATMÁR-BEREG,Kállósemjén,002,732,232,0,232,0,0,232
SZABOLCS-SZATMÁR-BEREG,Kállósemjén,003,592,229,0,229,0,2,227
SZABOLCS-SZATMÁR-BEREG,Kállósemjén,004,862,286,2,284,-2,2,282
SZABOLCS-SZATMÁR-BEREG,Kállósemjén,005,220,80,0,80,0,1,79
SZABOLCS-SZATMÁR-BEREG,Kálmánháza,001,738,232,0,232,0,3,229
SZABOLCS-SZATMÁR-BEREG,Kálmánháza,002,606,216,0,216,0,3,213
SZABOLCS-SZATMÁR-BEREG,Kálmánháza,003,174,62,0,62,0,0,62
SZABOLCS-SZATMÁR-BEREG,Kántorjánosi,001,725,256,0,256,0,1,255
SZABOLCS-SZATMÁR-BEREG,Kántorjánosi,002,915,261,0,261,0,4,257
SZABOLCS-SZATMÁR-BEREG,Kemecse,001,1090,521,0,521,0,5,516
SZABOLCS-SZATMÁR-BEREG,Kemecse,002,1048,490,0,490,0,7,483
SZABOLCS-SZATMÁR-BEREG,Kemecse,003,783,403,0,402,-1,6,396
SZABOLCS-SZATMÁR-BEREG,Kemecse,004,991,459,0,459,0,8,451
SZABOLCS-SZATMÁR-BEREG,Kék,001,746,253,0,253,0,1,252
SZABOLCS-SZATMÁR-BEREG,Kék,002,798,270,0,270,0,0,270
SZABOLCS-SZATMÁR-BEREG,Kékcse,001,615,276,0,276,0,1,275
SZABOLCS-SZATMÁR-BEREG,Kékcse,002,599,250,0,250,0,4,246
SZABOLCS-SZATMÁR-BEREG,Kérsemjén,001,242,133,0,133,0,0,133
SZABOLCS-SZATMÁR-BEREG,Kisar,001,828,348,0,348,0,7,341
SZABOLCS-SZATMÁR-BEREG,Kishódos,001,57,38,0,38,0,1,37
SZABOLCS-SZATMÁR-BEREG,Kisléta,001,1294,473,0,473,0,0,473
SZABOLCS-SZATMÁR-BEREG,Kisnamény,001,221,97,0,97,0,6,91
SZABOLCS-SZATMÁR-BEREG,Kispalád,001,606,165,0,165,0,0,165
SZABOLCS-SZATMÁR-BEREG,Kisszekeres,001,430,225,0,225,0,1,224
SZABOLCS-SZATMÁR-BEREG,Kisvarsány,001,841,325,0,325,0,0,325
SZABOLCS-SZATMÁR-BEREG,Kisvárda,001,761,287,0,287,0,4,283
SZABOLCS-SZATMÁR-BEREG,Kisvárda,002,943,353,0,353,0,3,350
SZABOLCS-SZATMÁR-BEREG,Kisvárda,003,732,301,0,301,0,1,300
SZABOLCS-SZATMÁR-BEREG,Kisvárda,004,972,400,0,400,0,2,398
SZABOLCS-SZATMÁR-BEREG,Kisvárda,005,1123,458,0,458,0,7,451
SZABOLCS-SZATMÁR-BEREG,Kisvárda,006,704,336,0,336,0,6,330
SZABOLCS-SZATMÁR-BEREG,Kisvárda,007,862,291,0,291,0,1,290
SZABOLCS-SZATMÁR-BEREG,Kisvárda,008,967,396,0,396,0,5,391
SZABOLCS-SZATMÁR-BEREG,Kisvárda,009,829,291,0,291,0,2,289
SZABOLCS-SZATMÁR-BEREG,Kisvárda,010,854,370,0,370,0,6,364
SZABOLCS-SZATMÁR-BEREG,Kisvárda,011,841,413,0,413,0,3,410
SZABOLCS-SZATMÁR-BEREG,Kisvárda,012,622,296,0,296,0,1,295
SZABOLCS-SZATMÁR-BEREG,Kisvárda,013,922,315,0,315,0,3,312
SZABOLCS-SZATMÁR-BEREG,Kisvárda,014,841,375,0,375,0,2,373
SZABOLCS-SZATMÁR-BEREG,Kisvárda,015,792,301,0,301,0,5,296
SZABOLCS-SZATMÁR-BEREG,Kisvárda,016,819,306,0,306,0,5,301
SZABOLCS-SZATMÁR-BEREG,Kocsord,001,967,378,0,378,0,5,373
SZABOLCS-SZATMÁR-BEREG,Kocsord,002,630,258,0,258,0,0,258
SZABOLCS-SZATMÁR-BEREG,Kocsord,003,742,266,1,266,0,1,265
SZABOLCS-SZATMÁR-BEREG,Komlódtótfalu,001,111,41,0,41,0,0,41
SZABOLCS-SZATMÁR-BEREG,Komoró,001,1103,324,0,324,0,3,321
SZABOLCS-SZATMÁR-BEREG,Kótaj,001,1245,286,0,286,0,1,285
SZABOLCS-SZATMÁR-BEREG,Kótaj,002,1219,315,0,315,0,1,314
SZABOLCS-SZATMÁR-BEREG,Kótaj,003,1216,381,0,381,0,1,380
SZABOLCS-SZATMÁR-BEREG,Kölcse,001,1095,422,0,419,-3,2,417
SZABOLCS-SZATMÁR-BEREG,Kömörõ,001,492,183,0,183,0,4,179
SZABOLCS-SZATMÁR-BEREG,Laskod,001,789,319,0,319,0,6,313
SZABOLCS-SZATMÁR-BEREG,Levelek,001,783,273,0,273,0,0,273
SZABOLCS-SZATMÁR-BEREG,Levelek,002,759,267,0,267,0,1,266
SZABOLCS-SZATMÁR-BEREG,Levelek,003,818,262,0,262,0,9,253
SZABOLCS-SZATMÁR-BEREG,Lónya,001,770,246,0,246,0,0,246
SZABOLCS-SZATMÁR-BEREG,Lövõpetri,001,417,199,0,199,0,3,196
SZABOLCS-SZATMÁR-BEREG,Magosliget,001,228,110,0,110,0,0,110
SZABOLCS-SZATMÁR-BEREG,Magy,001,705,233,0,233,0,5,228
SZABOLCS-SZATMÁR-BEREG,Mánd,001,243,100,0,100,0,1,99
SZABOLCS-SZATMÁR-BEREG,Mándok,001,700,269,0,269,0,8,261
SZABOLCS-SZATMÁR-BEREG,Mándok,002,752,276,0,276,0,2,274
SZABOLCS-SZATMÁR-BEREG,Mándok,003,1004,250,0,250,0,4,246
SZABOLCS-SZATMÁR-BEREG,Mándok,004,843,360,0,360,0,3,357
SZABOLCS-SZATMÁR-BEREG,Máriapócs,001,851,424,0,424,0,4,420
SZABOLCS-SZATMÁR-BEREG,Máriapócs,002,855,237,0,237,0,3,234
SZABOLCS-SZATMÁR-BEREG,Márokpapi,001,522,195,0,195,0,5,190
SZABOLCS-SZATMÁR-BEREG,Mátészalka,001,1130,451,0,451,0,2,449
SZABOLCS-SZATMÁR-BEREG,Mátészalka,002,697,338,0,338,0,1,337
SZABOLCS-SZATMÁR-BEREG,Mátészalka,003,721,343,0,343,0,5,338
SZABOLCS-SZATMÁR-BEREG,Mátészalka,004,788,373,0,373,0,0,373
SZABOLCS-SZATMÁR-BEREG,Mátészalka,005,762,284,0,284,0,1,283
SZABOLCS-SZATMÁR-BEREG,Mátészalka,006,821,357,0,357,0,2,355
SZABOLCS-SZATMÁR-BEREG,Mátészalka,007,905,352,0,352,0,2,350
SZABOLCS-SZATMÁR-BEREG,Mátészalka,008,697,294,0,294,0,1,293
SZABOLCS-SZATMÁR-BEREG,Mátészalka,009,918,432,0,432,0,1,431
SZABOLCS-SZATMÁR-BEREG,Mátészalka,010,790,357,0,357,0,2,355
SZABOLCS-SZATMÁR-BEREG,Mátészalka,011,819,323,0,323,0,1,322
SZABOLCS-SZATMÁR-BEREG,Mátészalka,012,1037,406,0,406,0,5,401
SZABOLCS-SZATMÁR-BEREG,Mátészalka,013,823,362,0,362,0,2,360
SZABOLCS-SZATMÁR-BEREG,Mátészalka,014,777,317,0,317,0,2,315
SZABOLCS-SZATMÁR-BEREG,Mátészalka,015,923,397,1,397,0,5,392
SZABOLCS-SZATMÁR-BEREG,Mátészalka,016,942,435,0,435,0,0,435
SZABOLCS-SZATMÁR-BEREG,Mátyus,001,253,74,0,74,0,2,72
SZABOLCS-SZATMÁR-BEREG,Mezõladány,001,828,254,0,254,0,2,252
SZABOLCS-SZATMÁR-BEREG,Méhtelek,001,570,215,0,215,0,5,210
SZABOLCS-SZATMÁR-BEREG,Mérk,001,1057,371,0,371,0,1,370
SZABOLCS-SZATMÁR-BEREG,Mérk,002,625,259,0,259,0,0,259
SZABOLCS-SZATMÁR-BEREG,Milota,001,760,384,0,384,0,2,382
SZABOLCS-SZATMÁR-BEREG,Nagyar,001,528,245,0,245,0,0,245
SZABOLCS-SZATMÁR-BEREG,Nagycserkesz,001,925,255,0,255,0,2,253
SZABOLCS-SZATMÁR-BEREG,Nagycserkesz,002,224,69,0,69,0,0,69
SZABOLCS-SZATMÁR-BEREG,Nagycserkesz,003,107,44,0,43,-1,0,43
SZABOLCS-SZATMÁR-BEREG,Nagydobos,001,831,251,0,251,0,4,247
SZABOLCS-SZATMÁR-BEREG,Nagydobos,002,849,272,0,272,0,4,268
SZABOLCS-SZATMÁR-BEREG,Nagyecsed,001,1040,310,0,310,0,1,309
SZABOLCS-SZATMÁR-BEREG,Nagyecsed,002,559,153,0,153,0,0,153
SZABOLCS-SZATMÁR-BEREG,Nagyecsed,003,834,219,0,219,0,0,219
SZABOLCS-SZATMÁR-BEREG,Nagyecsed,004,691,133,0,133,0,0,133
SZABOLCS-SZATMÁR-BEREG,Nagyecsed,005,990,137,0,137,0,3,134
SZABOLCS-SZATMÁR-BEREG,Nagyecsed,006,800,230,0,230,0,2,228
SZABOLCS-SZATMÁR-BEREG,Nagyhalász,001,712,224,0,224,0,6,218
SZABOLCS-SZATMÁR-BEREG,Nagyhalász,002,631,172,0,172,0,1,171
SZABOLCS-SZATMÁR-BEREG,Nagyhalász,003,798,184,0,184,0,1,183
SZABOLCS-SZATMÁR-BEREG,Nagyhalász,004,834,154,0,154,0,1,153
SZABOLCS-SZATMÁR-BEREG,Nagyhalász,005,770,225,0,225,0,1,224
SZABOLCS-SZATMÁR-BEREG,Nagyhalász,006,778,181,0,181,0,1,180
SZABOLCS-SZATMÁR-BEREG,Nagyhódos,001,121,63,0,63,0,1,62
SZABOLCS-SZATMÁR-BEREG,Nagykálló,001,994,417,0,417,0,5,412
SZABOLCS-SZATMÁR-BEREG,Nagykálló,002,1036,326,0,326,0,2,324
SZABOLCS-SZATMÁR-BEREG,Nagykálló,003,1012,332,0,332,0,2,330
SZABOLCS-SZATMÁR-BEREG,Nagykálló,004,940,319,0,319,0,6,313
SZABOLCS-SZATMÁR-BEREG,Nagykálló,005,929,357,0,357,0,6,351
SZABOLCS-SZATMÁR-BEREG,Nagykálló,006,996,330,1,329,-1,6,323
SZABOLCS-SZATMÁR-BEREG,Nagykálló,007,939,335,0,335,0,1,334
SZABOLCS-SZATMÁR-BEREG,Nagykálló,008,1014,396,0,396,0,2,394
SZABOLCS-SZATMÁR-BEREG,Nagyszekeres,001,453,157,0,157,0,3,154
SZABOLCS-SZATMÁR-BEREG,Nagyvarsány,001,1157,477,0,477,0,3,474
SZABOLCS-SZATMÁR-BEREG,Napkor,001,950,355,0,355,0,0,355
SZABOLCS-SZATMÁR-BEREG,Napkor,002,1004,309,1,308,-1,9,299
SZABOLCS-SZATMÁR-BEREG,Napkor,003,1156,281,0,281,0,1,280
SZABOLCS-SZATMÁR-BEREG,Nábrád,001,748,338,0,338,0,5,333
SZABOLCS-SZATMÁR-BEREG,Nemesborzova,001,98,53,0,53,0,3,50
SZABOLCS-SZATMÁR-BEREG,Nyírbátor,001,1397,357,0,357,0,9,348
SZABOLCS-SZATMÁR-BEREG,Nyírbátor,002,1142,429,0,429,0,2,427
SZABOLCS-SZATMÁR-BEREG,Nyírbátor,003,1071,401,0,401,0,1,400
SZABOLCS-SZATMÁR-BEREG,Nyírbátor,004,1129,489,0,489,0,2,487
SZABOLCS-SZATMÁR-BEREG,Nyírbátor,005,1160,472,0,472,0,1,471
SZABOLCS-SZATMÁR-BEREG,Nyírbátor,006,1226,587,0,587,0,3,584
SZABOLCS-SZATMÁR-BEREG,Nyírbátor,007,1187,404,0,404,0,1,403
SZABOLCS-SZATMÁR-BEREG,Nyírbátor,008,1159,531,0,531,0,3,528
SZABOLCS-SZATMÁR-BEREG,Nyírbéltek,001,693,245,0,245,0,0,245
SZABOLCS-SZATMÁR-BEREG,Nyírbéltek,002,828,336,0,336,0,3,333
SZABOLCS-SZATMÁR-BEREG,Nyírbéltek,003,627,213,0,213,0,1,212
SZABOLCS-SZATMÁR-BEREG,Nyírbogát,001,914,679,0,679,0,13,666
SZABOLCS-SZATMÁR-BEREG,Nyírbogát,002,757,557,0,557,0,5,552
SZABOLCS-SZATMÁR-BEREG,Nyírbogát,003,834,601,0,601,0,8,593
SZABOLCS-SZATMÁR-BEREG,Nyírbogdány,001,593,195,0,195,0,2,193
SZABOLCS-SZATMÁR-BEREG,Nyírbogdány,002,874,229,0,229,0,5,224
SZABOLCS-SZATMÁR-BEREG,Nyírbogdány,003,855,343,0,343,0,1,342
SZABOLCS-SZATMÁR-BEREG,Nyírcsaholy,001,1111,471,0,471,0,4,467
SZABOLCS-SZATMÁR-BEREG,Nyírcsaholy,002,643,225,0,225,0,5,220
SZABOLCS-SZATMÁR-BEREG,Nyírcsászári,001,980,465,0,465,0,7,458
SZABOLCS-SZATMÁR-BEREG,Nyírderzs,001,487,249,0,249,0,4,245
SZABOLCS-SZATMÁR-BEREG,Nyíregyháza,001,847,428,0,427,-1,1,426
SZABOLCS-SZATMÁR-BEREG,Nyíregyháza,002,1001,480,0,480,0,1,479
SZABOLCS-SZATMÁR-BEREG,Nyíregyháza,003,767,335,0,335,0,4,331
SZABOLCS-SZATMÁR-BEREG,Nyíregyháza,004,1398,579,0,579,0,5,574
SZABOLCS-SZATMÁR-BEREG,Nyíregyháza,005,1010,450,0,450,0,2,448
SZABOLCS-SZATMÁR-BEREG,Nyíregyháza,006,952,430,0,430,0,0,430
SZABOLCS-SZATMÁR-BEREG,Nyíregyháza,007,906,500,0,500,0,2,498
SZABOLCS-SZATMÁR-BEREG,Nyíregyháza,008,1054,459,0,459,0,0,459
SZABOLCS-SZATMÁR-BEREG,Nyíregyháza,009,843,340,0,340,0,2,338
SZABOLCS-SZATMÁR-BEREG,Nyíregyháza,010,872,446,0,446,0,6,440
SZABOLCS-SZATMÁR-BEREG,Nyíregyháza,011,976,396,0,396,0,1,395
SZABOLCS-SZATMÁR-BEREG,Nyíregyháza,012,834,336,0,336,0,3,333
SZABOLCS-SZATMÁR-BEREG,Nyíregyháza,013,987,287,0,287,0,1,286
SZABOLCS-SZATMÁR-BEREG,Nyíregyháza,014,926,417,0,417,0,1,416
SZABOLCS-SZATMÁR-BEREG,Nyíregyháza,015,1123,595,0,592,-3,1,591
SZABOLCS-SZATMÁR-BEREG,Nyíregyháza,016,727,352,0,352,0,0,352
SZABOLCS-SZATMÁR-BEREG,Nyíregyháza,017,966,616,0,616,0,5,611
SZABOLCS-SZATMÁR-BEREG,Nyíregyháza,018,697,349,0,346,-3,2,344
SZABOLCS-SZATMÁR-BEREG,Nyíregyháza,019,1170,401,0,401,0,3,398
SZABOLCS-SZATMÁR-BEREG,Nyíregyháza,020,828,364,0,364,0,0,364
SZABOLCS-SZATMÁR-BEREG,Nyíregyháza,021,824,381,0,381,0,0,381
SZABOLCS-SZATMÁR-BEREG,Nyíregyháza,022,1295,641,0,640,-1,4,636
SZABOLCS-SZATMÁR-BEREG,Nyíregyháza,023,952,407,0,407,0,1,406
SZABOLCS-SZATMÁR-BEREG,Nyíregyháza,024,1108,459,0,458,-1,3,455
SZABOLCS-SZATMÁR-BEREG,Nyíregyháza,025,922,421,0,421,0,1,420
SZABOLCS-SZATMÁR-BEREG,Nyíregyháza,026,814,314,0,314,0,2,312
SZABOLCS-SZATMÁR-BEREG,Nyíregyháza,027,751,309,0,309,0,1,308
SZABOLCS-SZATMÁR-BEREG,Nyíregyháza,028,991,484,0,484,0,1,483
SZABOLCS-SZATMÁR-BEREG,Nyíregyháza,029,844,386,0,386,0,1,385
SZABOLCS-SZATMÁR-BEREG,Nyíregyháza,030,1081,438,0,438,0,4,434
SZABOLCS-SZATMÁR-BEREG,Nyíregyháza,031,832,394,0,394,0,0,394
SZABOLCS-SZATMÁR-BEREG,Nyíregyháza,032,873,448,0,448,0,0,448
SZABOLCS-SZATMÁR-BEREG,Nyíregyháza,033,834,435,0,435,0,1,434
SZABOLCS-SZATMÁR-BEREG,Nyíregyháza,034,982,411,0,411,0,5,406
SZABOLCS-SZATMÁR-BEREG,Nyíregyháza,035,726,220,0,220,0,3,217
SZABOLCS-SZATMÁR-BEREG,Nyíregyháza,036,919,371,0,371,0,2,369
SZABOLCS-SZATMÁR-BEREG,Nyíregyháza,037,590,282,0,282,0,1,281
SZABOLCS-SZATMÁR-BEREG,Nyíregyháza,038,699,338,0,338,0,7,331
SZABOLCS-SZATMÁR-BEREG,Nyíregyháza,039,668,212,0,212,0,2,210
SZABOLCS-SZATMÁR-BEREG,Nyíregyháza,040,1023,405,0,405,0,5,400
SZABOLCS-SZATMÁR-BEREG,Nyíregyháza,041,1181,476,0,476,0,0,476
SZABOLCS-SZATMÁR-BEREG,Nyíregyháza,042,1230,458,0,457,-1,0,457
SZABOLCS-SZATMÁR-BEREG,Nyíregyháza,043,872,400,0,400,0,9,391
SZABOLCS-SZATMÁR-BEREG,Nyíregyháza,044,936,451,0,451,0,6,445
SZABOLCS-SZATMÁR-BEREG,Nyíregyháza,045,734,351,0,351,0,3,348
SZABOLCS-SZATMÁR-BEREG,Nyíregyháza,046,922,382,0,382,0,3,379
SZABOLCS-SZATMÁR-BEREG,Nyíregyháza,047,1392,924,0,923,-1,6,917
SZABOLCS-SZATMÁR-BEREG,Nyíregyháza,048,1152,475,0,475,0,3,472
SZABOLCS-SZATMÁR-BEREG,Nyíregyháza,049,655,221,0,221,0,1,220
SZABOLCS-SZATMÁR-BEREG,Nyíregyháza,050,866,376,0,376,0,2,374
SZABOLCS-SZATMÁR-BEREG,Nyíregyháza,051,978,348,0,339,-9,2,337
SZABOLCS-SZATMÁR-BEREG,Nyíregyháza,052,893,397,0,397,0,11,386
SZABOLCS-SZATMÁR-BEREG,Nyíregyháza,053,707,302,0,302,0,1,301
SZABOLCS-SZATMÁR-BEREG,Nyíregyháza,054,1181,518,0,518,0,3,515
SZABOLCS-SZATMÁR-BEREG,Nyíregyháza,055,902,379,0,379,0,6,373
SZABOLCS-SZATMÁR-BEREG,Nyíregyháza,056,690,335,0,335,0,1,334
SZABOLCS-SZATMÁR-BEREG,Nyíregyháza,057,1045,505,0,505,0,3,502
SZABOLCS-SZATMÁR-BEREG,Nyíregyháza,058,817,399,0,399,0,1,398
SZABOLCS-SZATMÁR-BEREG,Nyíregyháza,059,853,479,0,479,0,0,479
SZABOLCS-SZATMÁR-BEREG,Nyíregyháza,060,757,392,0,390,-2,0,390
SZABOLCS-SZATMÁR-BEREG,Nyíregyháza,061,657,219,0,219,0,0,219
SZABOLCS-SZATMÁR-BEREG,Nyíregyháza,062,1325,582,0,582,0,1,581
SZABOLCS-SZATMÁR-BEREG,Nyíregyháza,063,879,359,0,353,-6,3,350
SZABOLCS-SZATMÁR-BEREG,Nyíregyháza,064,802,329,0,329,0,1,328
SZABOLCS-SZATMÁR-BEREG,Nyíregyháza,065,986,344,0,344,0,1,343
SZABOLCS-SZATMÁR-BEREG,Nyíregyháza,066,1231,450,0,450,0,4,446
SZABOLCS-SZATMÁR-BEREG,Nyíregyháza,067,1151,413,0,413,0,2,411
SZABOLCS-SZATMÁR-BEREG,Nyíregyháza,068,976,412,0,412,0,4,408
SZABOLCS-SZATMÁR-BEREG,Nyíregyháza,069,1087,336,0,335,-1,1,334
SZABOLCS-SZATMÁR-BEREG,Nyíregyháza,070,1185,552,0,552,0,1,551
SZABOLCS-SZATMÁR-BEREG,Nyíregyháza,071,860,473,0,473,0,1,472
SZABOLCS-SZATMÁR-BEREG,Nyíregyháza,072,855,300,0,300,0,1,299
SZABOLCS-SZATMÁR-BEREG,Nyíregyháza,073,1153,575,0,575,0,0,575
SZABOLCS-SZATMÁR-BEREG,Nyíregyháza,074,945,478,0,478,0,1,477
SZABOLCS-SZATMÁR-BEREG,Nyíregyháza,075,1159,519,0,519,0,1,518
SZABOLCS-SZATMÁR-BEREG,Nyíregyháza,076,565,128,0,128,0,0,128
SZABOLCS-SZATMÁR-BEREG,Nyíregyháza,077,655,244,0,244,0,0,244
SZABOLCS-SZATMÁR-BEREG,Nyíregyháza,078,841,258,0,258,0,5,253
SZABOLCS-SZATMÁR-BEREG,Nyíregyháza,079,1220,464,0,464,0,0,464
SZABOLCS-SZATMÁR-BEREG,Nyíregyháza,080,947,329,0,329,0,0,329
SZABOLCS-SZATMÁR-BEREG,Nyíregyháza,081,810,257,0,257,0,0,257
SZABOLCS-SZATMÁR-BEREG,Nyíregyháza,082,1023,293,0,293,0,1,292
SZABOLCS-SZATMÁR-BEREG,Nyíregyháza,083,727,169,0,169,0,4,165
SZABOLCS-SZATMÁR-BEREG,Nyíregyháza,084,1123,391,0,390,-1,0,390
SZABOLCS-SZATMÁR-BEREG,Nyíregyháza,085,1063,400,0,400,0,2,398
SZABOLCS-SZATMÁR-BEREG,Nyíregyháza,086,1017,288,0,288,0,0,288
SZABOLCS-SZATMÁR-BEREG,Nyíregyháza,087,908,354,0,353,-1,0,353
SZABOLCS-SZATMÁR-BEREG,Nyíregyháza,088,743,274,0,274,0,1,273
SZABOLCS-SZATMÁR-BEREG,Nyíregyháza,089,1150,496,0,496,0,1,495
SZABOLCS-SZATMÁR-BEREG,Nyíregyháza,090,1013,360,0,360,0,0,360
SZABOLCS-SZATMÁR-BEREG,Nyíregyháza,091,1127,398,0,398,0,1,397
SZABOLCS-SZATMÁR-BEREG,Nyíregyháza,092,823,263,0,263,0,4,259
SZABOLCS-SZATMÁR-BEREG,Nyíregyháza,093,1083,502,0,502,0,2,500
SZABOLCS-SZATMÁR-BEREG,Nyíregyháza,094,943,446,0,446,0,2,444
SZABOLCS-SZATMÁR-BEREG,Nyíregyháza,095,1084,480,0,480,0,3,477
SZABOLCS-SZATMÁR-BEREG,Nyíregyháza,096,1150,557,0,557,0,8,549
SZABOLCS-SZATMÁR-BEREG,Nyíregyháza,097,807,322,1,322,0,1,321
SZABOLCS-SZATMÁR-BEREG,Nyíregyháza,098,744,316,0,316,0,0,316
SZABOLCS-SZATMÁR-BEREG,Nyíregyháza,099,956,390,0,390,0,1,389
SZABOLCS-SZATMÁR-BEREG,Nyíregyháza,100,686,254,0,254,0,1,253
SZABOLCS-SZATMÁR-BEREG,Nyíregyháza,101,920,354,0,353,-1,0,353
SZABOLCS-SZATMÁR-BEREG,Nyírgelse,001,740,246,0,246,0,0,246
SZABOLCS-SZATMÁR-BEREG,Nyírgelse,002,170,65,0,65,0,0,65
SZABOLCS-SZATMÁR-BEREG,Nyírgyulaj,001,783,257,0,257,0,1,256
SZABOLCS-SZATMÁR-BEREG,Nyírgyulaj,002,850,241,0,241,0,2,239
SZABOLCS-SZATMÁR-BEREG,Nyíribrony,001,926,320,0,320,0,6,314
SZABOLCS-SZATMÁR-BEREG,Nyírjákó,001,701,408,0,408,0,2,406
SZABOLCS-SZATMÁR-BEREG,Nyírkarász,001,779,315,0,315,0,3,312
SZABOLCS-SZATMÁR-BEREG,Nyírkarász,002,1035,435,0,435,0,0,435
SZABOLCS-SZATMÁR-BEREG,Nyírkáta,001,715,340,0,340,0,3,337
SZABOLCS-SZATMÁR-BEREG,Nyírkáta,002,707,317,0,317,0,0,317
SZABOLCS-SZATMÁR-BEREG,Nyírkércs,001,641,293,0,293,0,7,286
SZABOLCS-SZATMÁR-BEREG,Nyírlövõ,001,564,229,0,229,0,4,225
SZABOLCS-SZATMÁR-BEREG,Nyírlugos,001,834,342,0,342,0,2,340
SZABOLCS-SZATMÁR-BEREG,Nyírlugos,002,969,356,0,356,0,3,353
SZABOLCS-SZATMÁR-BEREG,Nyírlugos,003,376,122,0,122,0,3,119
SZABOLCS-SZATMÁR-BEREG,Nyírmada,001,1026,197,0,197,0,1,196
SZABOLCS-SZATMÁR-BEREG,Nyírmada,002,862,166,0,166,0,1,165
SZABOLCS-SZATMÁR-BEREG,Nyírmada,003,922,259,0,259,0,1,258
SZABOLCS-SZATMÁR-BEREG,Nyírmada,004,850,240,0,240,0,2,238
SZABOLCS-SZATMÁR-BEREG,Nyírmeggyes,001,1120,427,0,427,0,1,426
SZABOLCS-SZATMÁR-BEREG,Nyírmeggyes,002,1043,357,0,357,0,0,357
SZABOLCS-SZATMÁR-BEREG,Nyírmihálydi,001,699,296,0,296,0,1,295
SZABOLCS-SZATMÁR-BEREG,Nyírmihálydi,002,761,262,0,262,0,1,261
SZABOLCS-SZATMÁR-BEREG,Nyírparasznya,001,741,375,0,375,0,5,370
SZABOLCS-SZATMÁR-BEREG,Nyírpazony,001,668,288,0,288,0,2,286
SZABOLCS-SZATMÁR-BEREG,Nyírpazony,002,684,286,0,286,0,0,286
SZABOLCS-SZATMÁR-BEREG,Nyírpazony,003,813,353,0,351,-2,6,345
SZABOLCS-SZATMÁR-BEREG,Nyírpazony,004,802,286,0,286,0,0,286
SZABOLCS-SZATMÁR-BEREG,Nyírpilis,001,572,245,0,245,0,3,242
SZABOLCS-SZATMÁR-BEREG,Nyírtass,001,888,301,0,301,0,0,301
SZABOLCS-SZATMÁR-BEREG,Nyírtass,002,740,209,1,208,-1,2,206
SZABOLCS-SZATMÁR-BEREG,Nyírtelek,001,889,344,0,344,0,2,342
SZABOLCS-SZATMÁR-BEREG,Nyírtelek,002,1082,375,0,375,0,1,374
SZABOLCS-SZATMÁR-BEREG,Nyírtelek,003,1120,327,0,327,0,3,324
SZABOLCS-SZATMÁR-BEREG,Nyírtelek,004,744,171,0,171,0,0,171
SZABOLCS-SZATMÁR-BEREG,Nyírtelek,005,1108,250,0,250,0,1,249
SZABOLCS-SZATMÁR-BEREG,Nyírtelek,006,710,312,0,312,0,0,312
SZABOLCS-SZATMÁR-BEREG,Nyírtét,001,869,323,0,323,0,2,321
SZABOLCS-SZATMÁR-BEREG,Nyírtura,001,689,225,0,225,0,2,223
SZABOLCS-SZATMÁR-BEREG,Nyírtura,002,848,302,0,302,0,3,299
SZABOLCS-SZATMÁR-BEREG,Nyírvasvári,001,806,314,0,314,0,2,312
SZABOLCS-SZATMÁR-BEREG,Nyírvasvári,002,787,327,0,327,0,4,323
SZABOLCS-SZATMÁR-BEREG,Olcsva,001,549,250,0,250,0,9,241
SZABOLCS-SZATMÁR-BEREG,Olcsvaapáti,001,250,160,0,160,0,0,160
SZABOLCS-SZATMÁR-BEREG,Ófehértó,001,1019,363,0,363,0,2,361
SZABOLCS-SZATMÁR-BEREG,Ófehértó,002,1077,360,0,360,0,8,352
SZABOLCS-SZATMÁR-BEREG,Ópályi,001,1007,391,0,391,0,4,387
SZABOLCS-SZATMÁR-BEREG,Ópályi,002,1230,272,0,272,0,5,267
SZABOLCS-SZATMÁR-BEREG,Ököritófülpös,001,697,249,1,248,-1,4,244
SZABOLCS-SZATMÁR-BEREG,Ököritófülpös,002,704,258,0,258,0,4,254
SZABOLCS-SZATMÁR-BEREG,Ömböly,001,372,134,0,134,0,1,133
SZABOLCS-SZATMÁR-BEREG,Õr,001,629,199,0,199,0,1,198
SZABOLCS-SZATMÁR-BEREG,Õr,002,553,187,0,187,0,4,183
SZABOLCS-SZATMÁR-BEREG,Panyola,001,491,226,0,226,0,2,224
SZABOLCS-SZATMÁR-BEREG,Pap,001,768,258,0,258,0,2,256
SZABOLCS-SZATMÁR-BEREG,Pap,002,768,218,0,218,0,2,216
SZABOLCS-SZATMÁR-BEREG,Papos,001,683,240,1,240,0,1,239
SZABOLCS-SZATMÁR-BEREG,Paszab,001,929,390,0,390,0,8,382
SZABOLCS-SZATMÁR-BEREG,Pátroha,001,743,307,0,307,0,2,305
SZABOLCS-SZATMÁR-BEREG,Pátroha,002,937,333,0,333,0,2,331
SZABOLCS-SZATMÁR-BEREG,Pátroha,003,639,248,0,248,0,1,247
SZABOLCS-SZATMÁR-BEREG,Pátyod,001,552,216,0,216,0,3,213
SZABOLCS-SZATMÁR-BEREG,Penészlek,001,775,365,0,365,0,3,362
SZABOLCS-SZATMÁR-BEREG,Penyige,001,640,280,0,280,0,3,277
SZABOLCS-SZATMÁR-BEREG,Petneháza,001,753,275,0,275,0,1,274
SZABOLCS-SZATMÁR-BEREG,Petneháza,002,678,260,0,260,0,6,254
SZABOLCS-SZATMÁR-BEREG,Piricse,001,611,292,0,292,0,2,290
SZABOLCS-SZATMÁR-BEREG,Piricse,002,685,273,0,273,0,2,271
SZABOLCS-SZATMÁR-BEREG,Porcsalma,001,683,290,0,290,0,1,289
SZABOLCS-SZATMÁR-BEREG,Porcsalma,002,704,255,0,255,0,2,253
SZABOLCS-SZATMÁR-BEREG,Porcsalma,003,655,231,0,231,0,0,231
SZABOLCS-SZATMÁR-BEREG,Pócspetri,001,678,256,0,256,0,1,255
SZABOLCS-SZATMÁR-BEREG,Pócspetri,002,674,211,0,211,0,1,210
SZABOLCS-SZATMÁR-BEREG,Pusztadobos,001,1138,511,0,511,0,9,502
SZABOLCS-SZATMÁR-BEREG,Rakamaz,001,665,248,0,248,0,2,246
SZABOLCS-SZATMÁR-BEREG,Rakamaz,002,865,289,0,289,0,0,289
SZABOLCS-SZATMÁR-BEREG,Rakamaz,003,749,186,0,186,0,0,186
SZABOLCS-SZATMÁR-BEREG,Rakamaz,004,651,239,0,239,0,4,235
SZABOLCS-SZATMÁR-BEREG,Rakamaz,005,826,252,0,252,0,0,252
SZABOLCS-SZATMÁR-BEREG,Ramocsaháza,001,1167,374,0,374,0,3,371
SZABOLCS-SZATMÁR-BEREG,Rápolt,001,112,38,0,38,0,1,37
SZABOLCS-SZATMÁR-BEREG,Rétközberencs,001,841,226,0,226,0,2,224
SZABOLCS-SZATMÁR-BEREG,Rohod,001,1003,502,2,502,0,9,493
SZABOLCS-SZATMÁR-BEREG,Rozsály,001,566,182,0,182,0,2,180
SZABOLCS-SZATMÁR-BEREG,Sényõ,001,1156,373,0,373,0,2,371
SZABOLCS-SZATMÁR-BEREG,Sonkád,001,680,308,0,308,0,5,303
SZABOLCS-SZATMÁR-BEREG,Szabolcs,001,286,143,0,143,0,2,141
SZABOLCS-SZATMÁR-BEREG,Szabolcsbáka,001,939,257,0,257,0,1,256
SZABOLCS-SZATMÁR-BEREG,Szabolcsveresmart,001,581,183,0,183,0,2,181
SZABOLCS-SZATMÁR-BEREG,Szabolcsveresmart,002,635,172,0,172,0,5,167
SZABOLCS-SZATMÁR-BEREG,Szakoly,001,817,215,0,215,0,1,214
SZABOLCS-SZATMÁR-BEREG,Szakoly,002,638,181,0,181,0,2,179
SZABOLCS-SZATMÁR-BEREG,Szakoly,003,684,146,0,146,0,1,145
SZABOLCS-SZATMÁR-BEREG,Szamosangyalos,001,423,165,0,165,0,2,163
SZABOLCS-SZATMÁR-BEREG,Szamosbecs,001,337,135,0,135,0,1,134
SZABOLCS-SZATMÁR-BEREG,Szamoskér,001,348,135,0,135,0,0,135
SZABOLCS-SZATMÁR-BEREG,Szamossályi,001,585,206,0,206,0,5,201
SZABOLCS-SZATMÁR-BEREG,Szamosszeg,001,639,321,0,321,0,0,321
SZABOLCS-SZATMÁR-BEREG,Szamosszeg,002,835,318,1,317,-1,3,314
SZABOLCS-SZATMÁR-BEREG,Szamostatárfalva,001,242,125,0,125,0,1,124
SZABOLCS-SZATMÁR-BEREG,Szamosújlak,001,332,156,0,156,0,3,153
SZABOLCS-SZATMÁR-BEREG,Szatmárcseke,001,606,264,0,264,0,0,264
SZABOLCS-SZATMÁR-BEREG,Szatmárcseke,002,607,240,0,240,0,3,237
SZABOLCS-SZATMÁR-BEREG,Székely,001,795,201,0,201,0,4,197
SZABOLCS-SZATMÁR-BEREG,Tarpa,001,998,339,0,339,0,9,330
SZABOLCS-SZATMÁR-BEREG,Tarpa,002,1030,484,0,484,0,5,479
SZABOLCS-SZATMÁR-BEREG,Tákos,001,287,187,0,187,0,0,187
SZABOLCS-SZATMÁR-BEREG,Terem,001,564,185,0,185,0,4,181
SZABOLCS-SZATMÁR-BEREG,Tiborszállás,001,832,312,0,312,0,0,312
SZABOLCS-SZATMÁR-BEREG,Timár,001,994,281,0,281,0,7,274
SZABOLCS-SZATMÁR-BEREG,Tiszaadony,001,515,303,0,303,0,3,300
SZABOLCS-SZATMÁR-BEREG,Tiszabecs,001,1204,393,0,393,0,8,385
SZABOLCS-SZATMÁR-BEREG,Tiszabercel,001,726,252,0,252,0,3,249
SZABOLCS-SZATMÁR-BEREG,Tiszabercel,002,678,270,0,270,0,1,269
SZABOLCS-SZATMÁR-BEREG,Tiszabezdéd,001,758,194,0,194,0,2,192
SZABOLCS-SZATMÁR-BEREG,Tiszabezdéd,002,751,197,0,197,0,3,194
SZABOLCS-SZATMÁR-BEREG,Tiszacsécse,001,207,116,0,116,0,2,114
SZABOLCS-SZATMÁR-BEREG,Tiszadada,001,599,191,0,191,0,3,188
SZABOLCS-SZATMÁR-BEREG,Tiszadada,002,533,264,0,264,0,1,263
SZABOLCS-SZATMÁR-BEREG,Tiszadada,003,567,210,0,210,0,1,209
SZABOLCS-SZATMÁR-BEREG,Tiszadob,001,532,186,0,186,0,1,185
SZABOLCS-SZATMÁR-BEREG,Tiszadob,002,683,217,0,217,0,1,216
SZABOLCS-SZATMÁR-BEREG,Tiszadob,003,724,198,0,198,0,0,198
SZABOLCS-SZATMÁR-BEREG,Tiszadob,004,116,51,0,51,0,1,50
SZABOLCS-SZATMÁR-BEREG,Tiszaeszlár,001,732,242,0,242,0,3,239
SZABOLCS-SZATMÁR-BEREG,Tiszaeszlár,002,692,154,0,154,0,0,154
SZABOLCS-SZATMÁR-BEREG,Tiszaeszlár,003,406,141,0,141,0,0,141
SZABOLCS-SZATMÁR-BEREG,Tiszaeszlár,004,105,52,0,52,0,0,52
SZABOLCS-SZATMÁR-BEREG,Tiszakanyár,001,590,301,0,301,0,4,297
SZABOLCS-SZATMÁR-BEREG,Tiszakanyár,002,651,269,0,269,0,0,269
SZABOLCS-SZATMÁR-BEREG,Tiszakerecseny,001,758,248,0,248,0,2,246
SZABOLCS-SZATMÁR-BEREG,Tiszakóród,001,644,266,0,266,0,8,258
SZABOLCS-SZATMÁR-BEREG,Tiszalök,001,961,363,0,363,0,3,360
SZABOLCS-SZATMÁR-BEREG,Tiszalök,002,1023,323,0,322,-1,0,322
SZABOLCS-SZATMÁR-BEREG,Tiszalök,003,862,301,0,300,-1,7,293
SZABOLCS-SZATMÁR-BEREG,Tiszalök,004,920,328,0,328,0,3,325
SZABOLCS-SZATMÁR-BEREG,Tiszalök,005,325,55,0,55,0,2,53
SZABOLCS-SZATMÁR-BEREG,Tiszalök,006,188,97,0,97,0,4,93
SZABOLCS-SZATMÁR-BEREG,Tiszamogyorós,001,517,234,0,234,0,0,234
SZABOLCS-SZATMÁR-BEREG,Tiszanagyfalu,001,603,172,0,172,0,0,172
SZABOLCS-SZATMÁR-BEREG,Tiszanagyfalu,002,624,212,0,212,0,1,211
SZABOLCS-SZATMÁR-BEREG,Tiszanagyfalu,003,292,99,0,99,0,2,97
SZABOLCS-SZATMÁR-BEREG,Tiszarád,001,419,89,0,89,0,1,88
SZABOLCS-SZATMÁR-BEREG,Tiszaszalka,001,821,329,0,329,0,1,328
SZABOLCS-SZATMÁR-BEREG,Tiszaszentmárton,001,951,293,0,293,0,3,290
SZABOLCS-SZATMÁR-BEREG,Tiszatelek,001,617,197,0,197,0,0,197
SZABOLCS-SZATMÁR-BEREG,Tiszatelek,002,518,167,0,167,0,2,165
SZABOLCS-SZATMÁR-BEREG,Tiszavasvári,001,755,125,0,125,0,0,125
SZABOLCS-SZATMÁR-BEREG,Tiszavasvári,002,708,168,0,168,0,1,167
SZABOLCS-SZATMÁR-BEREG,Tiszavasvári,003,994,377,0,377,0,1,376
SZABOLCS-SZATMÁR-BEREG,Tiszavasvári,004,1201,317,0,317,0,0,317
SZABOLCS-SZATMÁR-BEREG,Tiszavasvári,005,686,220,0,220,0,1,219
SZABOLCS-SZATMÁR-BEREG,Tiszavasvári,006,714,225,0,225,0,0,225
SZABOLCS-SZATMÁR-BEREG,Tiszavasvári,007,1075,387,0,387,0,0,387
SZABOLCS-SZATMÁR-BEREG,Tiszavasvári,008,1183,402,0,402,0,2,400
SZABOLCS-SZATMÁR-BEREG,Tiszavasvári,009,1094,393,0,393,0,1,392
SZABOLCS-SZATMÁR-BEREG,Tiszavasvári,010,1279,260,0,260,0,11,249
SZABOLCS-SZATMÁR-BEREG,Tiszavid,001,408,140,0,140,0,1,139
SZABOLCS-SZATMÁR-BEREG,Tisztaberek,001,515,239,0,239,0,0,239
SZABOLCS-SZATMÁR-BEREG,Tivadar,001,170,87,0,87,0,0,87
SZABOLCS-SZATMÁR-BEREG,Tornyospálca,001,628,215,0,215,0,4,211
SZABOLCS-SZATMÁR-BEREG,Tornyospálca,002,655,205,0,205,0,0,205
SZABOLCS-SZATMÁR-BEREG,Tornyospálca,003,775,175,0,175,0,2,173
SZABOLCS-SZATMÁR-BEREG,Tunyogmatolcs,001,721,316,1,315,-1,0,315
SZABOLCS-SZATMÁR-BEREG,Tunyogmatolcs,002,644,225,0,225,0,2,223
SZABOLCS-SZATMÁR-BEREG,Tunyogmatolcs,003,612,175,0,175,0,1,174
SZABOLCS-SZATMÁR-BEREG,Tuzsér,001,914,305,0,305,0,1,304
SZABOLCS-SZATMÁR-BEREG,Tuzsér,002,808,274,0,274,0,1,273
SZABOLCS-SZATMÁR-BEREG,Tuzsér,003,818,241,0,241,0,2,239
SZABOLCS-SZATMÁR-BEREG,Túristvándi,001,573,286,0,286,0,8,278
SZABOLCS-SZATMÁR-BEREG,Túrricse,001,538,253,1,251,-2,1,250
SZABOLCS-SZATMÁR-BEREG,Tyukod,001,511,172,0,172,0,2,170
SZABOLCS-SZATMÁR-BEREG,Tyukod,002,565,179,0,179,0,0,179
SZABOLCS-SZATMÁR-BEREG,Tyukod,003,503,124,0,124,0,1,123
SZABOLCS-SZATMÁR-BEREG,Ura,001,516,261,0,261,0,0,261
SZABOLCS-SZATMÁR-BEREG,Uszka,001,388,175,0,175,0,1,174
SZABOLCS-SZATMÁR-BEREG,Újdombrád,001,535,154,0,154,0,1,153
SZABOLCS-SZATMÁR-BEREG,Újfehértó,001,1202,470,0,470,0,2,468
SZABOLCS-SZATMÁR-BEREG,Újfehértó,002,1419,459,0,459,0,1,458
SZABOLCS-SZATMÁR-BEREG,Újfehértó,003,1172,344,0,344,0,0,344
SZABOLCS-SZATMÁR-BEREG,Újfehértó,004,1413,419,0,419,0,2,417
SZABOLCS-SZATMÁR-BEREG,Újfehértó,005,1357,316,0,316,0,1,315
SZABOLCS-SZATMÁR-BEREG,Újfehértó,006,1063,309,0,309,0,2,307
SZABOLCS-SZATMÁR-BEREG,Újfehértó,007,1157,384,0,384,0,1,383
SZABOLCS-SZATMÁR-BEREG,Újfehértó,008,1307,324,0,324,0,3,321
SZABOLCS-SZATMÁR-BEREG,Újkenéz,001,784,224,0,224,0,2,222
SZABOLCS-SZATMÁR-BEREG,Vaja,001,1012,270,0,270,0,5,265
SZABOLCS-SZATMÁR-BEREG,Vaja,002,1039,373,0,373,0,4,369
SZABOLCS-SZATMÁR-BEREG,Vaja,003,809,308,0,308,0,2,306
SZABOLCS-SZATMÁR-BEREG,Vasmegyer,001,613,145,0,145,0,0,145
SZABOLCS-SZATMÁR-BEREG,Vasmegyer,002,669,159,0,159,0,1,158
SZABOLCS-SZATMÁR-BEREG,Vállaj,001,1013,404,0,404,0,2,402
SZABOLCS-SZATMÁR-BEREG,Vámosatya,001,474,154,0,154,0,3,151
SZABOLCS-SZATMÁR-BEREG,Vámosoroszi,001,460,279,0,279,0,6,273
SZABOLCS-SZATMÁR-BEREG,Vásárosnamény,001,741,290,0,290,0,1,289
SZABOLCS-SZATMÁR-BEREG,Vásárosnamény,002,977,376,0,376,0,3,373
SZABOLCS-SZATMÁR-BEREG,Vásárosnamény,003,1134,548,0,548,0,0,548
SZABOLCS-SZATMÁR-BEREG,Vásárosnamény,004,952,285,0,285,0,2,283
SZABOLCS-SZATMÁR-BEREG,Vásárosnamény,005,683,315,0,315,0,4,311
SZABOLCS-SZATMÁR-BEREG,Vásárosnamény,006,580,243,0,243,0,4,239
SZABOLCS-SZATMÁR-BEREG,Vásárosnamény,007,828,352,0,352,0,2,350
SZABOLCS-SZATMÁR-BEREG,Vásárosnamény,008,1075,374,0,374,0,1,373
SZABOLCS-SZATMÁR-BEREG,Vásárosnamény,009,188,89,0,89,0,1,88
SZABOLCS-SZATMÁR-BEREG,Zajta,001,348,139,0,139,0,1,138
SZABOLCS-SZATMÁR-BEREG,Záhony,001,974,415,0,415,0,2,413
SZABOLCS-SZATMÁR-BEREG,Záhony,002,1029,413,0,413,0,12,401
SZABOLCS-SZATMÁR-BEREG,Záhony,003,808,360,0,360,0,8,352
SZABOLCS-SZATMÁR-BEREG,Záhony,004,860,371,0,371,0,8,363
SZABOLCS-SZATMÁR-BEREG,Zsarolyán,001,347,135,0,135,0,1,134
SZABOLCS-SZATMÁR-BEREG,Zsurk,001,582,261,0,261,0,8,253
SZABOLCS-SZATMÁR-BEREG,Szorgalmatos,001,797,276,0,276,0,4,272
TOLNA,Alsónána,001,575,248,0,248,0,2,246
TOLNA,Alsónyék,001,575,203,0,203,0,0,203
TOLNA,Aparhant,001,369,163,0,163,0,0,163
TOLNA,Aparhant,002,478,235,0,235,0,0,235
TOLNA,Attala,001,648,247,0,247,0,1,246
TOLNA,Báta,001,638,277,1,276,-1,3,273
TOLNA,Báta,002,644,225,0,225,0,8,217
TOLNA,Bátaapáti,001,330,99,0,99,0,0,99
TOLNA,Bátaszék,001,1066,402,0,402,0,3,399
TOLNA,Bátaszék,002,967,420,0,420,0,3,417
TOLNA,Bátaszék,003,1050,450,0,450,0,5,445
TOLNA,Bátaszék,004,1101,357,0,357,0,0,357
TOLNA,Bátaszék,005,1076,402,1,400,-2,11,389
TOLNA,Belecska,001,214,108,0,108,0,2,106
TOLNA,Bikács,001,373,148,0,148,0,1,147
TOLNA,Bogyiszló,001,886,297,0,297,0,2,295
TOLNA,Bogyiszló,002,855,296,0,296,0,2,294
TOLNA,Bonyhád,001,726,348,0,348,0,1,347
TOLNA,Bonyhád,002,683,315,0,315,0,2,313
TOLNA,Bonyhád,003,646,284,0,284,0,2,282
TOLNA,Bonyhád,004,650,296,1,296,0,0,296
TOLNA,Bonyhád,005,652,337,0,337,0,2,335
TOLNA,Bonyhád,006,669,319,0,319,0,1,318
TOLNA,Bonyhád,007,684,304,0,304,0,0,304
TOLNA,Bonyhád,008,714,338,0,338,0,0,338
TOLNA,Bonyhád,009,656,288,0,288,0,2,286
TOLNA,Bonyhád,010,663,332,0,332,0,1,331
TOLNA,Bonyhád,011,680,333,0,333,0,0,333
TOLNA,Bonyhád,012,665,331,0,331,0,1,330
TOLNA,Bonyhád,013,666,311,0,311,0,1,310
TOLNA,Bonyhád,014,632,324,0,323,-1,7,316
TOLNA,Bonyhád,015,929,418,0,417,-1,2,415
TOLNA,Bonyhád,016,271,92,0,92,0,0,92
TOLNA,Bonyhád,017,117,65,0,65,0,0,65
TOLNA,Bonyhádvarasd,001,376,202,0,202,0,0,202
TOLNA,Bölcske,001,773,300,0,300,0,0,300
TOLNA,Bölcske,002,718,275,0,275,0,1,274
TOLNA,Bölcske,003,700,244,1,243,-1,1,242
TOLNA,Cikó,001,745,257,0,257,0,0,257
TOLNA,Csibrák,001,240,81,0,81,0,0,81
TOLNA,Csikóstõttõs,001,658,240,0,240,0,1,239
TOLNA,Dalmand,001,864,313,0,312,-1,2,310
TOLNA,Dalmand,002,142,60,0,60,0,0,60
TOLNA,Decs,001,864,268,0,268,0,4,264
TOLNA,Decs,002,794,224,0,224,0,2,222
TOLNA,Decs,003,852,235,0,235,0,0,235
TOLNA,Decs,004,776,267,0,267,0,4,263
TOLNA,Diósberény,001,276,116,0,116,0,0,116
TOLNA,Dombóvár,001,734,250,0,250,0,0,250
TOLNA,Dombóvár,002,864,339,0,339,0,0,339
TOLNA,Dombóvár,003,825,323,0,323,0,1,322
TOLNA,Dombóvár,004,954,322,0,322,0,0,322
TOLNA,Dombóvár,005,685,330,1,329,-1,0,329
TOLNA,Dombóvár,006,550,211,0,211,0,2,209
TOLNA,Dombóvár,007,579,268,0,268,0,1,267
TOLNA,Dombóvár,008,826,393,0,393,0,2,391
TOLNA,Dombóvár,009,807,340,0,340,0,2,338
TOLNA,Dombóvár,010,907,424,0,424,0,2,422
TOLNA,Dombóvár,011,743,305,0,305,0,0,305
TOLNA,Dombóvár,012,611,227,0,227,0,0,227
TOLNA,Dombóvár,013,690,300,0,299,-1,1,298
TOLNA,Dombóvár,014,622,271,0,271,0,1,270
TOLNA,Dombóvár,015,711,302,0,302,0,1,301
TOLNA,Dombóvár,016,749,337,0,337,0,2,335
TOLNA,Dombóvár,017,692,307,0,307,0,1,306
TOLNA,Dombóvár,018,650,269,0,269,0,1,268
TOLNA,Dombóvár,019,721,276,2,274,-2,0,274
TOLNA,Dombóvár,020,596,211,0,211,0,7,204
TOLNA,Dombóvár,021,199,37,0,37,0,0,37
TOLNA,Dombóvár,022,611,234,0,234,0,0,234
TOLNA,Döbrököz,001,563,194,0,194,0,1,193
TOLNA,Döbrököz,002,486,126,0,126,0,0,126
TOLNA,Döbrököz,003,509,143,0,143,0,1,142
TOLNA,Dunaföldvár,001,1081,450,0,449,-1,1,448
TOLNA,Dunaföldvár,002,1069,535,0,535,0,0,535
TOLNA,Dunaföldvár,003,795,301,0,301,0,0,301
TOLNA,Dunaföldvár,004,770,244,0,244,0,0,244
TOLNA,Dunaföldvár,005,846,308,0,308,0,6,302
TOLNA,Dunaföldvár,006,1189,424,0,424,0,2,422
TOLNA,Dunaföldvár,007,1123,406,0,406,0,0,406
TOLNA,Dunaszentgyörgy,001,647,276,0,276,0,3,273
TOLNA,Dunaszentgyörgy,002,785,309,0,309,0,2,307
TOLNA,Dunaszentgyörgy,003,626,246,0,246,0,2,244
TOLNA,Dúzs,001,197,85,0,85,0,0,85
TOLNA,Értény,001,512,161,0,161,0,3,158
TOLNA,Fadd,001,836,220,0,220,0,6,214
TOLNA,Fadd,002,812,199,0,199,0,0,199
TOLNA,Fadd,003,889,359,0,359,0,5,354
TOLNA,Fadd,004,780,319,0,319,0,0,319
TOLNA,Fácánkert,001,554,170,0,170,0,1,169
TOLNA,Felsõnána,001,493,178,0,178,0,0,178
TOLNA,Felsõnyék,001,829,359,0,359,0,1,358
TOLNA,Fürged,001,511,107,0,107,0,0,107
TOLNA,Gerjen,001,1014,356,0,356,0,2,354
TOLNA,Grábóc,001,134,73,0,73,0,0,73
TOLNA,Gyönk,001,751,327,0,327,0,0,327
TOLNA,Gyönk,002,734,311,0,311,0,0,311
TOLNA,Györe,001,556,205,0,205,0,1,204
TOLNA,Györköny,001,806,307,0,307,0,1,306
TOLNA,Gyulaj,001,642,186,0,186,0,0,186
TOLNA,Harc,001,697,257,1,256,-1,2,254
TOLNA,Hõgyész,001,790,338,0,338,0,0,338
TOLNA,Hõgyész,002,714,251,0,251,0,2,249
TOLNA,Hõgyész,003,769,197,0,197,0,0,197
TOLNA,Iregszemcse,001,681,218,0,218,0,0,218
TOLNA,Iregszemcse,002,754,244,0,244,0,1,243
TOLNA,Iregszemcse,003,643,208,0,208,0,2,206
TOLNA,Izmény,001,379,142,0,142,0,0,142
TOLNA,Jágónak,001,198,67,0,67,0,0,67
TOLNA,Kajdacs,001,929,304,0,304,0,3,301
TOLNA,Kakasd,001,707,314,0,314,0,0,314
TOLNA,Kakasd,002,686,316,0,316,0,0,316
TOLNA,Kalaznó,001,109,50,0,50,0,2,48
TOLNA,Kapospula,001,530,241,0,241,0,0,241
TOLNA,Kapospula,002,152,61,0,61,0,0,61
TOLNA,Kaposszekcsõ,001,932,311,0,311,0,1,310
TOLNA,Kaposszekcsõ,002,295,108,0,108,0,1,107
TOLNA,Keszõhidegkút,001,173,96,0,96,0,1,95
TOLNA,Kéty,001,574,243,0,243,0,1,242
TOLNA,Kisdorog,001,629,237,1,236,-1,1,235
TOLNA,Kismányok,001,279,116,0,116,0,0,116
TOLNA,Kisszékely,001,244,132,0,132,0,1,131
TOLNA,Kistormás,001,276,113,0,113,0,2,111
TOLNA,Kisvejke,001,291,90,0,90,0,0,90
TOLNA,Kocsola,001,933,201,0,201,0,2,199
TOLNA,Koppányszántó,001,251,100,0,100,0,0,100
TOLNA,Kölesd,001,559,148,0,148,0,1,147
TOLNA,Kölesd,002,552,155,0,155,0,1,154
TOLNA,Kölesd,003,81,25,0,25,0,0,25
TOLNA,Kurd,001,911,254,0,254,0,1,253
TOLNA,Lápafõ,001,120,51,0,51,0,0,51
TOLNA,Lengyel,001,408,189,0,189,0,2,187
TOLNA,Madocsa,001,482,211,0,211,0,1,210
TOLNA,Madocsa,002,631,283,0,283,0,1,282
TOLNA,Madocsa,003,443,210,0,210,0,0,210
TOLNA,Magyarkeszi,001,839,192,0,192,0,2,190
TOLNA,Medina,001,534,192,0,192,0,1,191
TOLNA,Medina,002,92,28,0,28,0,0,28
TOLNA,Miszla,001,237,120,0,120,0,1,119
TOLNA,Mórágy,001,499,182,0,182,0,3,179
TOLNA,Mórágy,002,82,29,0,29,0,0,29
TOLNA,Mõcsény,001,281,112,0,112,0,0,112
TOLNA,Mucsfa,001,299,146,0,146,0,0,146
TOLNA,Mucsi,001,345,107,0,107,0,1,106
TOLNA,Murga,001,47,24,0,24,0,1,23
TOLNA,Nagydorog,001,663,239,0,239,0,1,238
TOLNA,Nagydorog,002,702,252,0,252,0,1,251
TOLNA,Nagydorog,003,750,230,0,230,0,0,230
TOLNA,Nagykónyi,001,56,20,0,20,0,0,20
TOLNA,Nagykónyi,002,788,275,0,275,0,2,273
TOLNA,Nagymányok,001,909,375,0,375,0,4,371
TOLNA,Nagymányok,002,988,465,0,465,0,6,459
TOLNA,Nagyszékely,001,314,144,0,144,0,0,144
TOLNA,Nagyszokoly,001,668,228,0,228,0,2,226
TOLNA,Nagyvejke,001,118,47,0,47,0,0,47
TOLNA,Nak,001,431,137,0,137,0,0,137
TOLNA,Németkér,001,718,259,0,259,0,1,258
TOLNA,Németkér,002,691,258,0,258,0,2,256
TOLNA,Ozora,001,650,229,0,229,0,0,229
TOLNA,Ozora,002,590,204,0,204,0,0,204
TOLNA,Õcsény,001,792,351,0,351,0,0,351
TOLNA,Õcsény,002,595,183,0,183,0,0,183
TOLNA,Õcsény,003,586,157,0,157,0,1,156
TOLNA,Paks,001,846,471,0,471,0,5,466
TOLNA,Paks,002,1068,451,0,451,0,3,448
TOLNA,Paks,003,967,474,0,474,0,1,473
TOLNA,Paks,004,1184,592,0,592,0,0,592
TOLNA,Paks,005,1017,477,0,477,0,2,475
TOLNA,Paks,006,955,403,0,403,0,2,401
TOLNA,Paks,007,1048,508,0,508,0,1,507
TOLNA,Paks,008,1059,560,0,560,0,1,559
TOLNA,Paks,009,897,359,0,359,0,0,359
TOLNA,Paks,010,944,332,0,332,0,2,330
TOLNA,Paks,011,963,420,0,420,0,0,420
TOLNA,Paks,012,848,400,0,400,0,0,400
TOLNA,Paks,013,986,468,0,468,0,0,468
TOLNA,Paks,014,917,339,0,339,0,1,338
TOLNA,Paks,015,950,324,0,324,0,4,320
TOLNA,Paks,016,275,88,0,88,0,1,87
TOLNA,Paks,017,309,89,0,89,0,0,89
TOLNA,Pálfa,001,623,197,0,197,0,3,194
TOLNA,Pálfa,002,444,154,0,154,0,1,153
TOLNA,Pálfa,003,66,31,0,31,0,2,29
TOLNA,Pincehely,001,1045,418,0,418,0,0,418
TOLNA,Pincehely,002,748,281,0,281,0,4,277
TOLNA,Pörböly,001,445,168,0,168,0,0,168
TOLNA,Pusztahencse,001,804,224,0,224,0,0,224
TOLNA,Regöly,001,875,360,0,360,0,3,357
TOLNA,Sárpilis,001,445,118,0,118,0,2,116
TOLNA,Sárszentlõrinc,001,570,207,0,207,0,1,206
TOLNA,Sárszentlõrinc,002,194,76,0,76,0,0,76
TOLNA,Sárszentlõrinc,003,69,27,0,27,0,0,27
TOLNA,Simontornya,001,1054,295,0,295,0,1,294
TOLNA,Simontornya,002,1102,378,0,378,0,0,378
TOLNA,Simontornya,003,1122,340,0,340,0,1,339
TOLNA,Sióagárd,001,511,303,0,303,0,2,301
TOLNA,Sióagárd,002,527,263,0,263,0,0,263
TOLNA,Szakadát,001,184,94,0,94,0,0,94
TOLNA,Szakály,001,612,246,0,246,0,14,232
TOLNA,Szakály,002,428,127,0,127,0,1,126
TOLNA,Szakcs,001,682,206,0,206,0,1,205
TOLNA,Szálka,001,535,265,0,265,0,2,263
TOLNA,Szárazd,001,191,114,0,114,0,1,113
TOLNA,Szedres,001,590,226,0,226,0,1,225
TOLNA,Szedres,002,633,239,0,239,0,3,236
TOLNA,Szedres,003,607,177,0,177,0,1,176
TOLNA,Szekszárd,001,1079,409,0,409,0,2,407
TOLNA,Szekszárd,002,699,347,0,346,-1,1,345
TOLNA,Szekszárd,003,737,290,0,290,0,2,288
TOLNA,Szekszárd,004,751,355,0,355,0,2,353
TOLNA,Szekszárd,005,325,72,0,72,0,0,72
TOLNA,Szekszárd,006,582,306,0,306,0,3,303
TOLNA,Szekszárd,007,589,276,0,276,0,0,276
TOLNA,Szekszárd,008,645,329,0,329,0,0,329
TOLNA,Szekszárd,009,463,276,0,276,0,4,272
TOLNA,Szekszárd,010,747,375,0,375,0,4,371
TOLNA,Szekszárd,011,1090,544,0,544,0,0,544
TOLNA,Szekszárd,012,692,333,0,333,0,0,333
TOLNA,Szekszárd,013,515,224,0,224,0,0,224
TOLNA,Szekszárd,014,465,205,0,205,0,1,204
TOLNA,Szekszárd,015,557,276,2,274,-2,3,271
TOLNA,Szekszárd,016,501,240,0,239,-1,1,238
TOLNA,Szekszárd,017,571,235,1,235,0,1,234
TOLNA,Szekszárd,018,613,325,1,324,-1,2,322
TOLNA,Szekszárd,019,980,545,0,545,0,2,543
TOLNA,Szekszárd,020,794,345,0,345,0,2,343
TOLNA,Szekszárd,021,559,350,1,349,-1,4,345
TOLNA,Szekszárd,022,530,281,0,281,0,3,278
TOLNA,Szekszárd,023,576,298,0,298,0,1,297
TOLNA,Szekszárd,024,513,280,0,280,0,0,280
TOLNA,Szekszárd,025,521,289,0,289,0,5,284
TOLNA,Szekszárd,026,655,323,0,323,0,3,320
TOLNA,Szekszárd,027,611,261,0,261,0,5,256
TOLNA,Szekszárd,028,611,250,0,250,0,5,245
TOLNA,Szekszárd,029,670,258,0,258,0,1,257
TOLNA,Szekszárd,030,831,285,0,285,0,2,283
TOLNA,Szekszárd,031,624,283,0,282,-1,1,281
TOLNA,Szekszárd,032,719,291,0,291,0,0,291
TOLNA,Szekszárd,033,657,295,0,295,0,1,294
TOLNA,Szekszárd,034,763,372,0,372,0,1,371
TOLNA,Szekszárd,035,688,310,0,311,1,9,302
TOLNA,Szekszárd,036,828,402,0,402,0,3,399
TOLNA,Szekszárd,037,916,404,0,404,0,0,404
TOLNA,Szekszárd,038,894,457,0,457,0,2,455
TOLNA,Szekszárd,039,959,437,0,437,0,2,435
TOLNA,Tamási,001,242,75,0,75,0,0,75
TOLNA,Tamási,002,920,419,0,419,0,4,415
TOLNA,Tamási,003,898,314,0,314,0,12,302
TOLNA,Tamási,004,891,400,0,400,0,3,397
TOLNA,Tamási,005,1021,432,0,432,0,3,429
TOLNA,Tamási,006,789,344,0,344,0,2,342
TOLNA,Tamási,007,275,71,0,71,0,0,71
TOLNA,Tamási,008,952,527,0,526,-1,2,524
TOLNA,Tamási,009,603,205,0,205,0,0,205
TOLNA,Tengelic,001,659,259,0,259,0,1,258
TOLNA,Tengelic,002,298,84,0,84,0,1,83
TOLNA,Tengelic,003,219,42,0,42,0,0,42
TOLNA,Tengelic,004,625,216,0,216,0,3,213
TOLNA,Tevel,001,571,209,0,209,0,1,208
TOLNA,Tevel,002,556,203,0,203,0,0,203
TOLNA,Tolna,001,1185,386,0,386,0,3,383
TOLNA,Tolna,002,661,258,0,258,0,2,256
TOLNA,Tolna,003,590,227,0,227,0,1,226
TOLNA,Tolna,004,1012,384,0,384,0,1,383
TOLNA,Tolna,005,701,292,0,292,0,1,291
TOLNA,Tolna,006,625,264,0,264,0,2,262
TOLNA,Tolna,007,719,223,0,223,0,3,220
TOLNA,Tolna,008,599,226,0,226,0,1,225
TOLNA,Tolna,009,583,260,0,260,0,2,258
TOLNA,Tolna,010,614,262,0,262,0,4,258
TOLNA,Tolna,011,899,398,0,398,0,2,396
TOLNA,Tolna,012,608,183,0,183,0,0,183
TOLNA,Tolna,013,589,201,0,201,0,0,201
TOLNA,Tolnanémedi,001,845,291,0,291,0,3,288
TOLNA,Udvari,001,268,100,0,100,0,0,100
TOLNA,Újireg,001,220,93,0,93,0,1,92
TOLNA,Varsád,001,290,137,0,137,0,1,136
TOLNA,Váralja,001,661,254,0,254,0,1,253
TOLNA,Várdomb,001,979,425,0,425,0,2,423
TOLNA,Várong,001,118,53,0,53,0,0,53
TOLNA,Závod,001,226,130,0,130,0,0,130
TOLNA,Zomba,001,632,287,0,286,-1,1,285
TOLNA,Zomba,002,478,192,0,192,0,0,192
TOLNA,Zomba,003,494,226,0,226,0,2,224
TOLNA,Zomba,004,93,50,0,50,0,0,50
TOLNA,Pári,001,500,192,0,192,0,0,192
VAS,Acsád,001,517,244,0,244,0,2,242
VAS,Alsószölnök,001,296,150,0,150,0,0,150
VAS,Alsóújlak,001,456,237,0,237,0,1,236
VAS,Andrásfa,001,192,89,0,89,0,0,89
VAS,Apátistvánfalva,001,338,183,0,183,0,0,183
VAS,Bajánsenye,001,393,241,0,241,0,0,241
VAS,Balogunyom,001,970,447,0,447,0,2,445
VAS,Bejcgyertyános,001,371,185,0,185,0,2,183
VAS,Bérbaltavár,001,399,123,0,123,0,0,123
VAS,Boba,001,696,343,0,343,0,2,341
VAS,Borgáta,001,135,79,0,79,0,0,79
VAS,Bozsok,001,308,197,0,197,0,1,196
VAS,Bozzai,001,248,132,0,132,0,4,128
VAS,Bögöt,001,315,178,0,178,0,0,178
VAS,Bögöte,001,253,124,0,124,0,0,124
VAS,Bõ,001,559,300,0,300,0,3,297
VAS,Bucsu,001,478,302,0,302,0,3,299
VAS,Bük,001,899,365,0,365,0,2,363
VAS,Bük,002,1006,498,0,498,0,0,498
VAS,Bük,003,976,441,0,441,0,3,438
VAS,Cák,001,230,136,0,136,0,0,136
VAS,Celldömölk,001,1087,497,0,497,0,3,494
VAS,Celldömölk,002,1000,536,0,536,0,4,532
VAS,Celldömölk,003,1043,471,0,471,0,1,470
VAS,Celldömölk,004,1030,506,0,506,0,1,505
VAS,Celldömölk,005,1038,510,0,510,0,4,506
VAS,Celldömölk,006,1079,449,0,449,0,2,447
VAS,Celldömölk,007,913,334,1,333,-1,1,332
VAS,Celldömölk,008,1171,465,0,465,0,2,463
VAS,Celldömölk,009,283,144,0,144,0,0,144
VAS,Chernelházadamonya,001,147,74,0,74,0,0,74
VAS,Csákánydoroszló,001,503,249,0,249,0,2,247
VAS,Csákánydoroszló,002,719,327,0,327,0,3,324
VAS,Csánig,001,288,161,0,161,0,1,160
VAS,Csehi,001,208,101,0,101,0,1,100
VAS,Csehimindszent,001,290,140,0,140,0,1,139
VAS,Csempeszkopács,001,276,144,0,144,0,2,142
VAS,Csepreg,001,1007,471,0,471,0,2,469
VAS,Csepreg,002,894,424,0,424,0,1,423
VAS,Csepreg,003,750,389,0,389,0,5,384
VAS,Csénye,001,545,252,0,252,0,2,250
VAS,Csipkerek,001,274,156,0,156,0,0,156
VAS,Csönge,001,313,136,0,136,0,2,134
VAS,Csörötnek,001,714,285,0,285,0,1,284
VAS,Daraboshegy,001,79,42,0,42,0,0,42
VAS,Dozmat,001,200,135,0,135,0,2,133
VAS,Döbörhegy,001,117,69,0,69,0,1,68
VAS,Döröske,001,84,60,0,60,0,0,60
VAS,Duka,001,215,102,0,102,0,2,100
VAS,Egervölgy,001,280,110,0,110,0,1,109
VAS,Egyházashetye,001,282,135,0,135,0,0,135
VAS,Egyházashollós,001,460,220,0,220,0,4,216
VAS,Egyházasrádóc,001,1072,592,0,590,-2,4,586
VAS,Felsõcsatár,001,374,184,0,184,0,0,184
VAS,Felsõjánosfa,001,166,111,0,111,0,0,111
VAS,Felsõmarác,001,220,119,0,119,0,3,116
VAS,Felsõszölnök,001,479,222,0,222,0,2,220
VAS,Gasztony,001,353,166,0,166,0,1,165
VAS,Gencsapáti,001,1050,582,0,582,0,3,579
VAS,Gencsapáti,002,1091,570,0,570,0,1,569
VAS,Gersekarát,001,560,246,0,246,0,2,244
VAS,Gérce,001,931,328,0,328,0,2,326
VAS,Gór,001,218,132,0,132,0,0,132
VAS,Gyanógeregye,001,119,63,0,63,0,0,63
VAS,Gyöngyösfalu,001,883,449,0,448,-1,3,445
VAS,Gyõrvár,001,531,234,0,234,0,0,234
VAS,Halastó,001,73,43,0,43,0,1,42
VAS,Halogy,001,217,125,0,125,0,1,124
VAS,Harasztifalu,001,128,63,0,63,0,0,63
VAS,Hegyfalu,001,641,315,1,314,-1,2,312
VAS,Hegyháthodász,001,131,86,0,86,0,0,86
VAS,Hegyhátsál,001,123,74,0,74,0,0,74
VAS,Hegyhátszentjakab,001,238,128,0,128,0,3,125
VAS,Hegyhátszentmárton,001,53,43,0,43,0,0,43
VAS,Hegyhátszentpéter,001,125,77,0,77,0,2,75
VAS,Horvátlövõ,001,156,102,0,102,0,0,102
VAS,Horvátzsidány,001,670,330,0,330,0,0,330
VAS,Hosszúpereszteg,001,564,236,0,236,0,0,236
VAS,Ikervár,001,751,328,0,328,0,1,327
VAS,Ikervár,002,690,285,0,285,0,0,285
VAS,Iklanberény,001,39,20,0,20,0,0,20
VAS,Ispánk,001,100,69,0,69,0,0,69
VAS,Ivánc,001,407,201,0,201,0,3,198
VAS,Ják,001,1110,401,0,401,0,0,401
VAS,Ják,002,934,364,0,364,0,9,355
VAS,Jákfa,001,403,181,0,181,0,2,179
VAS,Jánosháza,001,696,252,0,252,0,1,251
VAS,Jánosháza,002,633,245,0,245,0,3,242
VAS,Jánosháza,003,736,224,1,223,-1,1,222
VAS,Karakó,001,168,56,0,56,0,0,56
VAS,Katafa,001,275,155,0,155,0,0,155
VAS,Káld,001,858,361,0,361,0,4,357
VAS,Kám,001,395,179,0,179,0,0,179
VAS,Keléd,001,65,32,0,32,0,0,32
VAS,Kemeneskápolna,001,77,45,0,45,0,1,44
VAS,Kemenesmagasi,001,713,312,0,312,0,0,312
VAS,Kemenesmihályfa,001,433,182,0,182,0,4,178
VAS,Kemenespálfa,001,333,123,0,123,0,0,123
VAS,Kemenessömjén,001,473,177,0,177,0,0,177
VAS,Kemenesszentmárton,001,170,72,0,72,0,0,72
VAS,Kemestaródfa,001,184,108,0,108,0,0,108
VAS,Kenéz,001,220,99,0,99,0,1,98
VAS,Kenyeri,001,689,360,0,360,0,1,359
VAS,Kercaszomor,001,200,116,0,116,0,2,114
VAS,Kerkáskápolna,001,55,39,0,39,0,0,39
VAS,Kétvölgy,001,112,65,0,65,0,0,65
VAS,Kisrákos,001,160,100,0,100,0,0,100
VAS,Kissomlyó,001,197,72,0,72,0,0,72
VAS,Kisunyom,001,362,176,0,176,0,1,175
VAS,Kiszsidány,001,68,42,0,42,0,0,42
VAS,Kondorfa,001,423,219,0,219,0,3,216
VAS,Köcsk,001,215,100,0,100,0,1,99
VAS,Körmend,001,1028,553,0,553,0,0,553
VAS,Körmend,002,1081,481,0,480,-1,1,479
VAS,Körmend,003,1130,579,0,577,-2,2,575
VAS,Körmend,004,1208,623,0,621,-2,4,617
VAS,Körmend,005,1268,602,0,602,0,2,600
VAS,Körmend,006,1187,618,0,618,0,3,615
VAS,Körmend,007,1137,555,0,555,0,1,554
VAS,Körmend,008,367,173,0,173,0,1,172
VAS,Körmend,009,695,378,0,378,0,0,378
VAS,Körmend,010,148,97,0,97,0,0,97
VAS,Kõszeg,001,1130,539,0,539,0,1,538
VAS,Kõszeg,002,1310,694,0,693,-1,4,689
VAS,Kõszeg,003,1072,492,0,492,0,3,489
VAS,Kõszeg,004,1128,495,0,495,0,3,492
VAS,Kõszeg,005,1093,525,0,525,0,1,524
VAS,Kõszeg,006,1408,744,0,743,-1,4,739
VAS,Kõszeg,007,1053,472,0,472,0,0,472
VAS,Kõszeg,008,695,331,0,331,0,3,328
VAS,Kõszeg,009,421,249,0,249,0,1,248
VAS,Kõszegdoroszló,001,207,118,0,118,0,2,116
VAS,Kõszegpaty,001,153,72,0,72,0,0,72
VAS,Kõszegszerdahely,001,406,216,0,216,0,2,214
VAS,Lócs,001,89,52,0,52,0,0,52
VAS,Lukácsháza,001,888,453,0,453,0,3,450
VAS,Magyarlak,001,657,328,0,328,0,0,328
VAS,Magyarnádalja,001,184,107,0,107,0,0,107
VAS,Magyarszecsõd,001,364,195,0,195,0,4,191
VAS,Magyarszombatfa,001,222,123,0,123,0,1,122
VAS,Meggyeskovácsi,001,549,208,0,208,0,1,207
VAS,Megyehíd,001,259,129,0,129,0,0,129
VAS,Mersevát,001,477,229,0,229,0,2,227
VAS,Mesterháza,001,136,69,0,69,0,0,69
VAS,Mesteri,001,178,92,0,92,0,1,91
VAS,Meszlen,001,181,113,0,113,0,4,109
VAS,Mikosszéplak,001,244,98,0,98,0,1,97
VAS,Molnaszecsõd,001,334,181,0,181,0,1,180
VAS,Nagygeresd,001,222,111,0,111,0,1,110
VAS,Nagykölked,001,117,61,0,61,0,0,61
VAS,Nagymizdó,001,96,73,0,73,0,0,73
VAS,Nagyrákos,001,221,111,0,111,0,0,111
VAS,Nagysimonyi,001,810,376,0,376,0,1,375
VAS,Nagytilaj,001,103,33,0,33,0,0,33
VAS,Narda,001,407,265,0,265,0,1,264
VAS,Nádasd,001,1071,505,0,505,0,5,500
VAS,Nárai,001,1098,517,0,517,0,2,515
VAS,Nemesbõd,001,520,244,0,244,0,2,242
VAS,Nemescsó,001,244,144,0,144,0,2,142
VAS,Nemeskeresztúr,001,237,104,0,104,0,0,104
VAS,Nemeskocs,001,262,128,0,128,0,0,128
VAS,Nemeskolta,001,300,132,0,132,0,1,131
VAS,Nemesládony,001,110,62,0,62,0,0,62
VAS,Nemesmedves,001,24,14,0,14,0,0,14
VAS,Nemesrempehollós,001,228,100,0,100,0,2,98
VAS,Nick,001,441,235,0,235,0,1,234
VAS,Nyõgér,001,270,144,0,144,0,2,142
VAS,Olaszfa,001,321,144,0,144,0,0,144
VAS,Orfalu,001,70,44,0,44,0,0,44
VAS,Ostffyasszonyfa,001,649,298,0,298,0,1,297
VAS,Oszkó,001,539,222,0,222,0,1,221
VAS,Ólmod,001,88,50,0,50,0,0,50
VAS,Ölbõ,001,587,235,0,235,0,0,235
VAS,Õrimagyarósd,001,197,126,0,126,0,0,126
VAS,Õriszentpéter,001,977,525,0,525,0,1,524
VAS,Pankasz,001,360,162,0,162,0,0,162
VAS,Pácsony,001,244,116,0,116,0,2,114
VAS,Pápoc,001,239,147,0,147,0,1,146
VAS,Pecöl,001,650,298,0,298,0,1,297
VAS,Perenye,001,559,309,0,309,0,1,308
VAS,Peresznye,001,432,250,0,250,0,4,246
VAS,Petõmihályfa,001,176,100,0,100,0,3,97
VAS,Pinkamindszent,001,145,83,0,83,0,3,80
VAS,Pornóapáti,001,277,172,0,172,0,3,169
VAS,Porpác,001,115,62,0,62,0,2,60
VAS,Pósfa,001,225,126,0,126,0,1,125
VAS,Pusztacsó,001,128,74,0,74,0,2,72
VAS,Püspökmolnári,001,717,381,0,381,0,5,376
VAS,Rábagyarmat,001,640,300,0,300,0,4,296
VAS,Rábahídvég,001,779,269,0,269,0,1,268
VAS,Rábapaty,001,721,265,0,265,0,1,264
VAS,Rábapaty,002,646,250,0,250,0,0,250
VAS,Rábatöttös,001,196,100,0,100,0,0,100
VAS,Rádóckölked,001,226,130,0,130,0,0,130
VAS,Rátót,001,187,85,0,85,0,1,84
VAS,Répcelak,001,648,332,0,332,0,0,332
VAS,Répcelak,002,873,430,0,430,0,2,428
VAS,Répcelak,003,654,319,0,319,0,2,317
VAS,Répceszentgyörgy,001,97,59,0,59,0,1,58
VAS,Rönök,001,339,130,0,130,0,0,130
VAS,Rum,001,924,365,0,365,0,2,363
VAS,Sajtoskál,001,244,130,0,130,0,0,130
VAS,Salköveskút,001,387,200,0,200,0,0,200
VAS,Sárfimizdó,001,81,55,0,55,0,0,55
VAS,Sárvár,001,828,384,0,384,0,3,381
VAS,Sárvár,002,539,198,0,198,0,0,198
VAS,Sárvár,003,601,286,0,286,0,4,282
VAS,Sárvár,004,669,300,0,300,0,1,299
VAS,Sárvár,005,45,27,0,27,0,0,27
VAS,Sárvár,006,678,344,0,344,0,0,344
VAS,Sárvár,007,653,345,0,345,0,0,345
VAS,Sárvár,008,833,418,0,417,-1,0,417
VAS,Sárvár,009,676,313,0,313,0,1,312
VAS,Sárvár,010,891,441,0,441,0,3,438
VAS,Sárvár,011,620,284,0,284,0,1,283
VAS,Sárvár,012,702,342,0,342,0,2,340
VAS,Sárvár,013,776,347,0,347,0,2,345
VAS,Sárvár,014,910,522,0,522,0,1,521
VAS,Sárvár,015,826,340,0,340,0,1,339
VAS,Sárvár,016,1061,523,1,522,-1,5,517
VAS,Sárvár,017,510,226,0,226,0,2,224
VAS,Sárvár,018,101,55,0,55,0,0,55
VAS,Sé,001,1102,531,0,531,0,1,530
VAS,Simaság,001,431,220,0,220,0,4,216
VAS,Sitke,001,569,276,0,276,0,3,273
VAS,Sorkifalud,001,313,134,0,134,0,1,133
VAS,Sorkifalud,002,135,69,0,69,0,1,68
VAS,Sorkifalud,003,87,39,0,39,0,0,39
VAS,Sorkikápolna,001,204,99,0,99,0,1,98
VAS,Sorokpolány,001,662,295,0,295,0,0,295
VAS,Sótony,001,513,249,0,249,0,1,248
VAS,Söpte,001,651,302,0,302,0,4,298
VAS,Szaknyér,001,49,42,0,42,0,0,42
VAS,Szakonyfalu,001,298,157,0,157,0,1,156
VAS,Szalafõ,001,182,101,0,101,0,1,100
VAS,Szarvaskend,001,195,124,0,124,0,0,124
VAS,Szatta,001,59,42,0,42,0,0,42
VAS,Szeleste,001,527,247,0,247,0,1,246
VAS,Szemenye,001,274,91,0,91,0,1,90
VAS,Szentgotthárd,001,622,222,0,222,0,2,220
VAS,Szentgotthárd,002,680,304,0,304,0,2,302
VAS,Szentgotthárd,003,719,339,0,339,0,2,337
VAS,Szentgotthárd,004,778,461,0,461,0,1,460
VAS,Szentgotthárd,005,699,369,0,369,0,1,368
VAS,Szentgotthárd,006,649,319,0,319,0,1,318
VAS,Szentgotthárd,007,635,322,0,322,0,0,322
VAS,Szentgotthárd,008,377,169,0,169,0,0,169
VAS,Szentgotthárd,009,682,386,0,386,0,4,382
VAS,Szentgotthárd,010,217,120,0,120,0,0,120
VAS,Szentgotthárd,011,307,153,0,153,0,1,152
VAS,Szentgotthárd,012,283,148,0,148,0,0,148
VAS,Szentgotthárd,013,58,41,0,41,0,0,41
VAS,Szentpéterfa,001,838,471,0,471,0,1,470
VAS,Szergény,001,246,106,0,106,0,0,106
VAS,Szombathely,001,864,525,0,525,0,0,525
VAS,Szombathely,002,906,514,0,514,0,1,513
VAS,Szombathely,003,893,510,0,510,0,2,508
VAS,Szombathely,004,871,514,0,514,0,2,512
VAS,Szombathely,005,1058,554,0,554,0,0,554
VAS,Szombathely,006,1020,496,0,496,0,5,491
VAS,Szombathely,007,1008,588,0,585,-3,0,585
VAS,Szombathely,008,874,418,0,418,0,5,413
VAS,Szombathely,009,687,327,0,327,0,4,323
VAS,Szombathely,010,735,298,0,299,1,12,287
VAS,Szombathely,011,844,423,0,423,0,0,423
VAS,Szombathely,012,942,426,0,426,0,1,425
VAS,Szombathely,013,876,422,0,422,0,0,422
VAS,Szombathely,014,855,332,0,332,0,3,329
VAS,Szombathely,015,848,382,0,382,0,2,380
VAS,Szombathely,016,776,366,0,366,0,3,363
VAS,Szombathely,017,785,386,0,386,0,0,386
VAS,Szombathely,018,867,383,0,383,0,1,382
VAS,Szombathely,019,866,371,1,370,-1,2,368
VAS,Szombathely,020,843,397,0,397,0,2,395
VAS,Szombathely,021,908,398,0,398,0,0,398
VAS,Szombathely,022,820,345,0,344,-1,0,344
VAS,Szombathely,023,875,443,0,443,0,2,441
VAS,Szombathely,024,809,383,0,383,0,0,383
VAS,Szombathely,025,781,365,0,365,0,1,364
VAS,Szombathely,026,991,476,0,476,0,0,476
VAS,Szombathely,027,830,470,2,468,-2,1,467
VAS,Szombathely,028,714,329,0,328,-1,2,326
VAS,Szombathely,029,768,423,0,423,0,1,422
VAS,Szombathely,030,1030,569,0,569,0,1,568
VAS,Szombathely,031,716,284,1,283,-1,0,283
VAS,Szombathely,032,711,306,0,306,0,2,304
VAS,Szombathely,033,983,444,0,444,0,4,440
VAS,Szombathely,034,881,442,0,442,0,0,442
VAS,Szombathely,035,1009,550,0,549,-1,1,548
VAS,Szombathely,036,933,474,0,474,0,4,470
VAS,Szombathely,037,680,406,0,406,0,3,403
VAS,Szombathely,038,1015,509,0,509,0,3,506
VAS,Szombathely,039,915,420,0,420,0,2,418
VAS,Szombathely,040,1330,798,0,798,0,9,789
VAS,Szombathely,041,876,392,0,392,0,0,392
VAS,Szombathely,042,823,365,0,365,0,2,363
VAS,Szombathely,043,810,418,0,418,0,1,417
VAS,Szombathely,044,920,418,0,417,-1,0,417
VAS,Szombathely,045,952,528,0,528,0,2,526
VAS,Szombathely,046,825,400,0,400,0,1,399
VAS,Szombathely,047,1031,574,0,574,0,3,571
VAS,Szombathely,048,873,480,1,479,-1,0,479
VAS,Szombathely,049,903,350,0,350,0,0,350
VAS,Szombathely,050,874,424,0,422,-2,1,421
VAS,Szombathely,051,1165,631,0,631,0,5,626
VAS,Szombathely,052,1431,745,0,744,-1,0,744
VAS,Szombathely,053,986,553,0,553,0,1,552
VAS,Szombathely,054,999,566,0,566,0,0,566
VAS,Szombathely,055,1443,801,0,801,0,6,795
VAS,Szombathely,056,681,370,0,370,0,1,369
VAS,Szombathely,057,776,439,0,439,0,3,436
VAS,Szombathely,058,693,339,0,339,0,5,334
VAS,Szombathely,059,469,233,0,232,-1,0,232
VAS,Szombathely,060,690,392,0,392,0,1,391
VAS,Szombathely,061,998,560,0,560,0,3,557
VAS,Szombathely,062,981,480,0,480,0,2,478
VAS,Szombathely,063,787,409,0,409,0,5,404
VAS,Szombathely,064,942,472,0,472,0,3,469
VAS,Szombathely,065,603,339,0,339,0,1,338
VAS,Szombathely,066,1258,643,0,643,0,5,638
VAS,Szombathely,067,1312,711,0,711,0,1,710
VAS,Szombathely,068,1006,494,0,494,0,0,494
VAS,Szombathely,069,745,407,0,407,0,1,406
VAS,Szõce,001,282,156,0,156,0,0,156
VAS,Tanakajd,001,612,300,0,300,0,0,300
VAS,Táplánszentkereszt,001,1064,483,0,483,0,5,478
VAS,Táplánszentkereszt,002,987,454,0,454,0,1,453
VAS,Telekes,001,413,172,0,172,0,1,171
VAS,Tokorcs,001,276,144,0,144,0,2,142
VAS,Tompaládony,001,252,130,0,130,0,1,129
VAS,Tormásliget,001,268,135,0,135,0,1,134
VAS,Torony,001,834,375,0,375,0,2,373
VAS,Torony,002,734,203,0,203,0,0,203
VAS,Tömörd,001,238,138,0,138,0,2,136
VAS,Uraiújfalu,001,410,169,0,169,0,0,169
VAS,Uraiújfalu,002,301,119,0,119,0,0,119
VAS,Vasalja,001,283,134,0,134,0,1,133
VAS,Vasasszonyfa,001,311,175,0,175,0,3,172
VAS,Vasegerszeg,001,309,177,0,177,0,0,177
VAS,Vashosszúfalu,001,312,158,0,158,0,3,155
VAS,Vaskeresztes,001,277,201,0,201,0,0,201
VAS,Vassurány,001,658,308,0,308,0,0,308
VAS,Vasszentmihály,001,285,143,0,143,0,0,143
VAS,Vasszécseny,001,477,188,0,188,0,0,188
VAS,Vasszécseny,002,645,298,0,298,0,1,297
VAS,Vasszilvágy,001,342,163,0,163,0,1,162
VAS,Vasvár,001,628,318,0,318,0,0,318
VAS,Vasvár,002,613,273,0,273,0,0,273
VAS,Vasvár,003,669,243,0,243,0,2,241
VAS,Vasvár,004,691,344,0,344,0,0,344
VAS,Vasvár,005,703,352,0,352,0,0,352
VAS,Vasvár,006,87,43,0,43,0,1,42
VAS,Vasvár,007,60,37,0,37,0,0,37
VAS,Vámoscsalád,001,254,158,0,158,0,0,158
VAS,Vásárosmiske,001,283,160,0,160,0,2,158
VAS,Vát,001,565,222,0,222,0,3,219
VAS,Velem,001,330,190,0,190,0,0,190
VAS,Velemér,001,67,50,0,50,0,0,50
VAS,Vép,001,739,215,0,215,0,0,215
VAS,Vép,002,656,273,0,273,0,0,273
VAS,Vép,003,696,324,0,324,0,2,322
VAS,Vép,004,611,291,0,291,0,0,291
VAS,Viszák,001,225,126,0,126,0,0,126
VAS,Vönöck,001,610,294,0,294,0,2,292
VAS,Zsennye,001,85,55,0,55,0,0,55
VAS,Zsédeny,001,166,83,0,83,0,0,83
VESZPRÉM,Adásztevel,001,676,298,0,298,0,4,294
VESZPRÉM,Adorjánháza,001,308,109,0,109,0,3,106
VESZPRÉM,Ajka,001,942,409,0,409,0,2,407
VESZPRÉM,Ajka,002,917,416,0,416,0,0,416
VESZPRÉM,Ajka,003,715,357,1,357,0,1,356
VESZPRÉM,Ajka,004,1048,527,1,526,-1,1,525
VESZPRÉM,Ajka,005,732,304,0,304,0,1,303
VESZPRÉM,Ajka,006,871,324,0,324,0,0,324
VESZPRÉM,Ajka,007,610,251,0,251,0,0,251
VESZPRÉM,Ajka,008,871,394,0,393,-1,0,393
VESZPRÉM,Ajka,009,924,288,0,288,0,0,288
VESZPRÉM,Ajka,010,834,336,0,336,0,2,334
VESZPRÉM,Ajka,011,713,343,0,343,0,0,343
VESZPRÉM,Ajka,012,999,377,0,377,0,6,371
VESZPRÉM,Ajka,013,637,231,0,231,0,0,231
VESZPRÉM,Ajka,014,991,400,0,400,0,1,399
VESZPRÉM,Ajka,015,848,364,0,364,0,1,363
VESZPRÉM,Ajka,016,766,320,0,320,0,1,319
VESZPRÉM,Ajka,017,609,281,0,281,0,0,281
VESZPRÉM,Ajka,018,876,413,0,413,0,1,412
VESZPRÉM,Ajka,019,823,364,0,364,0,0,364
VESZPRÉM,Ajka,020,734,391,0,391,0,0,391
VESZPRÉM,Ajka,021,753,303,0,303,0,4,299
VESZPRÉM,Ajka,022,1005,419,0,418,-1,0,418
VESZPRÉM,Ajka,023,813,299,0,299,0,1,298
VESZPRÉM,Ajka,024,452,140,0,140,0,1,139
VESZPRÉM,Ajka,025,889,467,0,467,0,1,466
VESZPRÉM,Ajka,026,893,457,0,457,0,2,455
VESZPRÉM,Ajka,027,773,253,0,253,0,2,251
VESZPRÉM,Ajka,028,621,229,0,229,0,0,229
VESZPRÉM,Ajka,029,911,345,0,345,0,2,343
VESZPRÉM,Alsóörs,001,921,549,0,549,0,0,549
VESZPRÉM,Alsóörs,002,701,377,0,377,0,1,376
VESZPRÉM,Apácatorna,001,131,59,0,59,0,1,58
VESZPRÉM,Aszófõ,001,407,252,0,252,0,4,248
VESZPRÉM,Ábrahámhegy,001,543,367,0,367,0,1,366
VESZPRÉM,Badacsonytomaj,001,845,512,0,512,0,1,511
VESZPRÉM,Badacsonytomaj,002,566,281,0,281,0,4,277
VESZPRÉM,Badacsonytomaj,003,579,256,0,256,0,1,255
VESZPRÉM,Badacsonytördemic,001,796,445,0,445,0,2,443
VESZPRÉM,Bakonybél,001,1018,465,0,464,-1,0,464
VESZPRÉM,Bakonyjákó,001,590,304,0,304,0,4,300
VESZPRÉM,Bakonykoppány,001,179,96,0,96,0,1,95
VESZPRÉM,Bakonynána,001,819,276,0,276,0,2,274
VESZPRÉM,Bakonyoszlop,001,370,169,0,169,0,0,169
VESZPRÉM,Bakonypölöske,001,327,119,0,119,0,0,119
VESZPRÉM,Bakonyság,001,59,36,0,36,0,1,35
VESZPRÉM,Bakonyszentiván,001,168,87,0,87,0,1,86
VESZPRÉM,Bakonyszentkirály,001,689,234,0,234,0,0,234
VESZPRÉM,Bakonyszücs,001,253,140,0,140,0,0,140
VESZPRÉM,Bakonytamási,001,503,203,0,203,0,0,203
VESZPRÉM,Balatonakali,001,677,372,1,371,-1,1,370
VESZPRÉM,Balatonalmádi,001,945,488,0,488,0,2,486
VESZPRÉM,Balatonalmádi,002,888,496,0,496,0,2,494
VESZPRÉM,Balatonalmádi,003,998,566,0,566,0,4,562
VESZPRÉM,Balatonalmádi,004,1191,797,0,797,0,2,795
VESZPRÉM,Balatonalmádi,005,948,509,0,509,0,1,508
VESZPRÉM,Balatonalmádi,006,1064,446,0,446,0,2,444
VESZPRÉM,Balatonalmádi,007,1071,512,0,511,-1,1,510
VESZPRÉM,Balatonalmádi,008,996,555,0,555,0,2,553
VESZPRÉM,Balatoncsicsó,001,200,94,0,94,0,0,94
VESZPRÉM,Balatonederics,001,882,418,0,418,0,2,416
VESZPRÉM,Balatonfõkajár,001,1127,450,0,450,0,7,443
VESZPRÉM,Balatonfüred,001,1285,609,0,609,0,3,606
VESZPRÉM,Balatonfüred,002,1271,512,0,512,0,4,508
VESZPRÉM,Balatonfüred,003,1393,557,0,557,0,1,556
VESZPRÉM,Balatonfüred,004,1366,552,0,552,0,0,552
VESZPRÉM,Balatonfüred,005,2302,1509,0,1509,0,2,1507
VESZPRÉM,Balatonfüred,006,1314,634,0,634,0,2,632
VESZPRÉM,Balatonfüred,007,1386,727,0,727,0,0,727
VESZPRÉM,Balatonfüred,008,1387,723,0,723,0,1,722
VESZPRÉM,Balatonfûzfõ,001,906,497,0,497,0,2,495
VESZPRÉM,Balatonfûzfõ,002,756,378,0,378,0,0,378
VESZPRÉM,Balatonfûzfõ,003,670,308,0,308,0,1,307
VESZPRÉM,Balatonfûzfõ,004,748,292,0,292,0,1,291
VESZPRÉM,Balatonfûzfõ,005,705,389,0,389,0,0,389
VESZPRÉM,Balatonhenye,001,110,61,0,61,0,0,61
VESZPRÉM,Balatonkenese,001,786,384,0,384,0,3,381
VESZPRÉM,Balatonkenese,002,721,335,0,335,0,3,332
VESZPRÉM,Balatonkenese,003,904,546,0,546,0,0,546
VESZPRÉM,Balatonrendes,001,175,121,0,121,0,0,121
VESZPRÉM,Balatonszepezd,001,464,272,0,272,0,8,264
VESZPRÉM,Balatonszõlõs,001,527,236,0,236,0,1,235
VESZPRÉM,Balatonudvari,001,372,239,0,239,0,3,236
VESZPRÉM,Barnag,001,114,77,0,77,0,0,77
VESZPRÉM,Bazsi,001,355,106,0,106,0,0,106
VESZPRÉM,Bánd,001,546,298,0,298,0,2,296
VESZPRÉM,Berhida,001,793,226,0,226,0,0,226
VESZPRÉM,Berhida,002,816,210,0,210,0,2,208
VESZPRÉM,Berhida,003,839,186,0,186,0,0,186
VESZPRÉM,Berhida,004,935,274,0,274,0,2,272
VESZPRÉM,Berhida,005,629,206,0,206,0,3,203
VESZPRÉM,Berhida,006,596,229,0,229,0,0,229
VESZPRÉM,Béb,001,199,120,0,120,0,2,118
VESZPRÉM,Békás,001,165,74,0,74,0,0,74
VESZPRÉM,Bodorfa,001,86,49,0,49,0,0,49
VESZPRÉM,Borszörcsök,001,281,133,0,133,0,0,133
VESZPRÉM,Borzavár,001,606,235,0,235,0,1,234
VESZPRÉM,Csabrendek,001,666,299,0,299,0,0,299
VESZPRÉM,Csabrendek,002,642,217,0,217,0,3,214
VESZPRÉM,Csabrendek,003,712,238,0,238,0,0,238
VESZPRÉM,Csabrendek,004,281,60,0,60,0,0,60
VESZPRÉM,Csabrendek,005,57,45,0,45,0,0,45
VESZPRÉM,Csajág,001,700,236,0,236,0,2,234
VESZPRÉM,Csehbánya,001,246,142,0,142,0,1,141
VESZPRÉM,Csesznek,001,436,200,0,200,0,2,198
VESZPRÉM,Csetény,001,749,316,0,316,0,2,314
VESZPRÉM,Csetény,002,773,333,0,333,0,0,333
VESZPRÉM,Csopak,001,928,560,0,556,-4,3,553
VESZPRÉM,Csopak,002,888,507,0,507,0,3,504
VESZPRÉM,Csót,001,806,314,0,314,0,3,311
VESZPRÉM,Csögle,001,518,198,0,198,0,1,197
VESZPRÉM,Dabronc,001,355,126,0,126,0,2,124
VESZPRÉM,Dabrony,001,330,104,0,104,0,5,99
VESZPRÉM,Dáka,001,347,157,0,157,0,1,156
VESZPRÉM,Devecser,001,871,283,0,283,0,7,276
VESZPRÉM,Devecser,002,896,330,0,330,0,3,327
VESZPRÉM,Devecser,003,866,325,0,325,0,1,324
VESZPRÉM,Devecser,004,880,250,0,250,0,1,249
VESZPRÉM,Doba,001,379,200,0,200,0,1,199
VESZPRÉM,Döbrönte,001,233,122,0,122,0,0,122
VESZPRÉM,Dörgicse,001,254,163,0,163,0,0,163
VESZPRÉM,Dudar,001,674,242,0,242,0,2,240
VESZPRÉM,Dudar,002,709,279,0,279,0,0,279
VESZPRÉM,Egeralja,001,185,129,0,129,0,1,128
VESZPRÉM,Egyházaskeszõ,001,398,160,0,160,0,0,160
VESZPRÉM,Eplény,001,431,233,0,233,0,0,233
VESZPRÉM,Farkasgyepû,001,356,220,0,220,0,4,216
VESZPRÉM,Felsõörs,001,1421,755,0,755,0,1,754
VESZPRÉM,Ganna,001,224,142,0,142,0,1,141
VESZPRÉM,Gecse,001,326,120,0,120,0,1,119
VESZPRÉM,Gic,001,305,115,0,115,0,0,115
VESZPRÉM,Gógánfa,001,641,222,0,222,0,1,221
VESZPRÉM,Gyepükaján,001,271,124,0,124,0,0,124
VESZPRÉM,Gyulakeszi,001,604,241,0,241,0,1,240
VESZPRÉM,Hajmáskér,001,933,395,0,395,0,3,392
VESZPRÉM,Hajmáskér,002,683,205,0,205,0,1,204
VESZPRÉM,Hajmáskér,003,852,193,0,193,0,1,192
VESZPRÉM,Halimba,001,960,344,0,344,0,4,340
VESZPRÉM,Hárskút,001,548,276,0,276,0,0,276
VESZPRÉM,Hegyesd,001,142,91,0,91,0,0,91
VESZPRÉM,Hegymagas,001,238,134,0,134,0,0,134
VESZPRÉM,Herend,001,730,382,0,382,0,2,380
VESZPRÉM,Herend,002,718,334,0,334,0,1,333
VESZPRÉM,Herend,003,670,290,0,290,0,1,289
VESZPRÉM,Herend,004,721,307,0,307,0,1,306
VESZPRÉM,Hetyefõ,001,76,29,0,29,0,0,29
VESZPRÉM,Hidegkút,001,363,176,0,176,0,1,175
VESZPRÉM,Homokbödöge,001,566,231,0,231,0,1,230
VESZPRÉM,Hosztót,001,60,39,0,39,0,0,39
VESZPRÉM,Iszkáz,001,277,135,0,135,0,2,133
VESZPRÉM,Jásd,001,615,301,0,301,0,3,298
VESZPRÉM,Kamond,001,281,121,0,121,0,3,118
VESZPRÉM,Kapolcs,001,309,131,0,131,0,0,131
VESZPRÉM,Karakószörcsök,001,225,108,0,108,0,0,108
VESZPRÉM,Káptalanfa,001,661,237,0,237,0,2,235
VESZPRÉM,Káptalantóti,001,401,191,0,191,0,0,191
VESZPRÉM,Kemeneshõgyész,001,371,129,0,129,0,1,128
VESZPRÉM,Kemenesszentpéter,001,492,202,0,202,0,1,201
VESZPRÉM,Kerta,001,461,187,0,187,0,1,186
VESZPRÉM,Kékkút,001,66,49,0,49,0,0,49
VESZPRÉM,Királyszentistván,001,421,169,0,169,0,1,168
VESZPRÉM,Kisapáti,001,309,135,0,135,0,1,134
VESZPRÉM,Kisberzseny,001,81,36,0,36,0,0,36
VESZPRÉM,Kiscsõsz,001,90,56,0,56,0,0,56
VESZPRÉM,Kislõd,001,969,349,0,349,0,2,347
VESZPRÉM,Kispirit,001,60,34,0,34,0,1,33
VESZPRÉM,Kisszõlõs,001,96,34,0,34,0,0,34
VESZPRÉM,Kolontár,001,592,200,0,200,0,1,199
VESZPRÉM,Köveskál,001,319,170,0,170,0,2,168
VESZPRÉM,Kõvágóörs,001,662,316,0,316,0,3,313
VESZPRÉM,Kup,001,369,116,0,116,0,0,116
VESZPRÉM,Külsõvat,001,635,254,0,254,0,5,249
VESZPRÉM,Küngös,001,446,167,0,167,0,2,165
VESZPRÉM,Lesencefalu,001,261,126,0,126,0,1,125
VESZPRÉM,Lesenceistvánd,001,796,305,0,305,0,0,305
VESZPRÉM,Lesencetomaj,001,797,308,0,308,0,0,308
VESZPRÉM,Litér,001,895,384,1,384,0,0,384
VESZPRÉM,Litér,002,876,373,1,372,-1,0,372
VESZPRÉM,Lovas,001,404,238,0,238,0,2,236
VESZPRÉM,Lovászpatona,001,915,318,0,317,-1,7,310
VESZPRÉM,Lókút,001,374,158,0,157,-1,0,157
VESZPRÉM,Magyargencs,001,427,154,0,154,0,1,153
VESZPRÉM,Magyarpolány,001,1106,506,0,506,0,4,502
VESZPRÉM,Malomsok,001,427,213,0,213,0,1,212
VESZPRÉM,Marcalgergelyi,001,318,114,0,114,0,0,114
VESZPRÉM,Marcaltõ,001,432,163,0,163,0,0,163
VESZPRÉM,Marcaltõ,002,205,99,0,99,0,1,98
VESZPRÉM,Márkó,001,1151,605,0,605,0,1,604
VESZPRÉM,Megyer,001,28,14,0,14,0,0,14
VESZPRÉM,Mencshely,001,237,126,0,126,0,1,125
VESZPRÉM,Mezõlak,001,760,277,0,277,0,2,275
VESZPRÉM,Mihályháza,001,609,233,0,233,0,3,230
VESZPRÉM,Mindszentkálla,001,241,104,0,104,0,0,104
VESZPRÉM,Monostorapáti,001,905,395,0,395,0,1,394
VESZPRÉM,Monoszló,001,108,66,0,66,0,0,66
VESZPRÉM,Nagyacsád,001,535,205,0,205,0,2,203
VESZPRÉM,Nagyalásony,001,389,176,0,176,0,1,175
VESZPRÉM,Nagydém,001,274,99,0,99,0,1,98
VESZPRÉM,Nagyesztergár,001,951,339,0,339,0,0,339
VESZPRÉM,Nagygyimót,001,465,235,0,235,0,1,234
VESZPRÉM,Nagypirit,001,226,102,0,102,0,1,101
VESZPRÉM,Nagytevel,001,449,211,0,211,0,0,211
VESZPRÉM,Nagyvázsony,001,840,402,0,402,0,1,401
VESZPRÉM,Nagyvázsony,002,643,240,0,240,0,4,236
VESZPRÉM,Nemesgörzsöny,001,530,239,0,239,0,1,238
VESZPRÉM,Nemesgulács,001,840,387,0,387,0,2,385
VESZPRÉM,Nemeshany,001,298,119,0,119,0,0,119
VESZPRÉM,Nemesszalók,001,704,282,0,282,0,1,281
VESZPRÉM,Nemesvámos,001,1163,551,0,545,-6,1,544
VESZPRÉM,Nemesvámos,002,1173,577,0,577,0,2,575
VESZPRÉM,Nemesvita,001,299,144,1,143,-1,0,143
VESZPRÉM,Németbánya,001,81,55,0,55,0,1,54
VESZPRÉM,Noszlop,001,794,296,0,296,0,1,295
VESZPRÉM,Nóráp,001,183,115,0,115,0,1,114
VESZPRÉM,Nyárád,001,720,371,0,371,0,3,368
VESZPRÉM,Nyirád,001,810,304,0,304,0,1,303
VESZPRÉM,Nyirád,002,708,276,0,276,0,1,275
VESZPRÉM,Olaszfalu,001,854,382,0,382,0,1,381
VESZPRÉM,Oroszi,001,117,51,0,51,0,0,51
VESZPRÉM,Óbudavár,001,43,34,0,34,0,1,33
VESZPRÉM,Öcs,001,161,78,0,78,0,1,77
VESZPRÉM,Örvényes,001,165,115,0,115,0,1,114
VESZPRÉM,Öskü,001,1073,427,0,427,0,0,427
VESZPRÉM,Öskü,002,784,280,0,280,0,1,279
VESZPRÉM,Õsi,001,1022,353,1,353,0,1,352
VESZPRÉM,Õsi,002,644,246,0,246,0,4,242
VESZPRÉM,Paloznak,001,455,292,0,292,0,2,290
VESZPRÉM,Papkeszi,001,1101,327,0,327,0,0,327
VESZPRÉM,Papkeszi,002,185,81,0,81,0,1,80
VESZPRÉM,Pápa,001,902,400,0,400,0,1,399
VESZPRÉM,Pápa,002,776,340,1,339,-1,1,338
VESZPRÉM,Pápa,003,772,290,0,290,0,3,287
VESZPRÉM,Pápa,004,909,518,0,518,0,1,517
VESZPRÉM,Pápa,005,783,442,0,442,0,6,436
VESZPRÉM,Pápa,006,909,405,0,405,0,5,400
VESZPRÉM,Pápa,007,988,415,0,415,0,1,414
VESZPRÉM,Pápa,008,586,304,0,304,0,0,304
VESZPRÉM,Pápa,009,648,345,0,345,0,0,345
VESZPRÉM,Pápa,010,928,538,0,538,0,6,532
VESZPRÉM,Pápa,011,938,540,0,539,-1,2,537
VESZPRÉM,Pápa,012,624,321,0,321,0,1,320
VESZPRÉM,Pápa,013,688,365,0,365,0,2,363
VESZPRÉM,Pápa,014,763,314,0,314,0,0,314
VESZPRÉM,Pápa,015,1047,459,0,459,0,2,457
VESZPRÉM,Pápa,016,990,405,0,405,0,4,401
VESZPRÉM,Pápa,017,647,295,0,295,0,0,295
VESZPRÉM,Pápa,018,781,272,0,272,0,4,268
VESZPRÉM,Pápa,019,663,364,0,364,0,0,364
VESZPRÉM,Pápa,020,365,184,0,184,0,3,181
VESZPRÉM,Pápa,021,695,321,0,321,0,0,321
VESZPRÉM,Pápa,022,630,308,0,308,0,1,307
VESZPRÉM,Pápa,023,983,497,0,497,0,3,494
VESZPRÉM,Pápa,024,772,363,0,363,0,0,363
VESZPRÉM,Pápa,025,701,343,0,342,-1,0,342
VESZPRÉM,Pápa,026,607,305,0,305,0,0,305
VESZPRÉM,Pápa,027,657,284,0,284,0,1,283
VESZPRÉM,Pápa,028,974,427,0,427,0,1,426
VESZPRÉM,Pápa,029,762,266,0,266,0,1,265
VESZPRÉM,Pápa,030,1071,333,0,332,-1,3,329
VESZPRÉM,Pápa,031,699,369,0,369,0,0,369
VESZPRÉM,Pápadereske,001,215,106,0,106,0,1,105
VESZPRÉM,Pápakovácsi,001,475,218,0,218,0,0,218
VESZPRÉM,Pápasalamon,001,264,84,0,84,0,0,84
VESZPRÉM,Pápateszér,001,944,356,0,356,0,2,354
VESZPRÉM,Pécsely,001,504,272,0,272,0,2,270
VESZPRÉM,Pénzesgyõr,001,286,115,0,115,0,0,115
VESZPRÉM,Pétfürdõ,001,613,234,0,234,0,1,233
VESZPRÉM,Pétfürdõ,002,813,323,0,323,0,0,323
VESZPRÉM,Pétfürdõ,003,776,235,0,235,0,0,235
VESZPRÉM,Pétfürdõ,004,859,326,0,325,-1,1,324
VESZPRÉM,Pétfürdõ,005,778,268,0,268,0,3,265
VESZPRÉM,Porva,001,377,172,0,172,0,1,171
VESZPRÉM,Pula,001,160,93,0,93,0,0,93
VESZPRÉM,Pusztamiske,001,308,98,0,98,0,1,97
VESZPRÉM,Raposka,001,210,112,0,112,0,0,112
VESZPRÉM,Révfülöp,001,1114,659,0,659,0,4,655
VESZPRÉM,Rigács,001,159,53,0,53,0,0,53
VESZPRÉM,Salföld,001,75,49,0,49,0,0,49
VESZPRÉM,Sáska,001,225,111,0,111,0,2,109
VESZPRÉM,Somlójenõ,001,236,89,0,89,0,2,87
VESZPRÉM,Somlószõlõs,001,539,225,0,225,0,6,219
VESZPRÉM,Somlóvásárhely,001,900,322,0,322,0,4,318
VESZPRÉM,Somlóvecse,001,68,38,0,38,0,0,38
VESZPRÉM,Sóly,001,420,213,0,213,0,4,209
VESZPRÉM,Sümeg,001,832,354,0,353,-1,2,351
VESZPRÉM,Sümeg,002,620,284,0,284,0,2,282
VESZPRÉM,Sümeg,003,592,193,0,193,0,0,193
VESZPRÉM,Sümeg,004,780,347,0,347,0,3,344
VESZPRÉM,Sümeg,005,669,332,0,331,-1,2,329
VESZPRÉM,Sümeg,006,791,330,0,330,0,0,330
VESZPRÉM,Sümeg,007,725,283,0,283,0,2,281
VESZPRÉM,Sümegprága,001,519,192,0,192,0,1,191
VESZPRÉM,Szápár,001,404,148,0,148,0,4,144
VESZPRÉM,Szentantalfa,001,369,142,0,142,0,2,140
VESZPRÉM,Szentbékkálla,001,214,139,0,139,0,1,138
VESZPRÉM,Szentgál,001,788,250,0,250,0,1,249
VESZPRÉM,Szentgál,002,705,278,0,278,0,2,276
VESZPRÉM,Szentgál,003,712,232,0,231,-1,0,231
VESZPRÉM,Szentimrefalva,001,174,66,0,66,0,0,66
VESZPRÉM,Szentjakabfa,001,88,57,0,57,0,0,57
VESZPRÉM,Szentkirályszabadja,001,804,348,0,348,0,2,346
VESZPRÉM,Szentkirályszabadja,002,826,373,0,373,0,1,372
VESZPRÉM,Szigliget,001,833,452,0,452,0,0,452
VESZPRÉM,Szõc,001,356,152,0,152,0,0,152
VESZPRÉM,Tagyon,001,81,56,0,56,0,0,56
VESZPRÉM,Takácsi,001,689,285,0,285,0,0,285
VESZPRÉM,Taliándörögd,001,556,202,0,202,0,0,202
VESZPRÉM,Tapolca,001,876,490,0,490,0,1,489
VESZPRÉM,Tapolca,002,950,335,1,334,-1,3,331
VESZPRÉM,Tapolca,003,1255,573,0,573,0,3,570
VESZPRÉM,Tapolca,004,804,344,0,344,0,3,341
VESZPRÉM,Tapolca,005,875,401,0,401,0,0,401
VESZPRÉM,Tapolca,006,847,396,0,396,0,1,395
VESZPRÉM,Tapolca,007,847,369,0,369,0,0,369
VESZPRÉM,Tapolca,008,883,430,0,430,0,1,429
VESZPRÉM,Tapolca,009,794,364,0,364,0,2,362
VESZPRÉM,Tapolca,010,960,400,0,400,0,1,399
VESZPRÉM,Tapolca,011,808,326,0,326,0,0,326
VESZPRÉM,Tapolca,012,888,444,0,444,0,1,443
VESZPRÉM,Tapolca,013,801,382,0,382,0,2,380
VESZPRÉM,Tapolca,014,647,343,0,343,0,4,339
VESZPRÉM,Tapolca,015,708,316,0,316,0,0,316
VESZPRÉM,Tés,001,698,311,0,311,0,1,310
VESZPRÉM,Tihany,001,1269,724,0,724,0,5,719
VESZPRÉM,Tótvázsony,001,1088,490,0,489,-1,4,485
VESZPRÉM,Tüskevár,001,472,205,0,205,0,1,204
VESZPRÉM,Ugod,001,1083,426,0,426,0,4,422
VESZPRÉM,Ukk,001,275,97,0,97,0,1,96
VESZPRÉM,Uzsa,001,279,134,0,134,0,2,132
VESZPRÉM,Úrkút,001,869,294,0,294,0,1,293
VESZPRÉM,Úrkút,002,837,336,0,336,0,3,333
VESZPRÉM,Vanyola,001,446,174,0,174,0,2,172
VESZPRÉM,Vaszar,001,635,254,0,254,0,2,252
VESZPRÉM,Vaszar,002,607,267,0,267,0,0,267
VESZPRÉM,Várkeszõ,001,151,81,0,81,0,1,80
VESZPRÉM,Városlõd,001,1080,490,0,490,0,4,486
VESZPRÉM,Várpalota,001,870,388,0,388,0,4,384
VESZPRÉM,Várpalota,002,974,324,0,324,0,0,324
VESZPRÉM,Várpalota,003,817,333,0,332,-1,10,322
VESZPRÉM,Várpalota,004,955,422,0,422,0,2,420
VESZPRÉM,Várpalota,005,1046,413,0,413,0,1,412
VESZPRÉM,Várpalota,006,1024,391,0,391,0,0,391
VESZPRÉM,Várpalota,007,676,280,0,280,0,2,278
VESZPRÉM,Várpalota,008,748,353,0,353,0,4,349
VESZPRÉM,Várpalota,009,713,277,0,277,0,3,274
VESZPRÉM,Várpalota,010,815,334,0,334,0,2,332
VESZPRÉM,Várpalota,011,798,284,0,284,0,1,283
VESZPRÉM,Várpalota,012,1003,377,1,376,-1,5,371
VESZPRÉM,Várpalota,013,779,324,0,324,0,1,323
VESZPRÉM,Várpalota,014,895,397,0,397,0,0,397
VESZPRÉM,Várpalota,015,1088,485,2,482,-3,3,479
VESZPRÉM,Várpalota,016,984,363,0,363,0,0,363
VESZPRÉM,Várpalota,017,761,336,0,336,0,0,336
VESZPRÉM,Várpalota,018,753,359,1,358,-1,1,357
VESZPRÉM,Várpalota,019,788,233,0,233,0,3,230
VESZPRÉM,Vászoly,001,217,142,0,142,0,2,140
VESZPRÉM,Veszprém,001,1469,927,0,927,0,3,924
VESZPRÉM,Veszprém,002,806,407,0,407,0,4,403
VESZPRÉM,Veszprém,003,697,400,0,400,0,4,396
VESZPRÉM,Veszprém,004,1102,593,0,592,-1,1,591
VESZPRÉM,Veszprém,005,819,494,0,494,0,6,488
VESZPRÉM,Veszprém,006,735,434,0,433,-1,1,432
VESZPRÉM,Veszprém,007,841,501,0,501,0,2,499
VESZPRÉM,Veszprém,008,1076,599,0,598,-1,3,595
VESZPRÉM,Veszprém,009,823,402,0,401,-1,1,400
VESZPRÉM,Veszprém,010,855,427,0,427,0,2,425
VESZPRÉM,Veszprém,011,937,565,0,565,0,2,563
VESZPRÉM,Veszprém,012,876,420,0,420,0,0,420
VESZPRÉM,Veszprém,013,1079,608,0,608,0,0,608
VESZPRÉM,Veszprém,014,812,528,0,528,0,1,527
VESZPRÉM,Veszprém,015,585,286,0,286,0,0,286
VESZPRÉM,Veszprém,016,705,351,0,351,0,1,350
VESZPRÉM,Veszprém,017,598,380,0,380,0,1,379
VESZPRÉM,Veszprém,018,671,374,0,374,0,0,374
VESZPRÉM,Veszprém,019,683,416,0,416,0,1,415
VESZPRÉM,Veszprém,020,690,431,0,431,0,1,430
VESZPRÉM,Veszprém,021,746,422,0,422,0,1,421
VESZPRÉM,Veszprém,022,653,299,0,299,0,2,297
VESZPRÉM,Veszprém,023,807,402,0,402,0,2,400
VESZPRÉM,Veszprém,024,918,478,0,478,0,1,477
VESZPRÉM,Veszprém,025,1041,514,0,514,0,2,512
VESZPRÉM,Veszprém,026,930,446,0,446,0,0,446
VESZPRÉM,Veszprém,027,1050,595,0,595,0,1,594
VESZPRÉM,Veszprém,028,557,205,1,204,-1,2,202
VESZPRÉM,Veszprém,029,760,450,0,450,0,1,449
VESZPRÉM,Veszprém,030,661,398,0,397,-1,1,396
VESZPRÉM,Veszprém,031,1055,609,0,609,0,4,605
VESZPRÉM,Veszprém,032,940,578,0,578,0,1,577
VESZPRÉM,Veszprém,033,660,279,0,279,0,1,278
VESZPRÉM,Veszprém,034,980,443,0,443,0,1,442
VESZPRÉM,Veszprém,035,910,398,0,397,-1,1,396
VESZPRÉM,Veszprém,036,844,334,0,334,0,1,333
VESZPRÉM,Veszprém,037,609,229,0,229,0,2,227
VESZPRÉM,Veszprém,038,852,341,0,341,0,0,341
VESZPRÉM,Veszprém,039,691,260,0,260,0,2,258
VESZPRÉM,Veszprém,040,893,358,0,358,0,0,358
VESZPRÉM,Veszprém,041,600,217,0,215,-2,1,214
VESZPRÉM,Veszprém,042,705,286,0,286,0,0,286
VESZPRÉM,Veszprém,043,808,317,0,317,0,3,314
VESZPRÉM,Veszprém,044,920,409,0,409,0,4,405
VESZPRÉM,Veszprém,045,766,317,0,317,0,0,317
VESZPRÉM,Veszprém,046,618,275,0,275,0,0,275
VESZPRÉM,Veszprém,047,599,290,1,289,-1,0,289
VESZPRÉM,Veszprém,048,384,209,0,209,0,1,208
VESZPRÉM,Veszprém,049,750,387,0,387,0,0,387
VESZPRÉM,Veszprém,050,1026,471,0,471,0,1,470
VESZPRÉM,Veszprém,051,832,365,0,365,0,2,363
VESZPRÉM,Veszprém,052,231,113,0,113,0,1,112
VESZPRÉM,Veszprém,053,1173,594,0,594,0,3,591
VESZPRÉM,Veszprém,054,787,397,0,395,-2,0,395
VESZPRÉM,Veszprém,055,742,366,0,366,0,2,364
VESZPRÉM,Veszprém,056,793,337,0,337,0,3,334
VESZPRÉM,Veszprémfajsz,001,199,124,0,124,0,2,122
VESZPRÉM,Veszprémgalsa,001,220,90,0,90,0,1,89
VESZPRÉM,Vid,001,105,47,0,47,0,0,47
VESZPRÉM,Vigántpetend,001,165,73,0,73,0,1,72
VESZPRÉM,Vilonya,001,527,191,0,191,0,0,191
VESZPRÉM,Vinár,001,190,92,0,92,0,0,92
VESZPRÉM,Vöröstó,001,67,37,0,37,0,0,37
VESZPRÉM,Zalaerdõd,001,203,48,0,48,0,0,48
VESZPRÉM,Zalagyömörõ,001,342,136,0,136,0,1,135
VESZPRÉM,Zalahaláp,001,1028,388,0,388,0,0,388
VESZPRÉM,Zalameggyes,001,45,21,0,21,0,1,20
VESZPRÉM,Zalaszegvár,001,123,69,0,69,0,0,69
VESZPRÉM,Zánka,001,864,468,0,468,0,5,463
VESZPRÉM,Zirc,001,774,316,0,316,0,5,311
VESZPRÉM,Zirc,002,752,285,0,285,0,2,283
VESZPRÉM,Zirc,003,786,345,0,344,-1,4,340
VESZPRÉM,Zirc,004,749,349,0,349,0,0,349
VESZPRÉM,Zirc,005,837,405,0,405,0,2,403
VESZPRÉM,Zirc,006,695,347,0,347,0,3,344
VESZPRÉM,Zirc,007,986,491,0,490,-1,6,484
VESZPRÉM,Balatonakarattya,001,896,543,0,543,0,4,539
ZALA,Alibánfa,001,341,172,0,172,0,1,171
ZALA,Almásháza,001,64,38,0,38,0,0,38
ZALA,Alsónemesapáti,001,576,247,0,247,0,1,246
ZALA,Alsópáhok,001,1197,547,0,547,0,6,541
ZALA,Alsórajk,001,271,78,0,78,0,0,78
ZALA,Alsószenterzsébet,001,52,38,0,38,0,1,37
ZALA,Babosdöbréte,001,409,216,0,216,0,0,216
ZALA,Baglad,001,36,26,0,26,0,0,26
ZALA,Bagod,001,1026,442,0,442,0,3,439
ZALA,Bak,001,662,309,0,309,0,2,307
ZALA,Bak,002,675,287,0,287,0,3,284
ZALA,Baktüttös,001,278,96,0,96,0,0,96
ZALA,Balatongyörök,001,1039,615,0,613,-2,2,611
ZALA,Balatonmagyaród,001,382,119,0,119,0,0,119
ZALA,Barlahida,001,110,68,0,68,0,0,68
ZALA,Batyk,001,296,111,0,111,0,0,111
ZALA,Bánokszentgyörgy,001,474,173,0,173,0,6,167
ZALA,Bázakerettye,001,482,241,0,241,0,2,239
ZALA,Bázakerettye,002,102,52,0,52,0,0,52
ZALA,Becsehely,001,634,247,0,247,0,0,247
ZALA,Becsehely,002,590,230,0,230,0,0,230
ZALA,Becsehely,003,477,158,0,158,0,3,155
ZALA,Becsvölgye,001,645,260,0,260,0,0,260
ZALA,Belezna,001,615,206,0,206,0,3,203
ZALA,Belsõsárd,001,87,56,0,56,0,0,56
ZALA,Bezeréd,001,110,57,0,57,0,1,56
ZALA,Bocfölde,001,932,400,0,400,0,2,398
ZALA,Bocska,001,248,86,0,86,0,0,86
ZALA,Boncodfölde,001,259,144,0,144,0,0,144
ZALA,Borsfa,001,582,192,0,192,0,5,187
ZALA,Bókaháza,001,237,105,0,105,0,1,104
ZALA,Böde,001,222,103,0,103,0,1,102
ZALA,Bödeháza,001,36,26,0,26,0,0,26
ZALA,Börzönce,001,43,21,0,21,0,1,20
ZALA,Búcsúszentlászló,001,590,301,0,301,0,1,300
ZALA,Bucsuta,001,176,78,0,78,0,0,78
ZALA,Csapi,001,121,49,0,49,0,0,49
ZALA,Csatár,001,426,193,0,193,0,0,193
ZALA,Cserszegtomaj,001,1259,586,0,586,0,6,580
ZALA,Cserszegtomaj,002,1059,478,0,478,0,3,475
ZALA,Csertalakos,001,32,9,0,9,0,0,9
ZALA,Csesztreg,001,706,393,0,393,0,1,392
ZALA,Csonkahegyhát,001,283,141,0,141,0,2,139
ZALA,Csöde,001,67,47,0,47,0,0,47
ZALA,Csömödér,001,477,192,0,192,0,1,191
ZALA,Csörnyeföld,001,324,103,0,103,0,1,102
ZALA,Dióskál,001,382,136,0,136,0,0,136
ZALA,Dobri,001,146,68,0,68,0,0,68
ZALA,Dobronhegy,001,121,76,0,76,0,4,72
ZALA,Döbröce,001,71,47,0,47,0,2,45
ZALA,Dötk,001,26,21,0,21,0,0,21
ZALA,Egeraracsa,001,247,100,0,100,0,4,96
ZALA,Egervár,001,854,367,0,366,-1,1,365
ZALA,Eszteregnye,001,555,225,0,225,0,0,225
ZALA,Esztergályhorváti,001,320,109,0,109,0,0,109
ZALA,Felsõpáhok,001,534,261,0,261,0,2,259
ZALA,Felsõrajk,001,585,241,0,241,0,0,241
ZALA,Felsõszenterzsébet,001,18,18,0,18,0,0,18
ZALA,Fityeház,001,537,210,0,210,0,0,210
ZALA,Fûzvölgy,001,115,61,0,61,0,0,61
ZALA,Galambok,001,959,317,0,317,0,0,317
ZALA,Garabonc,001,527,188,0,188,0,0,188
ZALA,Gáborjánháza,001,54,35,0,35,0,0,35
ZALA,Gellénháza,001,801,380,0,380,0,1,379
ZALA,Gellénháza,002,479,209,0,209,0,0,209
ZALA,Gelse,001,395,122,0,122,0,1,121
ZALA,Gelse,002,484,136,0,136,0,0,136
ZALA,Gelsesziget,001,218,97,0,97,0,0,97
ZALA,Gétye,001,73,28,0,28,0,0,28
ZALA,Gombosszeg,001,42,30,0,30,0,0,30
ZALA,Gosztola,001,49,37,0,37,0,0,37
ZALA,Gõsfa,001,241,118,0,118,0,0,118
ZALA,Gutorfölde,001,666,252,0,252,0,0,252
ZALA,Gutorfölde,002,188,68,0,68,0,0,68
ZALA,Gyenesdiás,001,1047,479,0,479,0,3,476
ZALA,Gyenesdiás,002,1021,557,0,557,0,6,551
ZALA,Gyenesdiás,003,966,460,0,460,0,2,458
ZALA,Gyûrûs,001,76,34,0,34,0,0,34
ZALA,Hagyárosbörönd,001,242,109,0,109,0,1,108
ZALA,Hahót,001,346,130,0,130,0,0,130
ZALA,Hahót,002,434,184,0,184,0,3,181
ZALA,Hahót,003,108,43,0,43,0,0,43
ZALA,Hernyék,001,65,35,0,35,0,1,34
ZALA,Hévíz,001,1221,911,1,910,-1,1,909
ZALA,Hévíz,002,676,336,0,336,0,1,335
ZALA,Hévíz,003,791,400,0,400,0,0,400
ZALA,Hévíz,004,748,371,0,371,0,0,371
ZALA,Hévíz,005,937,457,0,457,0,0,457
ZALA,Homokkomárom,001,183,86,0,86,0,2,84
ZALA,Hosszúvölgy,001,147,64,0,64,0,0,64
ZALA,Hottó,001,282,130,0,130,0,1,129
ZALA,Iborfia,001,9,8,0,8,0,0,8
ZALA,Iklódbördõce,001,245,115,0,115,0,2,113
ZALA,Kacorlak,001,165,78,0,78,0,1,77
ZALA,Kallósd,001,74,42,0,42,0,0,42
ZALA,Karmacs,001,589,255,0,255,0,1,254
ZALA,Kálócfa,001,126,87,0,87,0,0,87
ZALA,Kányavár,001,106,55,0,55,0,0,55
ZALA,Kávás,001,189,109,0,109,0,0,109
ZALA,Kehidakustány,001,562,245,0,245,0,0,245
ZALA,Kehidakustány,002,304,145,0,145,0,1,144
ZALA,Kemendollár,001,124,51,0,51,0,2,49
ZALA,Kemendollár,002,276,115,0,115,0,1,114
ZALA,Keménfa,001,72,29,0,29,0,0,29
ZALA,Kerecseny,001,185,36,0,36,0,0,36
ZALA,Kerkabarabás,001,235,116,0,116,0,1,115
ZALA,Kerkafalva,001,97,59,0,59,0,0,59
ZALA,Kerkakutas,001,86,59,0,59,0,0,59
ZALA,Kerkaszentkirály,001,194,84,0,84,0,1,83
ZALA,Kerkateskánd,001,143,67,0,67,0,1,66
ZALA,Keszthely,001,913,413,0,413,0,1,412
ZALA,Keszthely,002,794,337,0,337,0,2,335
ZALA,Keszthely,003,967,443,0,443,0,2,441
ZALA,Keszthely,004,961,560,0,560,0,4,556
ZALA,Keszthely,005,939,478,0,478,0,2,476
ZALA,Keszthely,006,1155,533,0,531,-2,1,530
ZALA,Keszthely,007,799,488,0,488,0,4,484
ZALA,Keszthely,008,843,428,0,428,0,3,425
ZALA,Keszthely,009,703,334,0,334,0,3,331
ZALA,Keszthely,010,971,500,0,500,0,3,497
ZALA,Keszthely,011,1062,512,0,512,0,0,512
ZALA,Keszthely,012,815,438,0,438,0,1,437
ZALA,Keszthely,013,948,412,0,412,0,0,412
ZALA,Keszthely,014,1130,434,0,434,0,0,434
ZALA,Keszthely,015,1023,427,0,427,0,1,426
ZALA,Keszthely,016,1021,433,0,433,0,0,433
ZALA,Keszthely,017,855,443,0,442,-1,0,442
ZALA,Kilimán,001,183,75,0,75,0,0,75
ZALA,Kisbucsa,001,372,150,0,150,0,1,149
ZALA,Kiscsehi,001,150,72,0,72,0,0,72
ZALA,Kisgörbõ,001,142,75,0,75,0,0,75
ZALA,Kiskutas,001,166,81,0,81,0,0,81
ZALA,Kispáli,001,219,123,0,123,0,0,123
ZALA,Kisrécse,001,142,66,0,66,0,0,66
ZALA,Kissziget,001,139,74,0,74,0,0,74
ZALA,Kistolmács,001,138,50,0,50,0,0,50
ZALA,Kisvásárhely,001,43,27,0,27,0,0,27
ZALA,Kozmadombja,001,35,29,0,29,0,0,29
ZALA,Kustánszeg,001,389,165,0,165,0,0,165
ZALA,Külsõsárd,001,66,38,0,38,0,0,38
ZALA,Lakhegy,001,386,180,0,180,0,3,177
ZALA,Lasztonya,001,49,21,0,21,0,0,21
ZALA,Lendvadedes,001,25,18,0,18,0,0,18
ZALA,Lendvajakabfa,001,32,23,0,23,0,1,22
ZALA,Lenti,001,996,582,0,582,0,8,574
ZALA,Lenti,002,1027,610,0,610,0,1,609
ZALA,Lenti,003,675,441,0,441,0,1,440
ZALA,Lenti,004,832,446,0,446,0,7,439
ZALA,Lenti,005,622,383,0,383,0,1,382
ZALA,Lenti,006,905,547,0,547,0,2,545
ZALA,Lenti,007,472,265,0,265,0,1,264
ZALA,Lenti,008,298,185,0,185,0,0,185
ZALA,Lenti,009,257,137,0,137,0,1,136
ZALA,Lenti,010,257,144,0,144,0,0,144
ZALA,Lenti,011,134,81,0,81,0,0,81
ZALA,Letenye,001,687,271,1,271,0,0,271
ZALA,Letenye,002,782,295,0,295,0,0,295
ZALA,Letenye,003,796,287,0,287,0,1,286
ZALA,Letenye,004,623,204,0,204,0,2,202
ZALA,Letenye,005,483,178,0,178,0,2,176
ZALA,Lickóvadamos,001,154,84,0,84,0,0,84
ZALA,Ligetfalva,001,46,30,0,30,0,0,30
ZALA,Lispeszentadorján,001,73,28,0,28,0,0,28
ZALA,Lispeszentadorján,002,157,64,0,64,0,0,64
ZALA,Liszó,001,310,134,0,134,0,1,133
ZALA,Lovászi,001,964,400,3,397,-3,0,397
ZALA,Magyarföld,001,47,29,0,29,0,0,29
ZALA,Magyarszentmiklós,001,220,97,0,97,0,0,97
ZALA,Magyarszerdahely,001,366,159,0,159,0,3,156
ZALA,Maróc,001,65,31,0,31,0,1,30
ZALA,Márokföld,001,41,32,0,32,0,0,32
ZALA,Miháld,001,595,193,0,193,0,2,191
ZALA,Mihályfa,001,292,154,1,152,-2,2,150
ZALA,Mikekarácsonyfa,001,228,129,0,129,0,5,124
ZALA,Milejszeg,001,253,111,0,111,0,3,108
ZALA,Misefa,001,241,92,0,92,0,0,92
ZALA,Molnári,001,590,253,0,253,0,1,252
ZALA,Murakeresztúr,001,864,254,0,254,0,0,254
ZALA,Murakeresztúr,002,575,188,0,188,0,1,187
ZALA,Murarátka,001,207,84,1,83,-1,0,83
ZALA,Muraszemenye,001,207,85,0,85,0,0,85
ZALA,Muraszemenye,002,93,53,0,53,0,2,51
ZALA,Muraszemenye,003,78,39,0,39,0,0,39
ZALA,Nagybakónak,001,342,120,0,120,0,2,118
ZALA,Nagygörbõ,001,126,60,0,60,0,1,59
ZALA,Nagykanizsa,001,876,371,0,371,0,0,371
ZALA,Nagykanizsa,002,1040,534,0,534,0,2,532
ZALA,Nagykanizsa,003,812,359,0,359,0,1,358
ZALA,Nagykanizsa,004,1205,485,0,485,0,3,482
ZALA,Nagykanizsa,005,960,440,0,440,0,1,439
ZALA,Nagykanizsa,006,1027,497,0,497,0,2,495
ZALA,Nagykanizsa,007,698,300,0,300,0,1,299
ZALA,Nagykanizsa,008,1043,438,0,438,0,2,436
ZALA,Nagykanizsa,009,1214,571,0,570,-1,1,569
ZALA,Nagykanizsa,010,1000,466,0,466,0,3,463
ZALA,Nagykanizsa,011,794,399,0,399,0,2,397
ZALA,Nagykanizsa,012,1071,584,0,584,0,5,579
ZALA,Nagykanizsa,013,888,470,0,470,0,1,469
ZALA,Nagykanizsa,014,1066,449,0,449,0,3,446
ZALA,Nagykanizsa,015,1011,447,0,447,0,2,445
ZALA,Nagykanizsa,016,790,185,0,185,0,0,185
ZALA,Nagykanizsa,017,218,87,0,87,0,1,86
ZALA,Nagykanizsa,018,1072,474,0,473,-1,3,470
ZALA,Nagykanizsa,019,1036,379,0,379,0,2,377
ZALA,Nagykanizsa,020,837,274,0,274,0,0,274
ZALA,Nagykanizsa,021,802,317,0,317,0,0,317
ZALA,Nagykanizsa,022,1013,400,0,398,-2,4,394
ZALA,Nagykanizsa,023,1078,431,0,431,0,0,431
ZALA,Nagykanizsa,024,765,348,0,348,0,1,347
ZALA,Nagykanizsa,025,820,324,0,324,0,1,323
ZALA,Nagykanizsa,026,1225,394,0,394,0,0,394
ZALA,Nagykanizsa,027,1257,516,0,516,0,1,515
ZALA,Nagykanizsa,028,1191,393,0,393,0,0,393
ZALA,Nagykanizsa,029,1135,525,0,525,0,1,524
ZALA,Nagykanizsa,030,964,363,0,363,0,2,361
ZALA,Nagykanizsa,031,750,331,0,331,0,0,331
ZALA,Nagykanizsa,032,846,395,0,395,0,3,392
ZALA,Nagykanizsa,033,954,448,0,448,0,1,447
ZALA,Nagykanizsa,034,1228,589,0,588,-1,2,586
ZALA,Nagykanizsa,035,1233,507,0,507,0,1,506
ZALA,Nagykanizsa,036,510,192,0,192,0,2,190
ZALA,Nagykanizsa,037,829,384,1,383,-1,0,383
ZALA,Nagykanizsa,038,914,407,0,407,0,3,404
ZALA,Nagykanizsa,039,1175,498,0,498,0,0,498
ZALA,Nagykanizsa,040,1131,488,0,488,0,1,487
ZALA,Nagykapornak,001,726,265,0,265,0,2,263
ZALA,Nagykutas,001,370,191,0,191,0,0,191
ZALA,Nagylengyel,001,395,187,0,187,0,0,187
ZALA,Nagypáli,001,407,168,0,168,0,0,168
ZALA,Nagyrada,001,404,145,1,145,0,0,145
ZALA,Nagyrécse,001,891,374,0,374,0,1,373
ZALA,Nemesapáti,001,387,151,0,151,0,0,151
ZALA,Nemesbük,001,537,255,0,255,0,6,249
ZALA,Nemeshetés,001,217,103,0,103,0,1,102
ZALA,Nemesnép,001,129,83,0,83,0,0,83
ZALA,Nemespátró,001,218,87,1,87,0,0,87
ZALA,Nemesrádó,001,261,129,0,129,0,1,128
ZALA,Nemessándorháza,001,251,111,0,111,0,3,108
ZALA,Nemesszentandrás,001,211,102,0,102,0,0,102
ZALA,Németfalu,001,160,103,0,103,0,0,103
ZALA,Nova,001,640,236,0,236,0,0,236
ZALA,Oltárc,001,200,55,0,55,0,0,55
ZALA,Orbányosfa,001,95,47,0,47,0,0,47
ZALA,Ormándlak,001,83,55,0,55,0,1,54
ZALA,Orosztony,001,333,93,0,93,0,0,93
ZALA,Ortaháza,001,95,42,0,42,0,1,41
ZALA,Ozmánbük,001,153,80,0,80,0,0,80
ZALA,Óhíd,001,459,159,0,159,0,1,158
ZALA,Pacsa,001,640,210,0,210,0,2,208
ZALA,Pacsa,002,696,267,0,267,0,1,266
ZALA,Padár,001,98,49,0,49,0,0,49
ZALA,Pakod,001,694,220,0,220,0,0,220
ZALA,Pat,001,148,74,0,74,0,2,72
ZALA,Páka,001,832,392,0,392,0,2,390
ZALA,Páka,002,119,56,0,56,0,1,55
ZALA,Pálfiszeg,001,142,69,0,69,0,0,69
ZALA,Pethõhenye,001,344,123,1,122,-1,2,120
ZALA,Petrikeresztúr,001,311,148,0,148,0,1,147
ZALA,Petrivente,001,308,115,0,115,0,0,115
ZALA,Pókaszepetk,001,765,306,0,306,0,1,305
ZALA,Pórszombat,001,232,157,0,157,0,0,157
ZALA,Pölöske,001,672,234,0,234,0,1,233
ZALA,Pölöskefõ,001,296,90,0,90,0,1,89
ZALA,Pördefölde,001,34,30,0,30,0,0,30
ZALA,Pötréte,001,231,105,0,105,0,1,104
ZALA,Pusztaapáti,001,26,24,0,24,0,0,24
ZALA,Pusztaederics,001,138,68,0,68,0,0,68
ZALA,Pusztamagyaród,001,434,180,0,180,0,0,180
ZALA,Pusztaszentlászló,001,467,219,0,219,0,3,216
ZALA,Ramocsa,001,30,18,0,18,0,1,17
ZALA,Resznek,001,231,97,0,97,0,0,97
ZALA,Rezi,001,1018,401,0,400,-1,2,398
ZALA,Rédics,001,753,352,0,352,0,1,351
ZALA,Rigyác,001,330,158,0,158,0,2,156
ZALA,Salomvár,001,479,219,0,219,0,3,216
ZALA,Sand,001,322,141,0,141,0,0,141
ZALA,Sárhida,001,627,298,0,298,0,2,296
ZALA,Sármellék,001,774,248,0,248,0,1,247
ZALA,Sármellék,002,735,222,1,221,-1,5,216
ZALA,Semjénháza,001,495,205,0,205,0,1,204
ZALA,Sénye,001,42,29,0,29,0,0,29
ZALA,Sormás,001,735,351,0,351,0,1,350
ZALA,Söjtör,001,575,178,0,178,0,1,177
ZALA,Söjtör,002,626,173,0,173,0,1,172
ZALA,Surd,001,484,189,0,189,0,0,189
ZALA,Sümegcsehi,001,495,233,0,233,0,2,231
ZALA,Szalapa,001,163,73,0,73,0,0,73
ZALA,Szentgyörgyvár,001,256,118,0,118,0,1,117
ZALA,Szentgyörgyvölgy,001,329,160,0,160,0,1,159
ZALA,Szentkozmadombja,001,50,29,0,29,0,1,28
ZALA,Szentliszló,001,247,98,1,97,-1,1,96
ZALA,Szentmargitfalva,001,69,31,0,31,0,0,31
ZALA,Szentpéterfölde,001,108,39,0,39,0,0,39
ZALA,Szentpéterúr,001,692,169,0,169,0,0,169
ZALA,Szepetnek,001,625,220,0,220,0,3,217
ZALA,Szepetnek,002,664,226,0,226,0,1,225
ZALA,Szécsisziget,001,185,103,0,103,0,0,103
ZALA,Szijártóháza,001,20,12,0,12,0,0,12
ZALA,Szilvágy,001,150,110,0,110,0,0,110
ZALA,Teskánd,001,872,440,0,440,0,1,439
ZALA,Tilaj,001,73,53,0,53,0,0,53
ZALA,Tilaj,002,54,35,0,35,0,0,35
ZALA,Tormafölde,001,290,132,0,132,0,0,132
ZALA,Tornyiszentmiklós,001,452,189,0,189,0,4,185
ZALA,Tófej,001,550,174,0,174,0,0,174
ZALA,Tótszentmárton,001,701,248,0,248,0,0,248
ZALA,Tótszerdahely,001,404,139,0,139,0,0,139
ZALA,Tótszerdahely,002,497,169,0,169,0,0,169
ZALA,Türje,001,476,98,0,98,0,1,97
ZALA,Türje,002,781,276,0,276,0,4,272
ZALA,Újudvar,001,800,333,0,333,0,1,332
ZALA,Valkonya,001,47,23,0,23,0,0,23
ZALA,Vasboldogasszony,001,467,185,0,185,0,1,184
ZALA,Vaspör,001,236,151,0,151,0,1,150
ZALA,Vaspör,002,59,36,0,36,0,0,36
ZALA,Vállus,001,110,47,0,47,0,0,47
ZALA,Várfölde,001,154,47,0,47,0,2,45
ZALA,Várvölgy,001,877,401,0,401,0,0,401
ZALA,Vindornyafok,001,100,56,0,56,0,1,55
ZALA,Vindornyalak,001,61,30,0,30,0,0,30
ZALA,Vindornyaszõlõs,001,281,127,0,127,0,0,127
ZALA,Vonyarcvashegy,001,1034,511,0,511,0,5,506
ZALA,Vonyarcvashegy,002,926,481,0,481,0,2,479
ZALA,Vöckönd,001,68,45,0,45,0,0,45
ZALA,Zajk,001,177,73,0,73,0,2,71
ZALA,Zalaapáti,001,633,258,0,258,0,4,254
ZALA,Zalaapáti,002,576,231,0,231,0,1,230
ZALA,Zalabaksa,001,528,259,0,259,0,4,255
ZALA,Zalabér,001,568,217,0,217,0,0,217
ZALA,Zalaboldogfa,001,295,130,0,130,0,1,129
ZALA,Zalacsány,001,811,330,0,330,0,1,329
ZALA,Zalacséb,001,406,182,0,182,0,1,181
ZALA,Zalaegerszeg,001,724,333,0,333,0,1,332
ZALA,Zalaegerszeg,002,1084,502,0,502,0,0,502
ZALA,Zalaegerszeg,003,1163,586,0,586,0,1,585
ZALA,Zalaegerszeg,004,884,457,0,457,0,0,457
ZALA,Zalaegerszeg,005,796,313,0,313,0,1,312
ZALA,Zalaegerszeg,006,1201,571,0,571,0,2,569
ZALA,Zalaegerszeg,007,827,354,0,354,0,3,351
ZALA,Zalaegerszeg,008,695,343,0,343,0,1,342
ZALA,Zalaegerszeg,009,828,405,0,405,0,1,404
ZALA,Zalaegerszeg,010,859,397,0,397,0,0,397
ZALA,Zalaegerszeg,011,803,359,0,359,0,2,357
ZALA,Zalaegerszeg,012,1011,472,0,472,0,2,470
ZALA,Zalaegerszeg,013,1089,514,0,513,-1,1,512
ZALA,Zalaegerszeg,014,878,367,0,367,0,3,364
ZALA,Zalaegerszeg,015,941,433,1,432,-1,1,431
ZALA,Zalaegerszeg,016,1443,751,0,751,0,4,747
ZALA,Zalaegerszeg,017,990,499,0,499,0,0,499
ZALA,Zalaegerszeg,018,954,472,0,471,-1,4,467
ZALA,Zalaegerszeg,019,857,447,1,447,0,4,443
ZALA,Zalaegerszeg,020,968,502,0,502,0,0,502
ZALA,Zalaegerszeg,021,1085,533,1,533,0,3,530
ZALA,Zalaegerszeg,022,902,407,0,407,0,3,404
ZALA,Zalaegerszeg,023,1110,588,0,588,0,3,585
ZALA,Zalaegerszeg,024,495,203,0,203,0,1,202
ZALA,Zalaegerszeg,025,529,265,0,265,0,0,265
ZALA,Zalaegerszeg,026,1312,613,0,613,0,1,612
ZALA,Zalaegerszeg,027,978,421,0,419,-2,2,417
ZALA,Zalaegerszeg,028,1371,617,1,615,-2,2,613
ZALA,Zalaegerszeg,029,892,433,0,432,-1,2,430
ZALA,Zalaegerszeg,030,595,230,0,230,0,4,226
ZALA,Zalaegerszeg,031,707,286,0,286,0,3,283
ZALA,Zalaegerszeg,032,788,380,0,380,0,3,377
ZALA,Zalaegerszeg,033,825,366,0,366,0,1,365
ZALA,Zalaegerszeg,034,982,447,0,447,0,1,446
ZALA,Zalaegerszeg,035,875,481,0,480,-1,2,478
ZALA,Zalaegerszeg,036,980,456,0,456,0,2,454
ZALA,Zalaegerszeg,037,1029,557,0,557,0,1,556
ZALA,Zalaegerszeg,038,871,407,0,407,0,3,404
ZALA,Zalaegerszeg,039,841,394,0,394,0,0,394
ZALA,Zalaegerszeg,040,1013,567,0,567,0,3,564
ZALA,Zalaegerszeg,041,1072,530,0,530,0,1,529
ZALA,Zalaegerszeg,042,664,344,0,344,0,1,343
ZALA,Zalaegerszeg,043,925,424,1,424,0,2,422
ZALA,Zalaegerszeg,044,922,447,0,447,0,2,445
ZALA,Zalaegerszeg,045,847,373,0,373,0,0,373
ZALA,Zalaegerszeg,046,831,388,0,388,0,0,388
ZALA,Zalaegerszeg,047,714,395,0,395,0,2,393
ZALA,Zalaegerszeg,048,1373,697,0,697,0,6,691
ZALA,Zalaegerszeg,049,997,474,0,474,0,3,471
ZALA,Zalaegerszeg,050,652,263,0,263,0,3,260
ZALA,Zalaegerszeg,051,633,349,0,349,0,0,349
ZALA,Zalaháshágy,001,302,153,0,153,0,0,153
ZALA,Zalaigrice,001,88,46,0,46,0,1,45
ZALA,Zalaistvánd,001,303,137,0,137,0,1,136
ZALA,Zalakaros,001,1054,599,0,599,0,5,594
ZALA,Zalakaros,002,925,345,0,345,0,2,343
ZALA,Zalakomár,001,671,149,0,149,0,2,147
ZALA,Zalakomár,002,693,242,0,242,0,2,240
ZALA,Zalakomár,003,722,172,0,172,0,0,172
ZALA,Zalaköveskút,001,22,17,0,17,0,0,17
ZALA,Zalalövõ,001,524,252,0,252,0,0,252
ZALA,Zalalövõ,002,527,221,0,221,0,2,219
ZALA,Zalalövõ,003,505,195,0,195,0,0,195
ZALA,Zalalövõ,004,500,218,0,218,0,0,218
ZALA,Zalalövõ,005,196,106,0,106,0,0,106
ZALA,Zalalövõ,006,74,44,0,44,0,0,44
ZALA,Zalamerenye,001,138,87,0,87,0,0,87
ZALA,Zalasárszeg,001,101,45,0,45,0,1,44
ZALA,Zalaszabar,001,428,174,0,174,0,1,173
ZALA,Zalaszántó,001,747,324,0,324,0,3,321
ZALA,Zalaszentbalázs,001,654,277,0,277,0,1,276
ZALA,Zalaszentgrót,001,661,260,0,260,0,1,259
ZALA,Zalaszentgrót,002,687,327,0,327,0,0,327
ZALA,Zalaszentgrót,003,820,374,0,373,-1,0,373
ZALA,Zalaszentgrót,004,1062,435,0,435,0,1,434
ZALA,Zalaszentgrót,005,428,176,0,176,0,1,175
ZALA,Zalaszentgrót,006,536,235,0,235,0,2,233
ZALA,Zalaszentgrót,007,155,56,0,56,0,0,56
ZALA,Zalaszentgrót,008,253,101,0,101,0,1,100
ZALA,Zalaszentgrót,009,234,82,0,82,0,2,80
ZALA,Zalaszentgrót,010,388,188,0,188,0,1,187
ZALA,Zalaszentgyörgy,001,353,186,0,186,0,0,186
ZALA,Zalaszentiván,001,829,371,0,371,0,1,370
ZALA,Zalaszentjakab,001,237,80,0,80,0,3,77
ZALA,Zalaszentlászló,001,412,178,0,178,0,0,178
ZALA,Zalaszentlászló,002,216,77,0,77,0,0,77
ZALA,Zalaszentlõrinc,001,227,114,0,114,0,2,112
ZALA,Zalaszentmárton,001,61,47,1,46,-1,1,45
ZALA,Zalaszentmihály,001,814,330,0,330,0,0,330
ZALA,Zalaszombatfa,001,46,40,0,40,0,1,39
ZALA,Zalatárnok,001,504,173,0,173,0,0,173
ZALA,Zalaújlak,001,75,45,0,45,0,0,45
ZALA,Zalavár,001,740,279,0,279,0,3,276
ZALA,Zalavég,001,290,113,0,113,0,0,113
ZALA,Zebecke,001,46,27,0,27,0,0,27
ZALA,Tekenye,001,380,161,0,161,0,0,161
