TIPUS,VALASZTAS,SZAVAZOKOR,VALASZTOPOLGAR,MEGJELENTEK,URNABAN_BELYEGZES_NELKULI,URNABAN_LEBELYEGZETT,ELTERES,ERVENYTELEN,ERVENYES
Listas,2014EP,01-001-001,1060,577,0,577,0,1,576
Listas,2014EP,01-001-002,1014,497,0,497,0,4,493
Listas,2014EP,01-001-003,1573,867,0,867,0,3,864
Listas,2014EP,01-001-004,999,500,0,498,-2,2,496
Listas,2014EP,01-001-005,979,483,0,483,0,2,481
Listas,2014EP,01-001-006,1091,549,0,549,0,7,542
Listas,2014EP,01-001-007,952,464,0,464,0,1,463
Listas,2014EP,01-001-008,935,451,0,451,0,0,451
Listas,2014EP,01-001-009,1098,538,0,538,0,3,535
Listas,2014EP,01-001-010,1004,513,0,513,0,4,509
Listas,2014EP,01-001-011,1038,541,0,540,-1,1,539
Listas,2014EP,01-001-012,1061,510,1,510,0,4,506
Listas,2014EP,01-001-013,1095,568,0,568,0,6,562
Listas,2014EP,01-001-014,1008,498,0,498,0,0,498
Listas,2014EP,01-001-015,995,518,0,518,0,1,517
Listas,2014EP,01-001-016,983,563,0,563,0,2,561
Listas,2014EP,01-001-017,1061,526,0,526,0,1,525
Listas,2014EP,01-001-018,1036,506,0,505,-1,2,503
Listas,2014EP,01-001-019,975,478,0,478,0,3,475
Listas,2014EP,01-001-020,992,530,0,529,-1,0,529
Listas,2014EP,01-002-001,1085,546,0,546,0,1,545
Listas,2014EP,01-002-002,966,509,0,509,0,0,509
Listas,2014EP,01-002-003,710,332,0,332,0,0,332
Listas,2014EP,01-002-004,1023,492,0,492,0,0,492
Listas,2014EP,01-002-005,1017,504,0,504,0,1,503
Listas,2014EP,01-002-006,901,473,0,472,-1,0,472
Listas,2014EP,01-002-007,876,473,0,470,-3,2,468
Listas,2014EP,01-002-008,960,540,0,540,0,0,540
Listas,2014EP,01-002-009,933,484,0,482,-2,1,481
Listas,2014EP,01-002-010,721,437,0,437,0,0,437
Listas,2014EP,01-002-011,1916,1207,0,1207,0,1,1206
Listas,2014EP,01-002-012,1148,619,0,618,-1,1,617
Listas,2014EP,01-002-013,728,372,0,372,0,0,372
Listas,2014EP,01-002-014,836,419,0,419,0,2,417
Listas,2014EP,01-002-015,857,491,0,490,-1,0,490
Listas,2014EP,01-002-016,973,558,0,557,-1,1,556
Listas,2014EP,01-002-017,891,422,0,422,0,0,422
Listas,2014EP,01-002-018,859,482,0,482,0,5,477
Listas,2014EP,01-002-019,879,495,0,495,0,0,495
Listas,2014EP,01-002-020,851,490,0,490,0,0,490
Listas,2014EP,01-002-021,676,328,0,328,0,0,328
Listas,2014EP,01-002-022,864,501,0,501,0,3,498
Listas,2014EP,01-002-023,933,517,0,517,0,0,517
Listas,2014EP,01-002-024,1021,545,0,545,0,3,542
Listas,2014EP,01-002-025,876,453,0,450,-3,0,450
Listas,2014EP,01-002-026,887,523,0,519,-4,1,518
Listas,2014EP,01-002-027,785,412,0,411,-1,2,409
Listas,2014EP,01-002-028,785,408,0,408,0,0,408
Listas,2014EP,01-002-029,752,370,0,370,0,2,368
Listas,2014EP,01-002-030,628,309,0,309,0,1,308
Listas,2014EP,01-002-031,1265,663,0,662,-1,0,662
Listas,2014EP,01-002-032,999,581,0,581,0,1,580
Listas,2014EP,01-002-033,891,498,0,498,0,0,498
Listas,2014EP,01-002-034,787,387,0,387,0,1,386
Listas,2014EP,01-002-035,941,503,0,503,0,1,502
Listas,2014EP,01-002-036,917,468,0,468,0,2,466
Listas,2014EP,01-002-037,930,479,0,479,0,2,477
Listas,2014EP,01-002-038,1013,535,0,535,0,2,533
Listas,2014EP,01-002-039,872,423,0,423,0,1,422
Listas,2014EP,01-002-040,810,405,0,405,0,0,405
Listas,2014EP,01-002-041,821,364,0,364,0,0,364
Listas,2014EP,01-002-042,853,403,1,402,-1,0,402
Listas,2014EP,01-002-043,850,424,0,424,0,1,423
Listas,2014EP,01-002-044,957,490,0,490,0,0,490
Listas,2014EP,01-002-045,884,470,0,470,0,1,469
Listas,2014EP,01-002-046,943,472,0,472,0,2,470
Listas,2014EP,01-002-047,903,487,0,487,0,0,487
Listas,2014EP,01-002-048,914,504,0,504,0,0,504
Listas,2014EP,01-002-049,910,458,0,457,-1,0,457
Listas,2014EP,01-002-050,1442,675,0,675,0,1,674
Listas,2014EP,01-002-051,828,502,0,502,0,2,500
Listas,2014EP,01-002-052,734,421,0,421,0,0,421
Listas,2014EP,01-002-053,765,456,0,456,0,1,455
Listas,2014EP,01-002-054,1299,632,0,632,0,1,631
Listas,2014EP,01-002-055,942,485,0,485,0,0,485
Listas,2014EP,01-002-056,845,428,0,428,0,2,426
Listas,2014EP,01-002-057,807,409,0,409,0,0,409
Listas,2014EP,01-002-058,1006,449,0,449,0,2,447
Listas,2014EP,01-002-059,779,364,0,365,1,8,357
Listas,2014EP,01-002-060,965,447,0,447,0,0,447
Listas,2014EP,01-002-061,960,489,0,489,0,1,488
Listas,2014EP,01-002-062,710,309,0,309,0,0,309
Listas,2014EP,01-002-063,870,424,0,424,0,3,421
Listas,2014EP,01-002-064,894,441,0,441,0,3,438
Listas,2014EP,01-002-065,927,453,0,453,0,2,451
Listas,2014EP,01-002-066,1119,516,0,515,-1,2,513
Listas,2014EP,01-002-067,876,388,0,388,0,2,386
Listas,2014EP,01-002-068,913,426,1,425,-1,1,424
Listas,2014EP,01-002-069,1000,425,0,425,0,2,423
Listas,2014EP,01-002-070,856,411,0,411,0,0,411
Listas,2014EP,01-002-071,953,473,0,473,0,0,473
Listas,2014EP,01-002-072,1068,473,0,473,0,2,471
Listas,2014EP,01-002-073,1047,529,0,529,0,2,527
Listas,2014EP,01-003-001,890,420,0,420,0,0,420
Listas,2014EP,01-003-002,831,356,0,356,0,2,354
Listas,2014EP,01-003-003,889,380,0,380,0,2,378
Listas,2014EP,01-003-004,921,369,0,369,0,0,369
Listas,2014EP,01-003-005,875,314,0,314,0,2,312
Listas,2014EP,01-003-006,919,433,0,433,0,0,433
Listas,2014EP,01-003-007,912,393,0,390,-3,3,387
Listas,2014EP,01-003-008,787,315,0,315,0,1,314
Listas,2014EP,01-003-009,830,367,0,367,0,1,366
Listas,2014EP,01-003-010,876,448,0,448,0,1,447
Listas,2014EP,01-003-011,985,447,0,447,0,1,446
Listas,2014EP,01-003-012,998,485,0,485,0,2,483
Listas,2014EP,01-003-013,935,439,0,439,0,0,439
Listas,2014EP,01-003-014,918,443,0,443,0,1,442
Listas,2014EP,01-003-015,790,380,0,380,0,1,379
Listas,2014EP,01-003-016,783,430,0,431,1,7,424
Listas,2014EP,01-003-017,837,448,0,448,0,4,444
Listas,2014EP,01-003-018,918,424,0,424,0,1,423
Listas,2014EP,01-003-019,992,426,0,426,0,1,425
Listas,2014EP,01-003-020,963,384,0,384,0,2,382
Listas,2014EP,01-003-021,758,342,0,342,0,1,341
Listas,2014EP,01-003-022,849,343,0,341,-2,1,340
Listas,2014EP,01-003-023,821,344,0,344,0,1,343
Listas,2014EP,01-003-024,816,372,0,372,0,1,371
Listas,2014EP,01-003-025,784,331,0,331,0,2,329
Listas,2014EP,01-003-026,782,394,0,394,0,1,393
Listas,2014EP,01-003-027,874,434,0,433,-1,1,432
Listas,2014EP,01-003-028,831,347,0,347,0,2,345
Listas,2014EP,01-003-029,889,389,0,389,0,3,386
Listas,2014EP,01-003-030,874,395,0,395,0,1,394
Listas,2014EP,01-003-031,879,354,0,354,0,3,351
Listas,2014EP,01-003-032,950,440,0,440,0,1,439
Listas,2014EP,01-003-033,869,347,0,347,0,6,341
Listas,2014EP,01-003-034,824,332,0,332,0,0,332
Listas,2014EP,01-003-035,828,346,0,346,0,2,344
Listas,2014EP,01-003-036,799,363,0,363,0,2,361
Listas,2014EP,01-003-037,886,437,0,436,-1,0,436
Listas,2014EP,01-003-038,769,321,0,321,0,1,320
Listas,2014EP,01-003-039,821,339,0,339,0,3,336
Listas,2014EP,01-003-040,748,287,0,287,0,1,286
Listas,2014EP,01-003-041,804,267,0,267,0,2,265
Listas,2014EP,01-003-042,1757,1089,0,1089,0,1,1088
Listas,2014EP,01-003-043,1036,383,0,383,0,0,383
Listas,2014EP,01-003-044,1032,464,0,464,0,4,460
Listas,2014EP,01-003-045,963,357,0,357,0,2,355
Listas,2014EP,01-003-046,1049,390,0,390,0,1,389
Listas,2014EP,01-003-047,627,237,0,237,0,1,236
Listas,2014EP,01-003-048,836,347,0,347,0,1,346
Listas,2014EP,01-003-049,878,368,0,368,0,1,367
Listas,2014EP,01-003-050,846,401,0,401,0,1,400
Listas,2014EP,01-003-051,782,353,0,351,-2,3,348
Listas,2014EP,01-003-052,845,347,0,346,-1,1,345
Listas,2014EP,01-003-053,789,344,0,344,0,1,343
Listas,2014EP,01-003-054,934,413,0,413,0,2,411
Listas,2014EP,01-003-055,882,342,0,342,0,0,342
Listas,2014EP,01-003-056,862,327,0,327,0,0,327
Listas,2014EP,01-003-057,929,343,0,342,-1,0,342
Listas,2014EP,01-003-058,816,314,0,314,0,0,314
Listas,2014EP,01-003-059,820,403,0,403,0,3,400
Listas,2014EP,01-003-060,893,311,0,310,-1,1,309
Listas,2014EP,01-003-061,913,354,0,354,0,0,354
Listas,2014EP,01-003-062,928,282,0,282,0,3,279
Listas,2014EP,01-003-063,946,271,2,271,0,3,268
Listas,2014EP,01-003-064,785,301,0,301,0,0,301
Listas,2014EP,01-003-065,1048,441,0,441,0,0,441
Listas,2014EP,01-003-066,891,313,0,312,-1,2,310
Listas,2014EP,01-003-067,914,326,0,326,0,1,325
Listas,2014EP,01-003-068,796,419,0,419,0,2,417
Listas,2014EP,01-003-069,905,388,0,388,0,3,385
Listas,2014EP,01-003-070,933,415,0,415,0,4,411
Listas,2014EP,01-003-071,986,431,0,431,0,1,430
Listas,2014EP,01-003-072,993,385,0,385,0,0,385
Listas,2014EP,01-003-073,919,406,0,406,0,3,403
Listas,2014EP,01-003-074,948,444,0,444,0,0,444
Listas,2014EP,01-003-075,786,380,0,380,0,0,380
Listas,2014EP,01-003-076,1026,427,0,427,0,3,424
Listas,2014EP,01-003-077,925,463,0,463,0,1,462
Listas,2014EP,01-003-078,799,406,0,406,0,0,406
Listas,2014EP,01-003-079,953,457,0,457,0,0,457
Listas,2014EP,01-003-080,884,420,0,419,-1,0,419
Listas,2014EP,01-003-081,902,407,0,407,0,0,407
Listas,2014EP,01-003-082,1073,525,0,525,0,0,525
Listas,2014EP,01-003-083,1026,468,0,468,0,1,467
Listas,2014EP,01-003-084,907,421,0,421,0,2,419
Listas,2014EP,01-003-085,884,306,0,306,0,1,305
Listas,2014EP,01-003-086,920,258,0,258,0,3,255
Listas,2014EP,01-003-087,853,318,0,318,0,0,318
Listas,2014EP,01-003-088,954,344,0,344,0,2,342
Listas,2014EP,01-003-089,939,328,0,327,-1,1,326
Listas,2014EP,01-003-090,917,255,0,255,0,0,255
Listas,2014EP,01-003-091,834,303,0,303,0,0,303
Listas,2014EP,01-003-092,1036,321,0,321,0,0,321
Listas,2014EP,01-003-093,940,342,0,342,0,2,340
Listas,2014EP,01-003-094,826,263,0,261,-2,2,259
Listas,2014EP,01-003-095,822,222,0,222,0,3,219
Listas,2014EP,01-003-096,1049,357,0,357,0,0,357
Listas,2014EP,01-003-097,1017,295,0,295,0,4,291
Listas,2014EP,01-003-098,776,199,0,199,0,0,199
Listas,2014EP,01-003-099,1046,301,0,301,0,2,299
Listas,2014EP,01-003-100,987,228,1,227,-1,3,224
Listas,2014EP,01-003-101,981,252,0,252,0,0,252
Listas,2014EP,01-003-102,936,304,0,304,0,1,303
Listas,2014EP,01-003-103,916,312,0,312,0,1,311
Listas,2014EP,01-003-104,879,262,0,262,0,3,259
Listas,2014EP,01-003-105,839,293,0,293,0,4,289
Listas,2014EP,01-003-106,915,336,0,336,0,1,335
Listas,2014EP,01-003-107,865,302,0,302,0,0,302
Listas,2014EP,01-003-108,913,314,0,314,0,0,314
Listas,2014EP,01-003-109,859,311,0,310,-1,1,309
Listas,2014EP,01-003-110,892,274,0,273,-1,1,272
Listas,2014EP,01-003-111,843,288,0,288,0,0,288
Listas,2014EP,01-003-112,888,248,0,248,0,2,246
Listas,2014EP,01-004-001,886,316,0,316,0,2,314
Listas,2014EP,01-004-002,1063,395,0,395,0,2,393
Listas,2014EP,01-004-003,1069,353,0,346,-7,1,345
Listas,2014EP,01-004-004,1034,424,0,424,0,0,424
Listas,2014EP,01-004-005,952,314,0,314,0,1,313
Listas,2014EP,01-004-006,1025,265,0,266,1,9,257
Listas,2014EP,01-004-007,1031,343,0,343,0,4,339
Listas,2014EP,01-004-008,965,359,0,359,0,1,358
Listas,2014EP,01-004-009,1092,339,0,339,0,0,339
Listas,2014EP,01-004-010,1007,294,0,294,0,0,294
Listas,2014EP,01-004-011,1079,314,0,313,-1,0,313
Listas,2014EP,01-004-012,1022,339,0,339,0,2,337
Listas,2014EP,01-004-013,979,311,0,311,0,1,310
Listas,2014EP,01-004-014,893,385,0,385,0,1,384
Listas,2014EP,01-004-015,911,398,0,397,-1,2,395
Listas,2014EP,01-004-016,812,351,0,351,0,1,350
Listas,2014EP,01-004-017,862,314,0,314,0,2,312
Listas,2014EP,01-004-018,882,299,0,299,0,1,298
Listas,2014EP,01-004-019,1023,400,0,400,0,2,398
Listas,2014EP,01-004-020,897,298,0,298,0,1,297
Listas,2014EP,01-004-021,880,312,0,312,0,1,311
Listas,2014EP,01-004-022,923,234,0,234,0,0,234
Listas,2014EP,01-004-023,847,250,0,250,0,0,250
Listas,2014EP,01-004-024,906,212,0,212,0,0,212
Listas,2014EP,01-004-025,947,270,0,270,0,1,269
Listas,2014EP,01-004-026,854,229,0,229,0,0,229
Listas,2014EP,01-004-027,928,343,0,343,0,0,343
Listas,2014EP,01-004-028,940,352,0,352,0,1,351
Listas,2014EP,01-004-029,968,391,0,391,0,3,388
Listas,2014EP,01-004-030,888,328,0,328,0,1,327
Listas,2014EP,01-004-031,922,357,0,357,0,0,357
Listas,2014EP,01-004-032,855,207,0,205,-2,0,205
Listas,2014EP,01-004-033,826,318,0,318,0,0,318
Listas,2014EP,01-004-034,961,382,0,381,-1,1,380
Listas,2014EP,01-004-035,898,266,0,266,0,1,265
Listas,2014EP,01-004-036,854,294,0,294,0,4,290
Listas,2014EP,01-004-037,893,366,0,366,0,0,366
Listas,2014EP,01-004-038,1031,379,0,379,0,0,379
Listas,2014EP,01-004-039,732,331,0,331,0,5,326
Listas,2014EP,01-004-040,943,454,0,454,0,1,453
Listas,2014EP,01-004-041,845,166,0,166,0,0,166
Listas,2014EP,01-004-042,916,239,0,239,0,1,238
Listas,2014EP,01-004-043,939,275,0,275,0,0,275
Listas,2014EP,01-004-044,866,215,0,215,0,1,214
Listas,2014EP,01-004-045,917,268,0,268,0,0,268
Listas,2014EP,01-004-046,918,330,0,330,0,0,330
Listas,2014EP,01-004-047,896,270,0,270,0,2,268
Listas,2014EP,01-004-048,934,311,0,311,0,0,311
Listas,2014EP,01-004-049,782,308,0,308,0,2,306
Listas,2014EP,01-004-050,975,280,0,280,0,1,279
Listas,2014EP,01-004-051,989,279,0,279,0,2,277
Listas,2014EP,01-004-052,960,317,0,317,0,0,317
Listas,2014EP,01-004-053,842,341,0,341,0,0,341
Listas,2014EP,01-004-054,828,254,0,254,0,3,251
Listas,2014EP,01-004-055,935,269,0,269,0,1,268
Listas,2014EP,01-004-056,952,358,0,358,0,3,355
Listas,2014EP,01-004-057,955,305,1,304,-1,0,304
Listas,2014EP,01-004-058,949,384,0,384,0,2,382
Listas,2014EP,01-004-059,1029,340,0,339,-1,0,339
Listas,2014EP,01-004-060,909,259,1,259,0,0,259
Listas,2014EP,01-004-061,926,259,0,259,0,1,258
Listas,2014EP,01-004-062,908,244,0,244,0,0,244
Listas,2014EP,01-004-063,923,310,0,310,0,0,310
Listas,2014EP,01-004-064,939,279,0,279,0,0,279
Listas,2014EP,01-004-065,861,298,0,298,0,1,297
Listas,2014EP,01-004-066,1797,980,0,979,-1,3,976
Listas,2014EP,01-004-067,959,328,0,328,0,3,325
Listas,2014EP,01-004-068,940,294,0,294,0,0,294
Listas,2014EP,01-004-069,912,321,0,321,0,1,320
Listas,2014EP,01-004-070,979,346,0,346,0,0,346
Listas,2014EP,01-004-071,919,264,0,264,0,2,262
Listas,2014EP,01-004-072,979,305,0,305,0,1,304
Listas,2014EP,01-004-073,1019,369,0,369,0,3,366
Listas,2014EP,01-004-074,1008,404,0,404,0,2,402
Listas,2014EP,01-004-075,1053,375,0,375,0,5,370
Listas,2014EP,01-004-076,914,270,0,270,0,1,269
Listas,2014EP,01-004-077,1040,298,0,298,0,1,297
Listas,2014EP,01-004-078,1063,337,0,337,0,2,335
Listas,2014EP,01-004-079,1037,329,0,329,0,2,327
Listas,2014EP,01-004-080,1005,300,0,300,0,3,297
Listas,2014EP,01-004-081,987,282,0,282,0,2,280
Listas,2014EP,01-004-082,998,353,1,351,-2,1,350
Listas,2014EP,01-004-083,916,309,0,309,0,1,308
Listas,2014EP,01-004-084,1015,293,0,293,0,0,293
Listas,2014EP,01-005-001,995,480,0,480,0,2,478
Listas,2014EP,01-005-002,819,366,0,366,0,1,365
Listas,2014EP,01-005-003,793,362,0,362,0,1,361
Listas,2014EP,01-005-004,970,483,0,483,0,1,482
Listas,2014EP,01-005-005,1044,487,1,486,-1,1,485
Listas,2014EP,01-005-006,866,429,0,428,-1,1,427
Listas,2014EP,01-005-007,972,416,0,416,0,0,416
Listas,2014EP,01-005-008,1114,513,0,513,0,2,511
Listas,2014EP,01-005-009,1004,431,0,431,0,3,428
Listas,2014EP,01-005-010,601,279,0,279,0,0,279
Listas,2014EP,01-005-011,1423,944,1,944,0,3,941
Listas,2014EP,01-005-012,1052,463,0,463,0,1,462
Listas,2014EP,01-005-013,1049,469,0,469,0,2,467
Listas,2014EP,01-005-014,1039,423,0,423,0,4,419
Listas,2014EP,01-005-015,964,415,1,414,-1,2,412
Listas,2014EP,01-005-016,892,394,0,394,0,3,391
Listas,2014EP,01-005-017,947,439,0,438,-1,0,438
Listas,2014EP,01-005-018,937,507,0,507,0,6,501
Listas,2014EP,01-005-019,991,497,0,497,0,0,497
Listas,2014EP,01-005-020,1083,493,0,493,0,1,492
Listas,2014EP,01-005-021,1066,482,0,482,0,0,482
Listas,2014EP,01-006-001,1007,410,0,410,0,1,409
Listas,2014EP,01-006-002,918,349,0,349,0,0,349
Listas,2014EP,01-006-003,662,251,0,251,0,2,249
Listas,2014EP,01-006-004,874,316,0,315,-1,2,313
Listas,2014EP,01-006-005,1046,396,0,396,0,1,395
Listas,2014EP,01-006-006,810,297,0,297,0,1,296
Listas,2014EP,01-006-007,718,259,0,259,0,0,259
Listas,2014EP,01-006-008,1195,433,0,433,0,2,431
Listas,2014EP,01-006-009,685,251,0,251,0,0,251
Listas,2014EP,01-006-010,880,362,0,362,0,0,362
Listas,2014EP,01-006-011,836,321,0,321,0,0,321
Listas,2014EP,01-006-012,834,253,0,253,0,0,253
Listas,2014EP,01-006-013,1372,413,0,413,0,0,413
Listas,2014EP,01-006-014,788,269,0,269,0,2,267
Listas,2014EP,01-006-015,1021,378,0,378,0,0,378
Listas,2014EP,01-006-016,1180,373,0,373,0,0,373
Listas,2014EP,01-006-017,1000,334,0,334,0,1,333
Listas,2014EP,01-006-018,858,294,0,294,0,1,293
Listas,2014EP,01-006-019,902,343,0,343,0,0,343
Listas,2014EP,01-006-020,904,346,0,346,0,3,343
Listas,2014EP,01-006-021,997,365,0,365,0,2,363
Listas,2014EP,01-006-022,1275,454,0,454,0,1,453
Listas,2014EP,01-006-023,866,340,0,340,0,2,338
Listas,2014EP,01-006-024,964,368,0,368,0,0,368
Listas,2014EP,01-006-025,785,317,0,314,-3,0,314
Listas,2014EP,01-006-026,1539,932,0,932,0,5,927
Listas,2014EP,01-006-027,1052,393,0,393,0,0,393
Listas,2014EP,01-006-028,861,329,0,329,0,3,326
Listas,2014EP,01-006-029,1172,497,0,497,0,2,495
Listas,2014EP,01-006-030,673,350,0,350,0,3,347
Listas,2014EP,01-007-001,870,343,0,343,0,3,340
Listas,2014EP,01-007-002,915,255,0,255,0,4,251
Listas,2014EP,01-007-003,1007,303,0,303,0,1,302
Listas,2014EP,01-007-004,911,258,0,258,0,3,255
Listas,2014EP,01-007-005,1169,410,0,410,0,1,409
Listas,2014EP,01-007-006,1164,413,0,413,0,0,413
Listas,2014EP,01-007-007,1203,358,0,358,0,1,357
Listas,2014EP,01-007-008,1086,363,0,363,0,2,361
Listas,2014EP,01-007-009,1089,344,0,344,0,3,341
Listas,2014EP,01-007-010,1710,968,1,967,-1,0,967
Listas,2014EP,01-007-011,602,249,0,249,0,3,246
Listas,2014EP,01-007-012,1149,372,0,372,0,1,371
Listas,2014EP,01-007-013,1092,312,0,312,0,4,308
Listas,2014EP,01-007-014,1248,454,0,453,-1,1,452
Listas,2014EP,01-007-015,1106,361,0,361,0,1,360
Listas,2014EP,01-007-016,1263,399,0,399,0,0,399
Listas,2014EP,01-007-017,1151,399,0,398,-1,1,397
Listas,2014EP,01-007-018,1077,397,0,397,0,2,395
Listas,2014EP,01-007-019,1097,347,0,347,0,1,346
Listas,2014EP,01-007-020,1076,340,0,340,0,0,340
Listas,2014EP,01-007-021,1147,442,0,442,0,2,440
Listas,2014EP,01-007-022,1028,392,0,392,0,5,387
Listas,2014EP,01-007-023,1160,378,0,378,0,1,377
Listas,2014EP,01-007-024,1204,468,0,468,0,0,468
Listas,2014EP,01-007-025,1279,468,0,462,-6,12,450
Listas,2014EP,01-007-026,1192,339,0,339,0,3,336
Listas,2014EP,01-007-027,1084,374,0,374,0,1,373
Listas,2014EP,01-007-028,1139,449,0,449,0,1,448
Listas,2014EP,01-007-029,1157,380,0,380,0,1,379
Listas,2014EP,01-007-030,1215,352,0,352,0,2,350
Listas,2014EP,01-007-031,1227,388,0,388,0,1,387
Listas,2014EP,01-007-032,1210,318,0,318,0,0,318
Listas,2014EP,01-007-033,1251,384,0,384,0,0,384
Listas,2014EP,01-007-034,1227,371,0,371,0,0,371
Listas,2014EP,01-007-035,1200,372,0,372,0,2,370
Listas,2014EP,01-007-036,1052,313,0,313,0,2,311
Listas,2014EP,01-007-037,1072,288,0,288,0,0,288
Listas,2014EP,01-007-038,1126,302,0,302,0,1,301
Listas,2014EP,01-008-001,910,362,0,362,0,0,362
Listas,2014EP,01-008-002,836,326,0,326,0,4,322
Listas,2014EP,01-008-003,810,356,0,356,0,1,355
Listas,2014EP,01-008-004,731,265,0,265,0,4,261
Listas,2014EP,01-008-005,911,363,0,363,0,0,363
Listas,2014EP,01-008-006,742,289,0,289,0,0,289
Listas,2014EP,01-008-007,1131,447,0,447,0,1,446
Listas,2014EP,01-008-008,842,314,0,314,0,0,314
Listas,2014EP,01-008-009,1025,411,0,411,0,1,410
Listas,2014EP,01-008-010,828,335,0,335,0,0,335
Listas,2014EP,01-008-011,1192,459,0,459,0,2,457
Listas,2014EP,01-008-012,833,212,0,212,0,2,210
Listas,2014EP,01-008-013,1089,293,0,293,0,0,293
Listas,2014EP,01-008-014,976,327,0,326,-1,0,326
Listas,2014EP,01-008-015,1025,254,0,254,0,0,254
Listas,2014EP,01-008-016,1020,370,0,370,0,1,369
Listas,2014EP,01-008-017,1077,379,0,379,0,0,379
Listas,2014EP,01-008-018,837,320,0,320,0,2,318
Listas,2014EP,01-008-019,965,289,0,289,0,1,288
Listas,2014EP,01-008-020,1096,260,0,260,0,3,257
Listas,2014EP,01-008-021,999,248,0,248,0,2,246
Listas,2014EP,01-008-022,825,218,0,217,-1,1,216
Listas,2014EP,01-008-023,739,176,0,176,0,2,174
Listas,2014EP,01-008-024,1006,263,0,263,0,0,263
Listas,2014EP,01-008-025,854,286,0,286,0,0,286
Listas,2014EP,01-008-026,867,297,0,297,0,5,292
Listas,2014EP,01-008-027,927,239,0,239,0,0,239
Listas,2014EP,01-008-028,750,224,0,224,0,1,223
Listas,2014EP,01-008-029,971,210,0,210,0,0,210
Listas,2014EP,01-008-030,1139,201,0,201,0,0,201
Listas,2014EP,01-008-031,1037,107,0,107,0,0,107
Listas,2014EP,01-008-032,952,197,0,197,0,3,194
Listas,2014EP,01-008-033,652,183,0,183,0,0,183
Listas,2014EP,01-008-034,809,217,0,217,0,2,215
Listas,2014EP,01-008-035,846,173,2,171,-2,1,170
Listas,2014EP,01-008-036,798,293,0,293,0,1,292
Listas,2014EP,01-008-037,580,109,0,109,0,1,108
Listas,2014EP,01-008-038,830,282,0,282,0,2,280
Listas,2014EP,01-008-039,792,252,0,252,0,1,251
Listas,2014EP,01-008-040,795,236,0,236,0,1,235
Listas,2014EP,01-008-041,887,310,0,310,0,0,310
Listas,2014EP,01-008-042,656,139,0,139,0,0,139
Listas,2014EP,01-008-043,640,88,0,88,0,0,88
Listas,2014EP,01-008-044,1072,257,0,257,0,1,256
Listas,2014EP,01-008-045,865,130,0,130,0,0,130
Listas,2014EP,01-008-046,746,190,0,190,0,0,190
Listas,2014EP,01-008-047,909,270,0,270,0,1,269
Listas,2014EP,01-008-048,642,176,0,176,0,0,176
Listas,2014EP,01-008-049,1082,200,0,200,0,1,199
Listas,2014EP,01-008-050,1333,363,0,363,0,2,361
Listas,2014EP,01-008-051,643,132,0,132,0,0,132
Listas,2014EP,01-008-052,882,151,0,151,0,1,150
Listas,2014EP,01-008-053,1133,271,0,271,0,0,271
Listas,2014EP,01-008-054,654,354,0,354,0,0,354
Listas,2014EP,01-008-055,1029,387,0,387,0,2,385
Listas,2014EP,01-008-056,821,224,0,224,0,1,223
Listas,2014EP,01-008-057,1023,270,0,270,0,1,269
Listas,2014EP,01-008-058,600,206,0,206,0,0,206
Listas,2014EP,01-008-059,659,306,0,306,0,0,306
Listas,2014EP,01-008-060,579,209,0,209,0,0,209
Listas,2014EP,01-008-061,661,124,0,124,0,0,124
Listas,2014EP,01-008-062,2246,804,0,804,0,1,803
Listas,2014EP,01-009-001,692,270,0,270,0,1,269
Listas,2014EP,01-009-002,751,278,0,278,0,1,277
Listas,2014EP,01-009-003,675,275,0,275,0,0,275
Listas,2014EP,01-009-004,813,361,0,361,0,0,361
Listas,2014EP,01-009-005,771,256,0,256,0,2,254
Listas,2014EP,01-009-006,906,369,0,369,0,2,367
Listas,2014EP,01-009-007,636,265,0,264,-1,1,263
Listas,2014EP,01-009-008,709,268,0,268,0,3,265
Listas,2014EP,01-009-009,2204,1385,0,1385,0,4,1381
Listas,2014EP,01-009-010,727,367,0,367,0,2,365
Listas,2014EP,01-009-011,787,289,0,289,0,1,288
Listas,2014EP,01-009-012,805,298,0,298,0,3,295
Listas,2014EP,01-009-013,855,353,0,353,0,2,351
Listas,2014EP,01-009-014,929,408,0,408,0,0,408
Listas,2014EP,01-009-015,708,278,0,278,0,2,276
Listas,2014EP,01-009-016,892,263,0,263,0,1,262
Listas,2014EP,01-009-017,993,354,0,354,0,0,354
Listas,2014EP,01-009-018,839,286,0,286,0,1,285
Listas,2014EP,01-009-019,1085,250,0,250,0,0,250
Listas,2014EP,01-009-020,1023,211,0,211,0,0,211
Listas,2014EP,01-009-021,895,271,0,271,0,1,270
Listas,2014EP,01-009-022,919,271,0,271,0,0,271
Listas,2014EP,01-009-023,838,200,0,200,0,0,200
Listas,2014EP,01-009-024,667,204,0,204,0,1,203
Listas,2014EP,01-009-025,940,352,0,352,0,0,352
Listas,2014EP,01-009-026,771,304,0,304,0,0,304
Listas,2014EP,01-009-027,785,332,0,332,0,0,332
Listas,2014EP,01-009-028,763,320,0,320,0,3,317
Listas,2014EP,01-009-029,865,352,0,352,0,0,352
Listas,2014EP,01-009-030,911,345,0,345,0,1,344
Listas,2014EP,01-009-031,808,216,0,216,0,0,216
Listas,2014EP,01-009-032,715,182,0,182,0,0,182
Listas,2014EP,01-009-033,895,259,0,259,0,5,254
Listas,2014EP,01-009-034,758,225,0,225,0,1,224
Listas,2014EP,01-009-035,785,325,0,325,0,3,322
Listas,2014EP,01-009-036,1086,298,0,298,0,0,298
Listas,2014EP,01-009-037,747,180,0,180,0,0,180
Listas,2014EP,01-009-038,744,174,0,174,0,0,174
Listas,2014EP,01-009-039,827,136,0,136,0,0,136
Listas,2014EP,01-009-040,944,115,0,115,0,0,115
Listas,2014EP,01-009-041,673,279,0,279,0,0,279
Listas,2014EP,01-009-042,709,276,0,276,0,0,276
Listas,2014EP,01-009-043,652,281,0,281,0,3,278
Listas,2014EP,01-009-044,674,261,0,261,0,0,261
Listas,2014EP,01-009-045,897,301,0,301,0,2,299
Listas,2014EP,01-009-046,794,294,0,294,0,2,292
Listas,2014EP,01-009-047,715,285,0,285,0,1,284
Listas,2014EP,01-009-048,725,299,0,299,0,1,298
Listas,2014EP,01-009-049,939,352,0,352,0,1,351
Listas,2014EP,01-009-050,882,367,0,367,0,0,367
Listas,2014EP,01-009-051,847,313,0,313,0,1,312
Listas,2014EP,01-009-052,837,335,0,335,0,4,331
Listas,2014EP,01-009-053,798,328,0,328,0,1,327
Listas,2014EP,01-010-001,647,238,0,238,0,2,236
Listas,2014EP,01-010-002,677,266,0,266,0,1,265
Listas,2014EP,01-010-003,805,156,0,156,0,0,156
Listas,2014EP,01-010-004,628,145,0,145,0,2,143
Listas,2014EP,01-010-005,644,145,0,145,0,2,143
Listas,2014EP,01-010-006,668,170,0,170,0,0,170
Listas,2014EP,01-010-007,647,228,0,228,0,0,228
Listas,2014EP,01-010-008,665,175,0,175,0,0,175
Listas,2014EP,01-010-009,902,273,0,273,0,0,273
Listas,2014EP,01-010-010,645,205,0,205,0,0,205
Listas,2014EP,01-010-011,742,277,0,277,0,0,277
Listas,2014EP,01-010-012,730,319,0,319,0,2,317
Listas,2014EP,01-010-013,764,277,0,277,0,3,274
Listas,2014EP,01-010-014,699,193,0,193,0,0,193
Listas,2014EP,01-010-015,792,214,0,214,0,0,214
Listas,2014EP,01-010-016,811,265,0,265,0,0,265
Listas,2014EP,01-010-017,821,303,0,303,0,1,302
Listas,2014EP,01-010-018,777,181,0,181,0,0,181
Listas,2014EP,01-010-019,765,293,0,293,0,0,293
Listas,2014EP,01-010-020,895,253,0,253,0,2,251
Listas,2014EP,01-010-021,979,265,0,265,0,0,265
Listas,2014EP,01-010-022,852,354,0,354,0,5,349
Listas,2014EP,01-010-023,821,292,0,292,0,0,292
Listas,2014EP,01-010-024,826,258,0,258,0,5,253
Listas,2014EP,01-010-025,638,197,0,197,0,0,197
Listas,2014EP,01-010-026,666,266,0,266,0,1,265
Listas,2014EP,01-010-027,854,225,0,225,0,0,225
Listas,2014EP,01-010-028,794,239,0,239,0,0,239
Listas,2014EP,01-010-029,840,267,0,267,0,1,266
Listas,2014EP,01-010-030,721,231,0,231,0,1,230
Listas,2014EP,01-010-031,817,342,0,342,0,1,341
Listas,2014EP,01-010-032,877,415,0,414,-1,0,414
Listas,2014EP,01-010-033,817,183,0,183,0,1,182
Listas,2014EP,01-010-034,836,239,0,239,0,0,239
Listas,2014EP,01-010-035,1467,828,0,828,0,8,820
Listas,2014EP,01-010-036,828,271,0,271,0,0,271
Listas,2014EP,01-010-037,905,308,0,308,0,0,308
Listas,2014EP,01-010-038,795,318,0,317,-1,2,315
Listas,2014EP,01-010-039,625,209,0,209,0,1,208
Listas,2014EP,01-010-040,708,193,0,193,0,0,193
Listas,2014EP,01-010-041,642,294,0,294,0,0,294
Listas,2014EP,01-010-042,762,288,0,288,0,2,286
Listas,2014EP,01-010-043,691,221,0,221,0,0,221
Listas,2014EP,01-010-044,678,230,0,230,0,0,230
Listas,2014EP,01-010-045,611,284,0,284,0,0,284
Listas,2014EP,01-010-046,621,206,0,206,0,1,205
Listas,2014EP,01-010-047,702,206,0,206,0,1,205
Listas,2014EP,01-010-048,755,203,0,203,0,1,202
Listas,2014EP,01-010-049,744,164,0,164,0,0,164
Listas,2014EP,01-010-050,775,182,0,182,0,0,182
Listas,2014EP,01-010-051,682,246,0,246,0,1,245
Listas,2014EP,01-010-052,664,211,0,211,0,0,211
Listas,2014EP,01-010-053,711,298,0,298,0,1,297
Listas,2014EP,01-010-054,717,323,0,323,0,0,323
Listas,2014EP,01-010-055,732,244,0,244,0,1,243
Listas,2014EP,01-010-056,885,243,0,243,0,1,242
Listas,2014EP,01-010-057,852,253,0,252,-1,0,252
Listas,2014EP,01-010-058,699,220,0,220,0,0,220
Listas,2014EP,01-010-059,644,219,0,219,0,2,217
Listas,2014EP,01-010-060,759,210,0,210,0,1,209
Listas,2014EP,01-010-061,841,318,0,318,0,3,315
Listas,2014EP,01-010-062,828,203,0,203,0,0,203
Listas,2014EP,01-010-063,848,256,0,255,-1,0,255
Listas,2014EP,01-010-064,801,260,0,260,0,3,257
Listas,2014EP,01-010-065,782,218,0,218,0,0,218
Listas,2014EP,01-010-066,848,237,0,237,0,1,236
Listas,2014EP,01-010-067,825,207,0,207,0,0,207
Listas,2014EP,01-010-068,693,242,0,242,0,0,242
Listas,2014EP,01-010-069,759,239,0,238,-1,0,238
Listas,2014EP,01-010-070,993,296,0,296,0,1,295
Listas,2014EP,01-010-071,935,309,0,309,0,0,309
Listas,2014EP,01-010-072,935,287,0,287,0,0,287
Listas,2014EP,01-010-073,894,251,0,251,0,0,251
Listas,2014EP,01-010-074,878,246,0,246,0,2,244
Listas,2014EP,01-010-075,639,243,0,243,0,1,242
Listas,2014EP,01-010-076,717,255,0,255,0,0,255
Listas,2014EP,01-011-001,849,414,0,414,0,2,412
Listas,2014EP,01-011-002,908,481,0,480,-1,0,480
Listas,2014EP,01-011-003,787,479,0,478,-1,1,477
Listas,2014EP,01-011-004,843,394,0,394,0,0,394
Listas,2014EP,01-011-005,877,504,0,502,-2,1,501
Listas,2014EP,01-011-006,928,480,0,479,-1,1,478
Listas,2014EP,01-011-007,847,406,0,406,0,2,404
Listas,2014EP,01-011-008,771,379,0,379,0,0,379
Listas,2014EP,01-011-009,859,402,0,402,0,1,401
Listas,2014EP,01-011-010,804,391,0,391,0,1,390
Listas,2014EP,01-011-011,905,407,0,407,0,1,406
Listas,2014EP,01-011-012,939,416,0,416,0,1,415
Listas,2014EP,01-011-013,798,368,0,368,0,3,365
Listas,2014EP,01-011-014,784,344,0,344,0,1,343
Listas,2014EP,01-011-015,734,393,0,392,-1,0,392
Listas,2014EP,01-011-016,856,403,1,403,0,1,402
Listas,2014EP,01-011-017,845,375,0,375,0,1,374
Listas,2014EP,01-011-018,810,373,0,373,0,1,372
Listas,2014EP,01-011-019,969,382,0,382,0,1,381
Listas,2014EP,01-011-020,846,364,0,364,0,2,362
Listas,2014EP,01-011-021,874,415,0,414,-1,1,413
Listas,2014EP,01-011-022,906,432,0,432,0,0,432
Listas,2014EP,01-011-023,715,373,0,373,0,1,372
Listas,2014EP,01-011-024,860,466,0,466,0,4,462
Listas,2014EP,01-011-025,810,382,0,382,0,0,382
Listas,2014EP,01-011-026,836,430,0,430,0,1,429
Listas,2014EP,01-011-027,929,427,0,427,0,1,426
Listas,2014EP,01-011-028,825,333,0,333,0,0,333
Listas,2014EP,01-011-029,914,450,3,446,-4,0,446
Listas,2014EP,01-011-030,926,457,0,457,0,1,456
Listas,2014EP,01-011-031,917,409,0,409,0,1,408
Listas,2014EP,01-011-032,837,394,0,393,-1,1,392
Listas,2014EP,01-011-033,909,414,0,414,0,4,410
Listas,2014EP,01-011-034,666,314,0,314,0,1,313
Listas,2014EP,01-011-035,2843,2037,0,2036,-1,8,2028
Listas,2014EP,01-011-036,1058,551,0,551,0,1,550
Listas,2014EP,01-011-037,916,473,0,473,0,1,472
Listas,2014EP,01-011-038,850,477,0,477,0,2,475
Listas,2014EP,01-011-039,944,575,0,575,0,1,574
Listas,2014EP,01-011-040,866,447,0,447,0,1,446
Listas,2014EP,01-011-041,848,447,0,447,0,0,447
Listas,2014EP,01-011-042,968,603,0,603,0,0,603
Listas,2014EP,01-011-043,985,571,0,571,0,1,570
Listas,2014EP,01-011-044,917,536,0,536,0,6,530
Listas,2014EP,01-011-045,874,513,0,512,-1,4,508
Listas,2014EP,01-011-046,949,547,2,545,-2,0,545
Listas,2014EP,01-011-047,991,547,0,547,0,2,545
Listas,2014EP,01-011-048,965,518,0,518,0,1,517
Listas,2014EP,01-011-049,1014,586,0,586,0,1,585
Listas,2014EP,01-011-050,987,365,0,365,0,0,365
Listas,2014EP,01-011-051,1010,429,0,428,-1,1,427
Listas,2014EP,01-011-052,810,385,0,385,0,0,385
Listas,2014EP,01-011-053,891,397,0,397,0,2,395
Listas,2014EP,01-011-054,881,381,0,381,0,0,381
Listas,2014EP,01-011-055,955,430,0,429,-1,3,426
Listas,2014EP,01-011-056,894,404,0,404,0,1,403
Listas,2014EP,01-011-057,846,420,0,420,0,2,418
Listas,2014EP,01-011-058,765,334,0,334,0,1,333
Listas,2014EP,01-011-059,1110,489,0,489,0,1,488
Listas,2014EP,01-011-060,1044,455,0,455,0,1,454
Listas,2014EP,01-011-061,1087,492,0,492,0,2,490
Listas,2014EP,01-011-062,878,435,0,435,0,3,432
Listas,2014EP,01-011-063,771,374,0,374,0,0,374
Listas,2014EP,01-011-064,1016,430,0,430,0,2,428
Listas,2014EP,01-011-065,768,307,0,307,0,2,305
Listas,2014EP,01-011-066,783,341,0,341,0,0,341
Listas,2014EP,01-011-067,971,388,0,388,0,3,385
Listas,2014EP,01-011-068,922,349,0,349,0,0,349
Listas,2014EP,01-011-069,1021,376,0,376,0,2,374
Listas,2014EP,01-011-070,806,259,0,259,0,2,257
Listas,2014EP,01-011-071,928,422,0,421,-1,3,418
Listas,2014EP,01-011-072,982,507,0,507,0,1,506
Listas,2014EP,01-011-073,762,325,0,325,0,0,325
Listas,2014EP,01-011-074,777,298,0,298,0,0,298
Listas,2014EP,01-011-075,788,307,0,307,0,1,306
Listas,2014EP,01-011-076,880,382,0,382,0,1,381
Listas,2014EP,01-011-077,848,359,0,359,0,1,358
Listas,2014EP,01-011-078,789,264,0,264,0,1,263
Listas,2014EP,01-011-079,798,333,0,333,0,2,331
Listas,2014EP,01-011-080,736,290,0,290,0,2,288
Listas,2014EP,01-011-081,958,458,0,457,-1,1,456
Listas,2014EP,01-011-082,1173,441,0,441,0,1,440
Listas,2014EP,01-011-083,1003,340,0,340,0,0,340
Listas,2014EP,01-011-084,1036,474,0,474,0,0,474
Listas,2014EP,01-011-085,1177,505,0,505,0,0,505
Listas,2014EP,01-011-086,1269,521,1,520,-1,0,520
Listas,2014EP,01-011-087,934,318,0,318,0,1,317
Listas,2014EP,01-011-088,1025,366,0,366,0,0,366
Listas,2014EP,01-011-089,971,360,0,360,0,0,360
Listas,2014EP,01-011-090,794,260,0,260,0,2,258
Listas,2014EP,01-011-091,839,410,0,410,0,4,406
Listas,2014EP,01-011-092,980,380,0,380,0,2,378
Listas,2014EP,01-011-093,792,243,0,243,0,0,243
Listas,2014EP,01-011-094,1068,360,0,359,-1,0,359
Listas,2014EP,01-011-095,734,274,0,274,0,0,274
Listas,2014EP,01-011-096,910,343,0,342,-1,1,341
Listas,2014EP,01-011-097,819,286,0,286,0,0,286
Listas,2014EP,01-011-098,854,304,0,304,0,1,303
Listas,2014EP,01-011-099,689,199,0,199,0,1,198
Listas,2014EP,01-011-100,835,306,0,306,0,1,305
Listas,2014EP,01-011-101,689,280,0,280,0,0,280
Listas,2014EP,01-011-102,712,328,0,328,0,1,327
Listas,2014EP,01-011-103,961,365,0,365,0,3,362
Listas,2014EP,01-011-104,1052,528,0,528,0,1,527
Listas,2014EP,01-011-105,1038,501,0,502,1,9,493
Listas,2014EP,01-011-106,1117,401,0,401,0,1,400
Listas,2014EP,01-011-107,886,323,0,323,0,0,323
Listas,2014EP,01-011-108,785,286,0,285,-1,1,284
Listas,2014EP,01-011-109,794,393,0,393,0,1,392
Listas,2014EP,01-011-110,754,292,0,292,0,0,292
Listas,2014EP,01-011-111,878,413,0,413,0,0,413
Listas,2014EP,01-011-112,892,393,0,393,0,1,392
Listas,2014EP,01-011-113,859,445,0,444,-1,3,441
Listas,2014EP,01-011-114,967,430,0,430,0,3,427
Listas,2014EP,01-011-115,957,461,0,461,0,0,461
Listas,2014EP,01-011-116,867,399,0,399,0,1,398
Listas,2014EP,01-011-117,1021,399,0,399,0,0,399
Listas,2014EP,01-011-118,1012,287,0,285,-2,2,283
Listas,2014EP,01-012-001,695,338,0,338,0,0,338
Listas,2014EP,01-012-002,741,292,0,291,-1,1,290
Listas,2014EP,01-012-003,524,227,1,226,-1,0,226
Listas,2014EP,01-012-004,768,417,0,417,0,1,416
Listas,2014EP,01-012-005,644,295,0,292,-3,0,292
Listas,2014EP,01-012-006,589,292,0,291,-1,0,291
Listas,2014EP,01-012-007,843,399,0,399,0,1,398
Listas,2014EP,01-012-008,893,440,0,439,-1,0,439
Listas,2014EP,01-012-009,952,506,0,506,0,0,506
Listas,2014EP,01-012-010,1022,548,0,548,0,2,546
Listas,2014EP,01-012-011,827,431,0,430,-1,2,428
Listas,2014EP,01-012-012,1015,574,0,574,0,0,574
Listas,2014EP,01-012-013,659,376,0,376,0,0,376
Listas,2014EP,01-012-014,658,362,0,362,0,0,362
Listas,2014EP,01-012-015,754,400,0,399,-1,3,396
Listas,2014EP,01-012-016,726,403,0,403,0,2,401
Listas,2014EP,01-012-017,977,403,0,402,-1,0,402
Listas,2014EP,01-012-018,856,458,0,458,0,5,453
Listas,2014EP,01-012-019,865,460,0,460,0,0,460
Listas,2014EP,01-012-020,826,383,0,382,-1,1,381
Listas,2014EP,01-012-021,805,388,0,387,-1,1,386
Listas,2014EP,01-012-022,557,331,0,331,0,0,331
Listas,2014EP,01-012-023,1697,1183,2,1181,-2,1,1180
Listas,2014EP,01-012-024,636,360,0,360,0,0,360
Listas,2014EP,01-012-025,795,479,0,479,0,1,478
Listas,2014EP,01-012-026,745,439,0,439,0,0,439
Listas,2014EP,01-012-027,731,449,0,449,0,1,448
Listas,2014EP,01-012-028,1046,545,0,545,0,1,544
Listas,2014EP,01-012-029,717,381,0,381,0,0,381
Listas,2014EP,01-012-030,908,506,0,506,0,0,506
Listas,2014EP,01-012-031,750,385,0,385,0,2,383
Listas,2014EP,01-012-032,839,406,0,405,-1,2,403
Listas,2014EP,01-012-033,993,418,0,417,-1,1,416
Listas,2014EP,01-012-034,883,517,0,517,0,1,516
Listas,2014EP,01-012-035,874,502,0,502,0,1,501
Listas,2014EP,01-012-036,719,422,0,422,0,3,419
Listas,2014EP,01-012-037,779,423,0,423,0,1,422
Listas,2014EP,01-012-038,960,508,0,507,-1,2,505
Listas,2014EP,01-012-039,984,534,0,534,0,1,533
Listas,2014EP,01-012-040,763,441,0,441,0,1,440
Listas,2014EP,01-012-041,624,368,0,368,0,0,368
Listas,2014EP,01-012-042,913,522,0,522,0,0,522
Listas,2014EP,01-012-043,970,517,0,517,0,1,516
Listas,2014EP,01-012-044,1001,497,0,497,0,0,497
Listas,2014EP,01-012-045,646,298,0,298,0,0,298
Listas,2014EP,01-012-046,1045,512,0,512,0,2,510
Listas,2014EP,01-012-047,1013,513,0,513,0,1,512
Listas,2014EP,01-012-048,911,393,0,392,-1,3,389
Listas,2014EP,01-012-049,918,502,0,502,0,2,500
Listas,2014EP,01-012-050,834,456,0,456,0,2,454
Listas,2014EP,01-012-051,629,370,0,370,0,7,363
Listas,2014EP,01-012-052,945,511,0,511,0,0,511
Listas,2014EP,01-012-053,899,457,0,457,0,0,457
Listas,2014EP,01-012-054,732,374,0,374,0,1,373
Listas,2014EP,01-012-055,740,389,0,389,0,0,389
Listas,2014EP,01-013-001,581,181,0,181,0,2,179
Listas,2014EP,01-013-002,623,247,0,247,0,1,246
Listas,2014EP,01-013-003,605,224,0,224,0,3,221
Listas,2014EP,01-013-004,817,399,0,399,0,0,399
Listas,2014EP,01-013-005,731,351,0,351,0,0,351
Listas,2014EP,01-013-006,600,298,0,298,0,1,297
Listas,2014EP,01-013-007,710,365,0,365,0,2,363
Listas,2014EP,01-013-008,661,374,0,372,-2,1,371
Listas,2014EP,01-013-009,801,386,0,386,0,1,385
Listas,2014EP,01-013-010,879,367,1,366,-1,0,366
Listas,2014EP,01-013-011,872,337,0,337,0,3,334
Listas,2014EP,01-013-012,858,359,0,358,-1,3,355
Listas,2014EP,01-013-013,897,409,0,409,0,0,409
Listas,2014EP,01-013-014,737,382,0,382,0,1,381
Listas,2014EP,01-013-015,698,373,0,373,0,1,372
Listas,2014EP,01-013-016,786,432,0,431,-1,1,430
Listas,2014EP,01-013-017,1038,516,0,516,0,3,513
Listas,2014EP,01-013-018,755,337,0,337,0,0,337
Listas,2014EP,01-013-019,848,381,0,381,0,1,380
Listas,2014EP,01-013-020,777,349,0,349,0,3,346
Listas,2014EP,01-013-021,969,448,0,448,0,2,446
Listas,2014EP,01-013-022,728,401,1,400,-1,1,399
Listas,2014EP,01-013-023,1101,597,0,597,0,3,594
Listas,2014EP,01-013-024,1075,526,0,526,0,2,524
Listas,2014EP,01-013-025,1005,437,1,436,-1,1,435
Listas,2014EP,01-013-026,937,401,0,401,0,0,401
Listas,2014EP,01-013-027,765,273,0,273,0,0,273
Listas,2014EP,01-013-028,878,379,0,379,0,1,378
Listas,2014EP,01-013-029,839,326,0,326,0,1,325
Listas,2014EP,01-013-030,675,276,0,274,-2,0,274
Listas,2014EP,01-013-031,1154,443,0,443,0,1,442
Listas,2014EP,01-013-032,752,296,0,294,-2,0,294
Listas,2014EP,01-013-033,1136,318,0,316,-2,1,315
Listas,2014EP,01-013-034,1119,242,0,242,0,1,241
Listas,2014EP,01-013-035,1223,211,0,211,0,1,210
Listas,2014EP,01-013-036,1008,478,0,478,0,3,475
Listas,2014EP,01-013-037,1090,504,0,504,0,1,503
Listas,2014EP,01-013-038,1012,490,0,490,0,3,487
Listas,2014EP,01-013-039,1293,356,0,356,0,0,356
Listas,2014EP,01-013-040,1239,237,0,237,0,2,235
Listas,2014EP,01-013-041,1083,392,0,392,0,0,392
Listas,2014EP,01-013-042,1147,373,0,372,-1,2,370
Listas,2014EP,01-013-043,832,303,0,303,0,0,303
Listas,2014EP,01-013-044,837,386,0,386,0,1,385
Listas,2014EP,01-013-045,767,291,0,291,0,0,291
Listas,2014EP,01-013-046,1096,354,0,354,0,0,354
Listas,2014EP,01-013-047,1065,289,0,289,0,0,289
Listas,2014EP,01-013-048,688,194,0,194,0,0,194
Listas,2014EP,01-013-049,1085,423,0,423,0,1,422
Listas,2014EP,01-013-050,1030,340,0,337,-3,4,333
Listas,2014EP,01-013-051,1095,455,0,455,0,1,454
Listas,2014EP,01-013-052,967,377,0,377,0,2,375
Listas,2014EP,01-013-053,878,417,0,417,0,3,414
Listas,2014EP,01-013-054,831,354,0,353,-1,0,353
Listas,2014EP,01-013-055,1208,373,0,372,-1,1,371
Listas,2014EP,01-013-056,972,200,0,200,0,1,199
Listas,2014EP,01-013-057,1072,319,0,319,0,0,319
Listas,2014EP,01-013-058,916,232,0,232,0,2,230
Listas,2014EP,01-013-059,1088,352,0,352,0,0,352
Listas,2014EP,01-013-060,734,186,0,186,0,1,185
Listas,2014EP,01-013-061,1059,262,0,262,0,1,261
Listas,2014EP,01-013-062,1262,382,0,382,0,1,381
Listas,2014EP,01-013-063,707,220,0,220,0,1,219
Listas,2014EP,01-013-064,687,140,0,140,0,1,139
Listas,2014EP,01-013-065,2657,1397,0,1394,-3,4,1390
Listas,2014EP,01-013-066,1087,413,0,413,0,2,411
Listas,2014EP,01-013-067,895,370,0,370,0,1,369
Listas,2014EP,01-013-068,1154,365,0,365,0,3,362
Listas,2014EP,01-013-069,1075,404,0,401,-3,1,400
Listas,2014EP,01-013-070,779,293,0,293,0,1,292
Listas,2014EP,01-013-071,958,489,0,489,0,4,485
Listas,2014EP,01-013-072,675,307,0,307,0,1,306
Listas,2014EP,01-013-073,838,376,0,376,0,2,374
Listas,2014EP,01-013-074,1030,356,0,356,0,0,356
Listas,2014EP,01-013-075,1183,459,0,459,0,3,456
Listas,2014EP,01-013-076,1001,377,0,377,0,0,377
Listas,2014EP,01-013-077,1120,460,0,460,0,0,460
Listas,2014EP,01-013-078,808,301,0,301,0,0,301
Listas,2014EP,01-013-079,693,259,0,259,0,1,258
Listas,2014EP,01-013-080,1310,280,0,280,0,3,277
Listas,2014EP,01-013-081,706,293,0,293,0,1,292
Listas,2014EP,01-013-082,1066,389,0,389,0,3,386
Listas,2014EP,01-013-083,652,219,0,219,0,1,218
Listas,2014EP,01-013-084,683,243,0,243,0,0,243
Listas,2014EP,01-013-085,1105,417,0,415,-2,0,415
Listas,2014EP,01-013-086,714,232,0,232,0,0,232
Listas,2014EP,01-013-087,727,255,0,255,0,3,252
Listas,2014EP,01-013-088,840,378,0,378,0,1,377
Listas,2014EP,01-013-089,678,213,0,213,0,1,212
Listas,2014EP,01-013-090,878,392,0,392,0,1,391
Listas,2014EP,01-013-091,992,354,0,354,0,0,354
Listas,2014EP,01-013-092,767,273,0,273,0,0,273
Listas,2014EP,01-013-093,1138,495,0,495,0,0,495
Listas,2014EP,01-013-094,1100,394,0,394,0,2,392
Listas,2014EP,01-013-095,778,236,0,231,-5,1,230
Listas,2014EP,01-013-096,974,277,0,277,0,1,276
Listas,2014EP,01-013-097,827,329,0,328,-1,2,326
Listas,2014EP,01-013-098,635,264,0,264,0,1,263
Listas,2014EP,01-014-001,910,398,0,398,0,2,396
Listas,2014EP,01-014-002,962,431,0,431,0,2,429
Listas,2014EP,01-014-003,879,378,0,378,0,0,378
Listas,2014EP,01-014-004,858,387,0,387,0,0,387
Listas,2014EP,01-014-005,917,401,0,401,0,2,399
Listas,2014EP,01-014-006,933,392,0,392,0,1,391
Listas,2014EP,01-014-007,875,290,0,290,0,0,290
Listas,2014EP,01-014-008,971,441,0,436,-5,4,432
Listas,2014EP,01-014-009,899,370,0,370,0,1,369
Listas,2014EP,01-014-010,873,360,0,360,0,3,357
Listas,2014EP,01-014-011,842,341,0,341,0,1,340
Listas,2014EP,01-014-012,911,411,0,410,-1,3,407
Listas,2014EP,01-014-013,894,316,0,316,0,3,313
Listas,2014EP,01-014-014,958,436,0,436,0,4,432
Listas,2014EP,01-014-015,1011,365,0,365,0,0,365
Listas,2014EP,01-014-016,773,384,0,384,0,0,384
Listas,2014EP,01-014-017,923,415,1,414,-1,2,412
Listas,2014EP,01-014-018,901,438,0,438,0,4,434
Listas,2014EP,01-014-019,934,383,0,383,0,5,378
Listas,2014EP,01-014-020,877,406,0,406,0,1,405
Listas,2014EP,01-014-021,955,474,0,474,0,1,473
Listas,2014EP,01-014-022,824,363,0,363,0,1,362
Listas,2014EP,01-014-023,843,255,0,255,0,0,255
Listas,2014EP,01-014-024,939,348,0,348,0,2,346
Listas,2014EP,01-014-025,836,370,0,370,0,0,370
Listas,2014EP,01-014-026,999,393,0,393,0,1,392
Listas,2014EP,01-014-027,720,221,0,221,0,0,221
Listas,2014EP,01-014-028,979,438,0,438,0,0,438
Listas,2014EP,01-014-029,892,421,0,421,0,2,419
Listas,2014EP,01-014-030,938,425,0,425,0,3,422
Listas,2014EP,01-014-031,902,330,0,330,0,1,329
Listas,2014EP,01-014-032,928,369,0,369,0,2,367
Listas,2014EP,01-014-033,906,405,0,404,-1,1,403
Listas,2014EP,01-014-034,946,401,1,402,1,7,395
Listas,2014EP,01-014-035,740,272,0,272,0,2,270
Listas,2014EP,01-014-036,663,284,0,284,0,2,282
Listas,2014EP,01-014-037,960,444,0,444,0,2,442
Listas,2014EP,01-014-038,1230,480,0,480,0,1,479
Listas,2014EP,01-014-039,1158,516,0,516,0,1,515
Listas,2014EP,01-014-040,2465,1544,0,1544,0,4,1540
Listas,2014EP,01-014-041,1208,461,0,461,0,0,461
Listas,2014EP,01-014-042,960,264,0,263,-1,2,261
Listas,2014EP,01-014-043,1007,451,0,451,0,1,450
Listas,2014EP,01-014-044,847,333,0,333,0,0,333
Listas,2014EP,01-014-045,893,315,0,314,-1,1,313
Listas,2014EP,01-014-046,909,442,0,441,-1,0,441
Listas,2014EP,01-014-047,911,433,0,433,0,2,431
Listas,2014EP,01-014-048,919,467,0,467,0,1,466
Listas,2014EP,01-014-049,861,389,0,389,0,0,389
Listas,2014EP,01-014-050,1081,325,0,325,0,1,324
Listas,2014EP,01-014-051,964,228,1,227,-1,1,226
Listas,2014EP,01-014-052,863,374,0,374,0,2,372
Listas,2014EP,01-014-053,811,340,0,340,0,1,339
Listas,2014EP,01-014-054,979,330,0,330,0,0,330
Listas,2014EP,01-014-055,1017,406,0,406,0,1,405
Listas,2014EP,01-014-056,915,325,0,325,0,6,319
Listas,2014EP,01-014-057,950,360,0,360,0,1,359
Listas,2014EP,01-014-058,881,340,0,340,0,7,333
Listas,2014EP,01-014-059,904,263,0,263,0,0,263
Listas,2014EP,01-014-060,906,420,0,419,-1,5,414
Listas,2014EP,01-014-061,912,431,0,431,0,2,429
Listas,2014EP,01-014-062,875,386,0,386,0,0,386
Listas,2014EP,01-014-063,831,349,0,349,0,0,349
Listas,2014EP,01-014-064,923,359,0,359,0,0,359
Listas,2014EP,01-014-065,745,332,0,332,0,3,329
Listas,2014EP,01-014-066,892,379,0,379,0,0,379
Listas,2014EP,01-014-067,935,419,0,419,0,1,418
Listas,2014EP,01-014-068,889,428,0,428,0,2,426
Listas,2014EP,01-014-069,991,482,0,482,0,0,482
Listas,2014EP,01-014-070,848,413,0,412,-1,0,412
Listas,2014EP,01-014-071,859,403,0,403,0,0,403
Listas,2014EP,01-014-072,1146,503,0,503,0,0,503
Listas,2014EP,01-014-073,680,287,0,287,0,0,287
Listas,2014EP,01-014-074,853,378,0,378,0,0,378
Listas,2014EP,01-014-075,874,321,0,321,0,0,321
Listas,2014EP,01-014-076,952,334,0,333,-1,1,332
Listas,2014EP,01-014-077,883,318,0,318,0,2,316
Listas,2014EP,01-014-078,896,392,0,392,0,0,392
Listas,2014EP,01-014-079,872,397,0,395,-2,0,395
Listas,2014EP,01-014-080,936,379,0,378,-1,1,377
Listas,2014EP,01-014-081,987,340,0,341,1,7,334
Listas,2014EP,01-014-082,1190,394,0,393,-1,1,392
Listas,2014EP,01-014-083,560,283,0,283,0,1,282
Listas,2014EP,01-014-084,943,427,0,427,0,2,425
Listas,2014EP,01-014-085,1024,460,0,460,0,0,460
Listas,2014EP,01-014-086,914,288,0,288,0,1,287
Listas,2014EP,01-014-087,740,295,0,295,0,2,293
Listas,2014EP,01-014-088,899,337,0,337,0,0,337
Listas,2014EP,01-014-089,986,442,0,442,0,3,439
Listas,2014EP,01-014-090,910,322,0,322,0,0,322
Listas,2014EP,01-014-091,798,244,0,244,0,0,244
Listas,2014EP,01-014-092,912,339,0,339,0,2,337
Listas,2014EP,01-014-093,882,356,0,356,0,1,355
Listas,2014EP,01-014-094,985,339,0,339,0,1,338
Listas,2014EP,01-014-095,942,326,0,326,0,3,323
Listas,2014EP,01-014-096,963,377,0,377,0,3,374
Listas,2014EP,01-014-097,860,359,0,359,0,2,357
Listas,2014EP,01-014-098,891,318,0,318,0,1,317
Listas,2014EP,01-014-099,958,377,0,376,-1,0,376
Listas,2014EP,01-014-100,960,387,0,387,0,1,386
Listas,2014EP,01-015-001,919,368,0,368,0,0,368
Listas,2014EP,01-015-002,854,343,0,343,0,3,340
Listas,2014EP,01-015-003,1000,387,0,387,0,1,386
Listas,2014EP,01-015-004,1090,411,0,411,0,1,410
Listas,2014EP,01-015-005,1515,648,0,648,0,0,648
Listas,2014EP,01-015-006,1058,433,0,433,0,1,432
Listas,2014EP,01-015-007,845,302,0,302,0,1,301
Listas,2014EP,01-015-008,805,276,0,276,0,0,276
Listas,2014EP,01-015-009,715,235,0,235,0,0,235
Listas,2014EP,01-015-010,1055,364,0,364,0,1,363
Listas,2014EP,01-015-011,985,336,0,336,0,1,335
Listas,2014EP,01-015-012,1094,340,0,339,-1,1,338
Listas,2014EP,01-015-013,1165,320,0,320,0,0,320
Listas,2014EP,01-015-014,824,220,0,220,0,0,220
Listas,2014EP,01-015-015,800,251,0,250,-1,2,248
Listas,2014EP,01-015-016,1061,374,0,374,0,2,372
Listas,2014EP,01-015-017,760,260,0,260,0,2,258
Listas,2014EP,01-015-018,782,298,0,298,0,0,298
Listas,2014EP,01-015-019,1003,352,0,352,0,0,352
Listas,2014EP,01-015-020,1078,336,0,336,0,0,336
Listas,2014EP,01-015-021,1036,345,0,345,0,0,345
Listas,2014EP,01-015-022,923,325,0,325,0,0,325
Listas,2014EP,01-015-023,987,405,0,405,0,1,404
Listas,2014EP,01-015-024,1051,404,0,404,0,2,402
Listas,2014EP,01-015-025,952,373,0,373,0,3,370
Listas,2014EP,01-015-026,813,323,0,323,0,0,323
Listas,2014EP,01-015-027,960,380,0,380,0,1,379
Listas,2014EP,01-015-028,949,328,1,327,-1,3,324
Listas,2014EP,01-015-029,901,330,0,330,0,1,329
Listas,2014EP,01-015-030,716,291,0,291,0,0,291
Listas,2014EP,01-015-031,881,257,0,257,0,0,257
Listas,2014EP,01-015-032,794,289,0,288,-1,0,288
Listas,2014EP,01-015-033,886,344,0,344,0,0,344
Listas,2014EP,01-015-034,754,371,0,371,0,0,371
Listas,2014EP,01-015-035,1115,436,1,436,0,3,433
Listas,2014EP,01-015-036,763,313,0,312,-1,1,311
Listas,2014EP,01-015-037,896,397,0,397,0,6,391
Listas,2014EP,01-015-038,969,371,0,371,0,1,370
Listas,2014EP,01-015-039,947,350,0,350,0,1,349
Listas,2014EP,01-015-040,778,244,0,244,0,0,244
Listas,2014EP,01-015-041,860,276,0,276,0,0,276
Listas,2014EP,01-015-042,996,296,0,296,0,2,294
Listas,2014EP,01-015-043,1007,342,0,342,0,0,342
Listas,2014EP,01-015-044,921,287,0,287,0,0,287
Listas,2014EP,01-015-045,784,220,0,220,0,0,220
Listas,2014EP,01-015-046,954,281,0,281,0,2,279
Listas,2014EP,01-015-047,852,244,0,244,0,2,242
Listas,2014EP,01-015-048,795,230,0,230,0,0,230
Listas,2014EP,01-015-049,829,343,0,343,0,4,339
Listas,2014EP,01-015-050,759,193,0,193,0,3,190
Listas,2014EP,01-015-051,768,212,0,212,0,1,211
Listas,2014EP,01-015-052,921,266,0,266,0,5,261
Listas,2014EP,01-015-053,794,278,0,278,0,2,276
Listas,2014EP,01-015-054,845,217,0,217,0,2,215
Listas,2014EP,01-015-055,884,277,0,277,0,0,277
Listas,2014EP,01-015-056,911,258,0,258,0,0,258
Listas,2014EP,01-015-057,884,280,0,280,0,0,280
Listas,2014EP,01-015-058,1158,392,0,392,0,2,390
Listas,2014EP,01-015-059,871,227,0,227,0,7,220
Listas,2014EP,01-015-060,938,289,0,289,0,0,289
Listas,2014EP,01-015-061,824,269,0,269,0,0,269
Listas,2014EP,01-015-062,811,236,0,236,0,1,235
Listas,2014EP,01-015-063,861,226,0,226,0,1,225
Listas,2014EP,01-015-064,863,300,0,300,0,1,299
Listas,2014EP,01-015-065,913,319,0,318,-1,0,318
Listas,2014EP,01-015-066,842,319,0,319,0,0,319
Listas,2014EP,01-015-067,927,342,0,342,0,2,340
Listas,2014EP,01-015-068,1062,322,0,322,0,0,322
Listas,2014EP,01-015-069,1021,307,0,307,0,0,307
Listas,2014EP,01-015-070,843,264,0,264,0,4,260
Listas,2014EP,01-015-071,916,230,0,230,0,1,229
Listas,2014EP,01-016-001,1070,431,0,431,0,3,428
Listas,2014EP,01-016-002,1014,442,0,442,0,0,442
Listas,2014EP,01-016-003,1029,450,0,450,0,0,450
Listas,2014EP,01-016-004,883,370,0,370,0,1,369
Listas,2014EP,01-016-005,920,402,0,402,0,0,402
Listas,2014EP,01-016-006,1031,406,0,406,0,1,405
Listas,2014EP,01-016-007,1084,398,0,398,0,1,397
Listas,2014EP,01-016-008,1039,426,0,426,0,0,426
Listas,2014EP,01-016-009,1012,393,0,393,0,2,391
Listas,2014EP,01-016-010,997,432,0,432,0,1,431
Listas,2014EP,01-016-011,990,387,0,386,-1,3,383
Listas,2014EP,01-016-012,1074,413,0,413,0,1,412
Listas,2014EP,01-016-013,870,338,0,338,0,1,337
Listas,2014EP,01-016-014,1000,450,0,450,0,0,450
Listas,2014EP,01-016-015,1090,460,0,460,0,0,460
Listas,2014EP,01-016-016,816,337,0,337,0,0,337
Listas,2014EP,01-016-017,1321,731,0,731,0,2,729
Listas,2014EP,01-016-018,926,409,1,408,-1,0,408
Listas,2014EP,01-016-019,768,321,0,321,0,2,319
Listas,2014EP,01-016-020,776,322,0,322,0,1,321
Listas,2014EP,01-016-021,741,325,0,325,0,1,324
Listas,2014EP,01-016-022,789,370,0,371,1,10,361
Listas,2014EP,01-016-023,914,338,0,338,0,0,338
Listas,2014EP,01-016-024,890,353,0,353,0,0,353
Listas,2014EP,01-016-025,877,383,0,383,0,5,378
Listas,2014EP,01-016-026,992,422,0,422,0,4,418
Listas,2014EP,01-016-027,1018,415,0,414,-1,0,414
Listas,2014EP,01-016-028,820,339,0,339,0,2,337
Listas,2014EP,01-016-029,875,311,0,311,0,0,311
Listas,2014EP,01-016-030,1053,429,0,429,0,0,429
Listas,2014EP,01-016-031,853,356,0,356,0,0,356
Listas,2014EP,01-016-032,1032,437,0,437,0,0,437
Listas,2014EP,01-016-033,1130,486,0,486,0,1,485
Listas,2014EP,01-016-034,968,392,0,392,0,4,388
Listas,2014EP,01-016-035,1062,414,0,413,-1,0,413
Listas,2014EP,01-016-036,852,388,0,388,0,1,387
Listas,2014EP,01-016-037,729,351,0,351,0,1,350
Listas,2014EP,01-016-038,936,453,0,453,0,2,451
Listas,2014EP,01-016-039,812,388,0,388,0,5,383
Listas,2014EP,01-016-040,973,465,0,465,0,0,465
Listas,2014EP,01-016-041,864,345,0,345,0,1,344
Listas,2014EP,01-016-042,934,383,0,383,0,1,382
Listas,2014EP,01-016-043,937,477,0,477,0,2,475
Listas,2014EP,01-016-044,1053,425,0,425,0,1,424
Listas,2014EP,01-016-045,977,415,0,415,0,1,414
Listas,2014EP,01-016-046,903,316,0,316,0,2,314
Listas,2014EP,01-016-047,647,267,0,267,0,2,265
Listas,2014EP,01-016-048,966,409,0,409,0,2,407
Listas,2014EP,01-016-049,1012,453,0,453,0,0,453
Listas,2014EP,01-016-050,838,340,0,340,0,1,339
Listas,2014EP,01-016-051,1098,410,0,410,0,0,410
Listas,2014EP,01-016-052,834,370,0,370,0,2,368
Listas,2014EP,01-016-053,781,351,0,351,0,0,351
Listas,2014EP,01-016-054,908,412,0,410,-2,0,410
Listas,2014EP,01-016-055,878,367,0,367,0,1,366
Listas,2014EP,01-016-056,1006,413,0,413,0,4,409
Listas,2014EP,01-016-057,1219,460,0,460,0,2,458
Listas,2014EP,01-016-058,792,344,0,344,0,1,343
Listas,2014EP,01-016-059,902,355,0,354,-1,1,353
Listas,2014EP,01-016-060,1069,424,0,424,0,0,424
Listas,2014EP,01-017-001,892,416,0,416,0,0,416
Listas,2014EP,01-017-002,870,435,0,435,0,0,435
Listas,2014EP,01-017-003,991,399,0,398,-1,2,396
Listas,2014EP,01-017-004,870,412,0,411,-1,0,411
Listas,2014EP,01-017-005,768,376,0,376,0,0,376
Listas,2014EP,01-017-006,908,424,0,424,0,0,424
Listas,2014EP,01-017-007,1039,337,0,337,0,0,337
Listas,2014EP,01-017-008,1032,258,0,258,0,0,258
Listas,2014EP,01-017-009,994,266,0,266,0,1,265
Listas,2014EP,01-017-010,1026,255,0,255,0,0,255
Listas,2014EP,01-017-011,1052,281,0,281,0,1,280
Listas,2014EP,01-017-012,950,303,0,303,0,0,303
Listas,2014EP,01-017-013,966,215,0,215,0,0,215
Listas,2014EP,01-017-014,1004,238,0,238,0,2,236
Listas,2014EP,01-017-015,918,307,0,307,0,1,306
Listas,2014EP,01-017-016,409,105,0,104,-1,1,103
Listas,2014EP,01-017-017,769,205,0,205,0,1,204
Listas,2014EP,01-017-018,934,270,0,270,0,1,269
Listas,2014EP,01-017-019,967,263,0,263,0,0,263
Listas,2014EP,01-017-020,927,220,0,220,0,0,220
Listas,2014EP,01-017-021,1473,505,0,505,0,3,502
Listas,2014EP,01-017-022,1022,290,0,288,-2,1,287
Listas,2014EP,01-017-023,1060,286,0,286,0,0,286
Listas,2014EP,01-017-024,818,230,0,230,0,1,229
Listas,2014EP,01-017-025,1037,350,0,350,0,0,350
Listas,2014EP,01-017-026,966,427,0,427,0,0,427
Listas,2014EP,01-017-027,783,310,0,310,0,0,310
Listas,2014EP,01-017-028,606,271,0,271,0,0,271
Listas,2014EP,01-017-029,923,336,0,336,0,0,336
Listas,2014EP,01-017-030,890,245,0,245,0,0,245
Listas,2014EP,01-017-031,880,412,0,412,0,1,411
Listas,2014EP,01-017-032,817,347,0,347,0,1,346
Listas,2014EP,01-017-033,900,352,0,352,0,0,352
Listas,2014EP,01-017-034,892,302,0,302,0,0,302
Listas,2014EP,01-017-035,1047,275,0,275,0,1,274
Listas,2014EP,01-017-036,982,304,0,303,-1,0,303
Listas,2014EP,01-017-037,1046,337,0,337,0,4,333
Listas,2014EP,01-017-038,1075,379,0,378,-1,0,378
Listas,2014EP,01-017-039,1001,390,0,390,0,1,389
Listas,2014EP,01-017-040,1059,399,0,397,-2,0,397
Listas,2014EP,01-017-041,1018,300,0,300,0,0,300
Listas,2014EP,01-017-042,1116,364,0,365,1,8,357
Listas,2014EP,01-017-043,1002,371,0,371,0,3,368
Listas,2014EP,01-017-044,737,263,0,263,0,1,262
Listas,2014EP,01-017-045,786,289,0,289,0,2,287
Listas,2014EP,01-017-046,985,388,0,388,0,0,388
Listas,2014EP,01-017-047,1068,435,0,435,0,1,434
Listas,2014EP,01-017-048,818,335,0,334,-1,2,332
Listas,2014EP,01-017-049,885,303,2,301,-2,0,301
Listas,2014EP,01-017-050,743,249,0,249,0,1,248
Listas,2014EP,01-017-051,1128,399,0,399,0,2,397
Listas,2014EP,01-017-052,1015,353,2,351,-2,0,351
Listas,2014EP,01-017-053,911,339,0,339,0,0,339
Listas,2014EP,01-017-054,801,305,0,305,0,0,305
Listas,2014EP,01-017-055,925,377,0,377,0,0,377
Listas,2014EP,01-017-056,1022,399,0,399,0,3,396
Listas,2014EP,01-017-057,815,299,0,298,-1,1,297
Listas,2014EP,01-017-058,950,340,0,340,0,0,340
Listas,2014EP,01-017-059,1087,394,0,394,0,0,394
Listas,2014EP,01-017-060,917,305,0,305,0,0,305
Listas,2014EP,01-017-061,1056,304,0,304,0,2,302
Listas,2014EP,01-017-062,756,266,0,266,0,0,266
Listas,2014EP,01-017-063,908,300,0,300,0,0,300
Listas,2014EP,01-017-064,1002,386,0,385,-1,1,384
Listas,2014EP,01-017-065,896,319,0,319,0,0,319
Listas,2014EP,01-017-066,937,382,0,382,0,0,382
Listas,2014EP,01-017-067,963,365,0,365,0,1,364
Listas,2014EP,01-017-068,980,401,0,401,0,1,400
Listas,2014EP,01-017-069,844,334,0,334,0,1,333
Listas,2014EP,01-017-070,883,339,0,339,0,0,339
Listas,2014EP,01-017-071,908,361,0,361,0,0,361
Listas,2014EP,01-017-072,1000,494,0,493,-1,0,493
Listas,2014EP,01-017-073,1000,462,0,462,0,0,462
Listas,2014EP,01-017-074,713,309,0,309,0,0,309
Listas,2014EP,01-017-075,996,460,0,460,0,0,460
Listas,2014EP,01-018-001,1117,436,0,436,0,0,436
Listas,2014EP,01-018-002,947,378,0,378,0,3,375
Listas,2014EP,01-018-003,1169,445,0,445,0,0,445
Listas,2014EP,01-018-004,1088,451,0,451,0,0,451
Listas,2014EP,01-018-005,1144,406,0,406,0,0,406
Listas,2014EP,01-018-006,1051,387,0,387,0,2,385
Listas,2014EP,01-018-007,1025,426,0,426,0,0,426
Listas,2014EP,01-018-008,989,415,0,415,0,0,415
Listas,2014EP,01-018-009,872,303,0,303,0,3,300
Listas,2014EP,01-018-010,987,431,0,430,-1,0,430
Listas,2014EP,01-018-011,1386,706,0,705,-1,2,703
Listas,2014EP,01-018-012,831,367,0,367,0,2,365
Listas,2014EP,01-018-013,1022,357,0,357,0,0,357
Listas,2014EP,01-018-014,918,371,0,371,0,0,371
Listas,2014EP,01-018-015,948,367,1,366,-1,1,365
Listas,2014EP,01-018-016,865,340,0,340,0,0,340
Listas,2014EP,01-018-017,869,337,0,337,0,2,335
Listas,2014EP,01-018-018,999,390,0,390,0,2,388
Listas,2014EP,01-018-019,1110,460,0,460,0,0,460
Listas,2014EP,01-018-020,852,348,0,348,0,0,348
Listas,2014EP,01-018-021,1015,449,0,449,0,3,446
Listas,2014EP,01-018-022,878,326,0,326,0,0,326
Listas,2014EP,01-018-023,956,382,0,382,0,0,382
Listas,2014EP,01-018-024,1131,342,0,342,0,1,341
Listas,2014EP,01-018-025,1088,460,0,459,-1,0,459
Listas,2014EP,01-018-026,1079,341,1,340,-1,0,340
Listas,2014EP,01-018-027,1230,466,0,466,0,0,466
Listas,2014EP,01-018-028,1128,460,0,460,0,1,459
Listas,2014EP,01-018-029,1295,312,0,312,0,2,310
Listas,2014EP,01-018-030,1122,328,0,328,0,2,326
Listas,2014EP,01-018-031,1324,328,0,328,0,0,328
Listas,2014EP,01-018-032,1154,234,0,234,0,0,234
Listas,2014EP,01-018-033,1146,292,0,292,0,10,282
Listas,2014EP,01-018-034,906,219,0,219,0,1,218
Listas,2014EP,01-018-035,1070,309,0,309,0,2,307
Listas,2014EP,01-018-036,1118,265,0,265,0,0,265
Listas,2014EP,01-018-037,996,254,0,254,0,0,254
Listas,2014EP,01-018-038,1101,238,0,238,0,0,238
Listas,2014EP,01-018-039,994,233,0,233,0,0,233
Listas,2014EP,01-018-040,1119,442,1,441,-1,0,441
Listas,2014EP,01-018-041,1203,542,0,541,-1,0,541
Listas,2014EP,01-018-042,1256,427,1,426,-1,1,425
Listas,2014EP,01-018-043,880,324,0,324,0,2,322
Listas,2014EP,01-018-044,1256,441,0,441,0,0,441
Listas,2014EP,01-018-045,719,294,0,294,0,0,294
Listas,2014EP,01-018-046,837,374,0,374,0,2,372
Listas,2014EP,01-018-047,1040,436,0,436,0,2,434
Listas,2014EP,01-018-048,800,299,0,299,0,0,299
Listas,2014EP,01-018-049,1093,399,0,399,0,2,397
Listas,2014EP,01-018-050,1093,478,0,478,0,1,477
Listas,2014EP,01-018-051,960,375,0,375,0,2,373
Listas,2014EP,01-018-052,1051,519,0,519,0,5,514
Listas,2014EP,01-018-053,1222,634,0,633,-1,1,632
Listas,2014EP,01-018-054,1105,504,0,504,0,0,504
Listas,2014EP,01-018-055,1153,416,0,416,0,2,414
Listas,2014EP,01-018-056,1152,412,0,412,0,2,410
Listas,2014EP,01-018-057,1134,517,0,517,0,2,515
Listas,2014EP,01-018-058,1022,377,0,377,0,0,377
Listas,2014EP,01-018-059,1199,435,0,435,0,0,435
Listas,2014EP,01-018-060,1237,347,0,347,0,0,347
Listas,2014EP,01-018-061,1290,424,0,424,0,0,424
Listas,2014EP,01-018-062,1191,365,0,364,-1,1,363
Listas,2014EP,01-018-063,1152,427,0,427,0,2,425
Listas,2014EP,01-018-064,919,305,0,305,0,0,305
Listas,2014EP,01-018-065,1111,351,0,351,0,0,351
Listas,2014EP,01-018-066,714,235,0,235,0,1,234
Listas,2014EP,01-018-067,1057,395,0,394,-1,2,392
Listas,2014EP,01-018-068,918,349,0,349,0,0,349
Listas,2014EP,01-018-069,1152,418,0,418,0,0,418
Listas,2014EP,01-018-070,1066,394,0,394,0,1,393
Listas,2014EP,01-018-071,831,283,0,283,0,0,283
Listas,2014EP,01-018-072,1156,366,0,366,0,2,364
Listas,2014EP,01-018-073,1084,405,0,405,0,1,404
Listas,2014EP,01-018-074,1182,406,0,406,0,1,405
Listas,2014EP,01-018-075,1209,415,0,415,0,1,414
Listas,2014EP,01-018-076,981,300,0,300,0,0,300
Listas,2014EP,01-019-001,747,193,0,193,0,1,192
Listas,2014EP,01-019-002,673,221,0,221,0,0,221
Listas,2014EP,01-019-003,643,180,0,180,0,1,179
Listas,2014EP,01-019-004,723,224,0,224,0,2,222
Listas,2014EP,01-019-005,936,350,0,347,-3,1,346
Listas,2014EP,01-019-006,896,346,0,346,0,1,345
Listas,2014EP,01-019-007,911,324,0,324,0,0,324
Listas,2014EP,01-019-008,962,279,0,279,0,0,279
Listas,2014EP,01-019-009,710,215,0,215,0,0,215
Listas,2014EP,01-019-010,669,245,0,244,-1,2,242
Listas,2014EP,01-019-011,1052,392,0,382,-10,0,382
Listas,2014EP,01-019-012,935,338,0,338,0,1,337
Listas,2014EP,01-019-013,766,260,0,260,0,0,260
Listas,2014EP,01-019-014,729,219,0,219,0,2,217
Listas,2014EP,01-019-015,905,323,0,323,0,0,323
Listas,2014EP,01-019-016,840,249,0,249,0,4,245
Listas,2014EP,01-019-017,864,339,0,339,0,2,337
Listas,2014EP,01-019-018,806,302,0,302,0,2,300
Listas,2014EP,01-019-019,939,290,0,290,0,1,289
Listas,2014EP,01-019-020,1079,392,0,392,0,0,392
Listas,2014EP,01-019-021,1540,631,0,631,0,1,630
Listas,2014EP,01-019-022,866,288,0,288,0,2,286
Listas,2014EP,01-019-023,992,362,0,362,0,0,362
Listas,2014EP,01-019-024,935,389,0,389,0,0,389
Listas,2014EP,01-019-025,832,227,0,227,0,0,227
Listas,2014EP,01-019-026,831,313,0,313,0,2,311
Listas,2014EP,01-019-027,903,301,0,301,0,2,299
Listas,2014EP,01-019-028,769,237,0,237,0,1,236
Listas,2014EP,01-019-029,915,310,0,310,0,0,310
Listas,2014EP,01-019-030,1010,273,0,273,0,0,273
Listas,2014EP,01-019-031,580,260,0,260,0,0,260
Listas,2014EP,01-019-032,630,249,0,249,0,1,248
Listas,2014EP,01-019-033,608,277,0,277,0,3,274
Listas,2014EP,01-019-034,956,430,0,429,-1,1,428
Listas,2014EP,01-019-035,657,296,0,296,0,0,296
Listas,2014EP,01-019-036,583,246,0,246,0,2,244
Listas,2014EP,01-019-037,621,282,0,282,0,0,282
Listas,2014EP,01-019-038,666,300,0,300,0,0,300
Listas,2014EP,01-019-039,1148,425,0,424,-1,0,424
Listas,2014EP,01-019-040,706,310,0,310,0,0,310
Listas,2014EP,01-019-041,878,398,0,397,-1,1,396
Listas,2014EP,01-019-042,643,247,0,247,0,3,244
Listas,2014EP,01-019-043,792,269,0,269,0,2,267
Listas,2014EP,01-019-044,1043,384,0,384,0,0,384
Listas,2014EP,01-019-045,674,284,0,283,-1,1,282
Listas,2014EP,01-019-046,673,234,0,234,0,1,233
Listas,2014EP,01-019-047,1111,427,0,427,0,1,426
Listas,2014EP,01-019-048,940,255,0,254,-1,0,254
Listas,2014EP,01-019-049,824,306,0,306,0,1,305
Listas,2014EP,01-019-050,716,298,0,298,0,1,297
Listas,2014EP,01-019-051,987,345,0,345,0,1,344
Listas,2014EP,01-019-052,669,251,0,251,0,0,251
Listas,2014EP,01-019-053,666,265,0,265,0,1,264
Listas,2014EP,01-019-054,912,337,0,337,0,0,337
Listas,2014EP,01-019-055,792,306,0,306,0,0,306
Listas,2014EP,01-019-056,868,407,0,407,0,2,405
Listas,2014EP,01-019-057,814,371,0,371,0,0,371
Listas,2014EP,01-019-058,838,384,0,384,0,2,382
Listas,2014EP,01-020-001,948,300,0,300,0,6,294
Listas,2014EP,01-020-002,1019,382,0,381,-1,2,379
Listas,2014EP,01-020-003,644,207,0,207,0,1,206
Listas,2014EP,01-020-004,740,192,0,192,0,0,192
Listas,2014EP,01-020-005,924,283,0,283,0,2,281
Listas,2014EP,01-020-006,1002,311,0,310,-1,1,309
Listas,2014EP,01-020-007,752,238,0,238,0,1,237
Listas,2014EP,01-020-008,1015,329,0,329,0,6,323
Listas,2014EP,01-020-009,941,231,0,231,0,1,230
Listas,2014EP,01-020-010,773,201,0,201,0,0,201
Listas,2014EP,01-020-011,1367,554,0,554,0,1,553
Listas,2014EP,01-020-012,857,202,0,202,0,0,202
Listas,2014EP,01-020-013,1049,324,0,324,0,2,322
Listas,2014EP,01-020-014,788,210,0,210,0,0,210
Listas,2014EP,01-020-015,806,212,0,212,0,2,210
Listas,2014EP,01-020-016,914,185,0,185,0,2,183
Listas,2014EP,01-020-017,949,242,0,242,0,2,240
Listas,2014EP,01-020-018,686,204,0,204,0,1,203
Listas,2014EP,01-020-019,1374,483,0,483,0,2,481
Listas,2014EP,01-020-020,1143,347,0,346,-1,1,345
Listas,2014EP,01-020-021,825,316,0,316,0,0,316
Listas,2014EP,01-020-022,878,271,0,271,0,1,270
Listas,2014EP,01-020-023,690,272,0,272,0,1,271
Listas,2014EP,01-020-024,645,220,0,220,0,1,219
Listas,2014EP,01-020-025,869,314,0,314,0,0,314
Listas,2014EP,01-020-026,840,304,0,304,0,3,301
Listas,2014EP,01-020-027,850,303,0,303,0,1,302
Listas,2014EP,01-020-028,796,265,0,265,0,2,263
Listas,2014EP,01-020-029,707,206,0,206,0,0,206
Listas,2014EP,01-020-030,821,281,0,281,0,1,280
Listas,2014EP,01-020-031,679,257,0,256,-1,0,256
Listas,2014EP,01-020-032,680,241,0,241,0,1,240
Listas,2014EP,01-020-033,631,249,0,248,-1,0,248
Listas,2014EP,01-020-034,805,289,0,289,0,0,289
Listas,2014EP,01-020-035,914,270,0,269,-1,4,265
Listas,2014EP,01-020-036,924,252,0,252,0,0,252
Listas,2014EP,01-020-037,878,241,0,241,0,0,241
Listas,2014EP,01-020-038,726,217,0,217,0,1,216
Listas,2014EP,01-020-039,962,300,0,299,-1,0,299
Listas,2014EP,01-020-040,982,309,0,309,0,0,309
Listas,2014EP,01-020-041,755,256,0,256,0,0,256
Listas,2014EP,01-020-042,990,300,0,300,0,0,300
Listas,2014EP,01-020-043,754,259,0,259,0,0,259
Listas,2014EP,01-020-044,799,255,0,255,0,2,253
Listas,2014EP,01-020-045,891,314,0,314,0,0,314
Listas,2014EP,01-020-046,605,237,0,237,0,1,236
Listas,2014EP,01-020-047,883,338,0,338,0,1,337
Listas,2014EP,01-020-048,699,231,0,231,0,2,229
Listas,2014EP,01-020-049,901,345,0,345,0,0,345
Listas,2014EP,01-020-050,1025,302,0,302,0,0,302
Listas,2014EP,01-020-051,754,283,0,283,0,1,282
Listas,2014EP,01-020-052,828,277,0,277,0,2,275
Listas,2014EP,01-020-053,685,214,0,214,0,0,214
Listas,2014EP,01-020-054,854,326,0,326,0,2,324
Listas,2014EP,01-020-055,787,244,0,244,0,0,244
Listas,2014EP,01-020-056,950,282,0,282,0,0,282
Listas,2014EP,01-020-057,819,273,0,273,0,1,272
Listas,2014EP,01-020-058,1039,317,0,317,0,1,316
Listas,2014EP,01-020-059,838,262,0,262,0,1,261
Listas,2014EP,01-020-060,940,302,0,302,0,1,301
Listas,2014EP,01-020-061,651,154,0,154,0,0,154
Listas,2014EP,01-021-001,870,346,1,345,-1,4,341
Listas,2014EP,01-021-002,852,326,0,325,-1,1,324
Listas,2014EP,01-021-003,797,295,0,295,0,1,294
Listas,2014EP,01-021-004,788,282,0,282,0,0,282
Listas,2014EP,01-021-005,907,335,0,335,0,1,334
Listas,2014EP,01-021-006,818,295,0,295,0,2,293
Listas,2014EP,01-021-007,748,244,0,244,0,0,244
Listas,2014EP,01-021-008,828,307,0,307,0,0,307
Listas,2014EP,01-021-009,765,261,0,261,0,2,259
Listas,2014EP,01-021-010,934,334,0,334,0,1,333
Listas,2014EP,01-021-011,803,317,0,317,0,1,316
Listas,2014EP,01-021-012,872,361,0,361,0,0,361
Listas,2014EP,01-021-013,858,312,0,312,0,0,312
Listas,2014EP,01-021-014,845,295,0,295,0,4,291
Listas,2014EP,01-021-015,966,334,0,334,0,1,333
Listas,2014EP,01-021-016,897,315,0,315,0,0,315
Listas,2014EP,01-021-017,1045,437,0,437,0,0,437
Listas,2014EP,01-021-018,914,377,0,377,0,4,373
Listas,2014EP,01-021-019,809,339,0,339,0,0,339
Listas,2014EP,01-021-020,782,359,0,359,0,2,357
Listas,2014EP,01-021-021,818,363,0,363,0,0,363
Listas,2014EP,01-021-022,751,288,0,288,0,1,287
Listas,2014EP,01-021-023,810,265,0,265,0,0,265
Listas,2014EP,01-021-024,836,243,0,243,0,2,241
Listas,2014EP,01-021-025,867,234,0,234,0,0,234
Listas,2014EP,01-021-026,832,296,0,296,0,0,296
Listas,2014EP,01-021-027,785,259,0,259,0,1,258
Listas,2014EP,01-021-028,851,251,0,251,0,0,251
Listas,2014EP,01-021-029,758,195,0,195,0,1,194
Listas,2014EP,01-021-030,786,205,0,205,0,2,203
Listas,2014EP,01-021-031,816,213,0,213,0,0,213
Listas,2014EP,01-021-032,982,342,0,342,0,1,341
Listas,2014EP,01-021-033,918,248,0,248,0,0,248
Listas,2014EP,01-021-034,791,174,0,174,0,1,173
Listas,2014EP,01-021-035,753,126,0,126,0,0,126
Listas,2014EP,01-021-036,785,227,0,227,0,0,227
Listas,2014EP,01-021-037,812,291,0,291,0,3,288
Listas,2014EP,01-021-038,1310,564,0,563,-1,0,563
Listas,2014EP,01-021-039,1034,347,0,347,0,3,344
Listas,2014EP,01-021-040,909,232,1,232,0,0,232
Listas,2014EP,01-021-041,1086,201,0,201,0,0,201
Listas,2014EP,01-021-042,940,249,0,249,0,0,249
Listas,2014EP,01-021-043,986,281,0,281,0,2,279
Listas,2014EP,01-021-044,797,250,0,250,0,1,249
Listas,2014EP,01-021-045,773,225,0,225,0,0,225
Listas,2014EP,01-021-046,849,190,0,190,0,0,190
Listas,2014EP,01-021-047,754,215,0,214,-1,0,214
Listas,2014EP,01-021-048,804,327,0,327,0,0,327
Listas,2014EP,01-021-049,926,374,0,374,0,1,373
Listas,2014EP,01-021-050,862,245,0,245,0,3,242
Listas,2014EP,01-021-051,931,305,0,305,0,0,305
Listas,2014EP,01-021-052,828,269,0,269,0,1,268
Listas,2014EP,01-021-053,911,258,0,258,0,1,257
Listas,2014EP,01-021-054,864,310,0,310,0,1,309
Listas,2014EP,01-021-055,1004,329,0,329,0,2,327
Listas,2014EP,01-021-056,842,175,0,175,0,2,173
Listas,2014EP,01-021-057,987,333,0,332,-1,0,332
Listas,2014EP,01-021-058,1025,339,0,339,0,1,338
Listas,2014EP,01-021-059,1026,375,0,375,0,0,375
Listas,2014EP,01-021-060,907,291,0,291,0,2,289
Listas,2014EP,01-021-061,802,295,0,295,0,0,295
Listas,2014EP,01-021-062,892,295,0,293,-2,1,292
Listas,2014EP,01-021-063,832,266,0,266,0,1,265
Listas,2014EP,01-021-064,909,263,0,262,-1,2,260
Listas,2014EP,01-021-065,965,232,0,232,0,3,229
Listas,2014EP,01-021-066,995,224,0,224,0,1,223
Listas,2014EP,01-021-067,895,186,0,185,-1,1,184
Listas,2014EP,01-021-068,1013,365,0,365,0,1,364
Listas,2014EP,01-021-069,825,273,0,273,0,0,273
Listas,2014EP,01-021-070,1107,203,0,203,0,2,201
Listas,2014EP,01-022-001,1069,601,0,599,-2,0,599
Listas,2014EP,01-022-002,975,480,0,480,0,1,479
Listas,2014EP,01-022-003,1176,557,0,557,0,5,552
Listas,2014EP,01-022-004,1144,525,0,523,-2,0,523
Listas,2014EP,01-022-005,1298,622,0,622,0,1,621
Listas,2014EP,01-022-006,1272,569,0,569,0,2,567
Listas,2014EP,01-022-007,1026,350,0,350,0,0,350
Listas,2014EP,01-022-008,930,285,0,285,0,0,285
Listas,2014EP,01-022-009,889,274,0,274,0,0,274
Listas,2014EP,01-022-010,1117,571,0,571,0,3,568
Listas,2014EP,01-022-011,1222,415,0,415,0,1,414
Listas,2014EP,01-022-012,1260,622,0,622,0,2,620
Listas,2014EP,01-022-013,1191,451,0,450,-1,0,450
Listas,2014EP,01-022-014,1167,521,0,521,0,1,520
Listas,2014EP,01-022-015,1049,431,0,431,0,2,429
Listas,2014EP,01-022-016,1222,458,0,458,0,1,457
Listas,2014EP,01-022-017,965,353,0,353,0,1,352
Listas,2014EP,01-022-018,1043,340,0,340,0,0,340
Listas,2014EP,01-022-019,1111,526,0,526,0,0,526
Listas,2014EP,01-022-020,1166,528,0,528,0,0,528
Listas,2014EP,01-022-021,1189,509,0,509,0,2,507
Listas,2014EP,01-022-022,1031,458,0,458,0,1,457
Listas,2014EP,01-022-023,1241,497,0,496,-1,1,495
Listas,2014EP,01-022-024,1200,512,0,512,0,1,511
Listas,2014EP,01-022-025,1035,455,0,455,0,2,453
Listas,2014EP,01-022-026,1121,391,0,391,0,1,390
Listas,2014EP,01-022-027,1226,554,0,554,0,3,551
Listas,2014EP,01-022-028,1218,486,0,486,0,0,486
Listas,2014EP,01-022-029,1300,454,0,453,-1,0,453
Listas,2014EP,01-022-030,1219,450,0,450,0,0,450
Listas,2014EP,01-022-031,1145,478,0,477,-1,0,477
Listas,2014EP,01-022-032,1188,466,0,466,0,2,464
Listas,2014EP,01-022-033,1226,430,0,430,0,0,430
Listas,2014EP,01-022-034,1132,387,0,387,0,0,387
Listas,2014EP,01-022-035,1222,367,0,367,0,1,366
Listas,2014EP,01-022-036,1371,394,1,393,-1,1,392
Listas,2014EP,01-022-037,1284,443,0,442,-1,1,441
Listas,2014EP,01-023-001,650,191,0,191,0,0,191
Listas,2014EP,01-023-002,710,228,0,228,0,0,228
Listas,2014EP,01-023-003,678,251,0,251,0,1,250
Listas,2014EP,01-023-004,812,326,0,326,0,0,326
Listas,2014EP,01-023-005,742,196,0,196,0,1,195
Listas,2014EP,01-023-006,680,233,0,233,0,1,232
Listas,2014EP,01-023-007,932,258,0,258,0,3,255
Listas,2014EP,01-023-008,623,218,0,218,0,0,218
Listas,2014EP,01-023-009,620,183,0,183,0,0,183
Listas,2014EP,01-023-010,641,238,0,238,0,0,238
Listas,2014EP,01-023-011,672,208,0,208,0,2,206
Listas,2014EP,01-023-012,825,304,0,304,0,2,302
Listas,2014EP,01-023-013,645,252,0,252,0,0,252
Listas,2014EP,01-023-014,788,228,0,228,0,0,228
Listas,2014EP,01-023-015,702,211,0,210,-1,0,210
Listas,2014EP,01-023-016,905,337,0,337,0,1,336
Listas,2014EP,01-023-017,692,247,0,247,0,8,239
Listas,2014EP,01-023-018,727,170,0,170,0,4,166
Listas,2014EP,01-023-019,797,284,0,284,0,1,283
Listas,2014EP,01-023-020,694,208,0,208,0,1,207
Listas,2014EP,01-023-021,747,221,0,221,0,1,220
Listas,2014EP,01-023-022,892,304,0,304,0,6,298
Listas,2014EP,01-023-023,720,221,0,221,0,0,221
Listas,2014EP,01-023-024,679,249,0,249,0,0,249
Listas,2014EP,02-001-001,556,136,0,136,0,0,136
Listas,2014EP,02-002-001,147,41,0,41,0,1,40
Listas,2014EP,02-003-001,342,120,0,120,0,0,120
Listas,2014EP,02-004-001,68,33,0,33,0,0,33
Listas,2014EP,02-005-001,285,64,0,64,0,0,64
Listas,2014EP,02-006-001,779,214,0,214,0,2,212
Listas,2014EP,02-007-001,110,34,0,34,0,0,34
Listas,2014EP,02-008-001,298,46,0,46,0,1,45
Listas,2014EP,02-009-001,142,27,0,27,0,0,27
Listas,2014EP,02-010-001,165,45,0,45,0,0,45
Listas,2014EP,02-011-001,607,144,0,144,0,0,144
Listas,2014EP,02-012-001,93,30,0,30,0,0,30
Listas,2014EP,02-013-001,292,77,0,77,0,2,75
Listas,2014EP,02-014-001,256,58,0,58,0,0,58
Listas,2014EP,02-015-001,651,104,0,104,0,0,104
Listas,2014EP,02-016-001,166,44,0,44,0,0,44
Listas,2014EP,02-017-001,363,58,0,58,0,2,56
Listas,2014EP,02-018-001,109,51,0,51,0,0,51
Listas,2014EP,02-019-001,163,43,0,43,0,0,43
Listas,2014EP,02-020-001,135,35,0,35,0,0,35
Listas,2014EP,02-021-001,463,120,0,120,0,0,120
Listas,2014EP,02-022-001,340,73,0,73,0,1,72
Listas,2014EP,02-023-001,723,130,0,130,0,0,130
Listas,2014EP,02-023-002,720,146,0,146,0,2,144
Listas,2014EP,02-023-003,701,94,0,94,0,0,94
Listas,2014EP,02-024-001,734,109,0,109,0,0,109
Listas,2014EP,02-025-001,94,23,0,23,0,0,23
Listas,2014EP,02-026-001,211,62,0,62,0,1,61
Listas,2014EP,02-027-001,840,188,0,188,0,0,188
Listas,2014EP,02-028-001,667,165,0,165,0,0,165
Listas,2014EP,02-029-001,426,106,0,106,0,0,106
Listas,2014EP,02-030-001,212,52,0,52,0,0,52
Listas,2014EP,02-031-001,358,73,0,73,0,0,73
Listas,2014EP,02-032-001,198,48,0,48,0,0,48
Listas,2014EP,02-033-001,841,199,0,199,0,1,198
Listas,2014EP,02-034-001,345,72,0,72,0,0,72
Listas,2014EP,02-035-001,242,47,0,47,0,0,47
Listas,2014EP,02-036-001,221,52,0,52,0,0,52
Listas,2014EP,02-036-002,36,17,0,17,0,0,17
Listas,2014EP,02-036-003,67,37,0,37,0,0,37
Listas,2014EP,02-037-001,345,92,0,92,0,3,89
Listas,2014EP,02-038-001,119,28,0,28,0,0,28
Listas,2014EP,02-039-001,272,52,0,52,0,0,52
Listas,2014EP,02-040-001,760,201,0,201,0,0,201
Listas,2014EP,02-040-002,696,192,0,192,0,0,192
Listas,2014EP,02-040-003,880,272,0,272,0,0,272
Listas,2014EP,02-040-004,685,185,0,185,0,0,185
Listas,2014EP,02-041-001,506,106,0,106,0,1,105
Listas,2014EP,02-041-002,425,43,0,43,0,0,43
Listas,2014EP,02-042-001,69,12,0,12,0,0,12
Listas,2014EP,02-043-001,136,31,0,31,0,0,31
Listas,2014EP,02-044-001,583,96,0,96,0,0,96
Listas,2014EP,02-045-001,72,20,0,20,0,0,20
Listas,2014EP,02-046-001,286,58,0,58,0,1,57
Listas,2014EP,02-047-001,489,144,0,144,0,0,144
Listas,2014EP,02-048-001,330,75,0,75,0,0,75
Listas,2014EP,02-049-001,137,44,0,44,0,0,44
Listas,2014EP,02-050-001,178,55,0,55,0,0,55
Listas,2014EP,02-051-001,486,49,0,49,0,1,48
Listas,2014EP,02-052-001,69,23,0,23,0,0,23
Listas,2014EP,02-053-001,566,139,0,139,0,0,139
Listas,2014EP,02-054-001,169,41,0,41,0,0,41
Listas,2014EP,02-055-001,188,39,0,39,0,0,39
Listas,2014EP,02-056-001,411,94,0,94,0,1,93
Listas,2014EP,02-057-001,140,40,0,40,0,0,40
Listas,2014EP,02-058-001,99,34,0,34,0,1,33
Listas,2014EP,02-059-001,212,48,0,48,0,1,47
Listas,2014EP,02-060-001,78,24,0,24,0,0,24
Listas,2014EP,02-061-001,562,116,0,116,0,0,116
Listas,2014EP,02-062-001,166,50,0,50,0,0,50
Listas,2014EP,02-063-001,365,77,0,77,0,1,76
Listas,2014EP,02-064-001,870,177,0,177,0,0,177
Listas,2014EP,02-064-002,787,206,0,206,0,0,206
Listas,2014EP,02-065-001,846,186,0,186,0,3,183
Listas,2014EP,02-066-001,252,47,0,47,0,1,46
Listas,2014EP,02-067-001,680,166,0,166,0,0,166
Listas,2014EP,02-068-001,193,57,0,57,0,2,55
Listas,2014EP,02-069-001,323,54,0,54,0,0,54
Listas,2014EP,02-070-001,64,27,0,27,0,0,27
Listas,2014EP,02-071-001,312,61,0,61,0,0,61
Listas,2014EP,02-072-001,245,52,0,52,0,0,52
Listas,2014EP,02-073-001,177,54,0,54,0,0,54
Listas,2014EP,02-074-001,178,73,0,73,0,0,73
Listas,2014EP,02-075-001,116,23,0,23,0,0,23
Listas,2014EP,02-076-001,826,176,0,176,0,1,175
Listas,2014EP,02-077-001,236,44,0,44,0,0,44
Listas,2014EP,02-078-001,420,81,0,81,0,2,79
Listas,2014EP,02-079-001,406,105,0,105,0,0,105
Listas,2014EP,02-079-002,253,61,0,61,0,0,61
Listas,2014EP,02-080-001,185,39,0,39,0,0,39
Listas,2014EP,02-081-001,255,41,0,41,0,0,41
Listas,2014EP,02-082-001,225,25,0,25,0,0,25
Listas,2014EP,02-083-001,540,87,0,87,0,0,87
Listas,2014EP,02-083-002,185,51,0,51,0,0,51
Listas,2014EP,02-084-001,652,160,0,160,0,0,160
Listas,2014EP,02-084-002,569,91,0,91,0,2,89
Listas,2014EP,02-084-003,155,17,0,17,0,0,17
Listas,2014EP,02-085-001,345,62,0,62,0,0,62
Listas,2014EP,02-086-001,549,129,0,129,0,0,129
Listas,2014EP,02-087-001,117,27,0,27,0,0,27
Listas,2014EP,02-088-001,231,46,0,46,0,0,46
Listas,2014EP,02-089-001,459,120,0,120,0,0,120
Listas,2014EP,02-089-002,870,280,0,280,0,1,279
Listas,2014EP,02-089-003,966,383,0,382,-1,0,382
Listas,2014EP,02-089-004,1138,296,0,296,0,4,292
Listas,2014EP,02-090-001,256,106,0,106,0,0,106
Listas,2014EP,02-091-001,134,49,0,49,0,0,49
Listas,2014EP,02-092-001,348,96,0,96,0,2,94
Listas,2014EP,02-093-001,285,53,0,53,0,0,53
Listas,2014EP,02-094-001,386,84,0,84,0,0,84
Listas,2014EP,02-095-001,877,189,0,189,0,0,189
Listas,2014EP,02-095-002,889,213,0,213,0,1,212
Listas,2014EP,02-096-001,392,116,0,116,0,0,116
Listas,2014EP,02-096-002,536,127,0,127,0,0,127
Listas,2014EP,02-097-001,169,21,0,21,0,0,21
Listas,2014EP,02-098-001,389,53,0,53,0,0,53
Listas,2014EP,02-098-002,410,87,0,87,0,0,87
Listas,2014EP,02-099-001,526,135,0,135,0,0,135
Listas,2014EP,02-100-001,57,34,0,34,0,0,34
Listas,2014EP,02-101-001,937,244,0,244,0,0,244
Listas,2014EP,02-101-002,831,224,0,224,0,0,224
Listas,2014EP,02-101-003,944,187,0,187,0,2,185
Listas,2014EP,02-102-001,47,22,0,22,0,0,22
Listas,2014EP,02-103-001,185,44,0,44,0,0,44
Listas,2014EP,02-104-001,201,34,0,34,0,0,34
Listas,2014EP,02-105-001,188,63,0,63,0,0,63
Listas,2014EP,02-106-001,111,44,0,44,0,0,44
Listas,2014EP,02-107-001,204,48,0,48,0,0,48
Listas,2014EP,02-108-001,218,47,0,47,0,0,47
Listas,2014EP,02-109-001,130,27,0,27,0,0,27
Listas,2014EP,02-110-001,177,42,0,42,0,0,42
Listas,2014EP,02-111-001,289,73,0,73,0,0,73
Listas,2014EP,02-112-001,288,77,0,77,0,0,77
Listas,2014EP,02-113-001,287,84,0,84,0,0,84
Listas,2014EP,02-114-001,51,24,0,24,0,0,24
Listas,2014EP,02-115-001,1005,316,0,316,0,2,314
Listas,2014EP,02-116-001,149,62,0,62,0,0,62
Listas,2014EP,02-117-001,392,113,0,113,0,0,113
Listas,2014EP,02-118-001,555,111,0,111,0,1,110
Listas,2014EP,02-119-001,795,130,0,130,0,2,128
Listas,2014EP,02-120-001,155,51,0,51,0,0,51
Listas,2014EP,02-121-001,68,17,0,17,0,0,17
Listas,2014EP,02-122-001,90,26,0,26,0,0,26
Listas,2014EP,02-123-001,107,38,0,38,0,1,37
Listas,2014EP,02-124-001,196,45,0,45,0,1,44
Listas,2014EP,02-125-001,161,29,0,29,0,1,28
Listas,2014EP,02-126-001,429,90,0,90,0,0,90
Listas,2014EP,02-127-001,187,48,0,48,0,0,48
Listas,2014EP,02-128-001,130,42,0,42,0,0,42
Listas,2014EP,02-129-001,208,47,0,47,0,0,47
Listas,2014EP,02-130-001,242,34,0,34,0,0,34
Listas,2014EP,02-131-001,166,53,0,53,0,0,53
Listas,2014EP,02-132-001,128,55,0,55,0,0,55
Listas,2014EP,02-132-002,64,18,0,18,0,0,18
Listas,2014EP,02-133-001,102,21,0,21,0,1,20
Listas,2014EP,02-134-001,179,40,0,40,0,0,40
Listas,2014EP,02-135-001,283,63,0,63,0,2,61
Listas,2014EP,02-136-001,247,33,0,33,0,0,33
Listas,2014EP,02-137-001,1026,192,0,192,0,2,190
Listas,2014EP,02-137-002,1091,263,0,263,0,1,262
Listas,2014EP,02-137-003,1021,314,0,314,0,0,314
Listas,2014EP,02-137-004,1114,271,0,271,0,2,269
Listas,2014EP,02-137-005,1074,264,0,264,0,17,247
Listas,2014EP,02-137-006,886,238,0,238,0,1,237
Listas,2014EP,02-137-007,1113,352,0,352,0,1,351
Listas,2014EP,02-137-008,1043,315,0,315,0,0,315
Listas,2014EP,02-137-009,866,183,0,183,0,0,183
Listas,2014EP,02-137-010,700,195,0,195,0,0,195
Listas,2014EP,02-137-011,890,273,0,273,0,0,273
Listas,2014EP,02-137-012,1052,186,0,186,0,3,183
Listas,2014EP,02-137-013,951,201,0,201,0,0,201
Listas,2014EP,02-137-014,1092,266,0,266,0,2,264
Listas,2014EP,02-137-015,850,221,0,221,0,0,221
Listas,2014EP,02-137-016,1191,217,0,217,0,1,216
Listas,2014EP,02-137-017,1100,209,0,209,0,1,208
Listas,2014EP,02-137-018,970,186,0,186,0,0,186
Listas,2014EP,02-137-019,1065,317,0,317,0,1,316
Listas,2014EP,02-137-020,1075,306,0,306,0,2,304
Listas,2014EP,02-137-021,352,124,0,124,0,2,122
Listas,2014EP,02-137-022,653,154,0,154,0,0,154
Listas,2014EP,02-137-023,176,68,0,68,0,0,68
Listas,2014EP,02-138-001,207,46,0,46,0,0,46
Listas,2014EP,02-139-001,58,26,0,26,0,0,26
Listas,2014EP,02-140-001,1004,215,0,215,0,0,215
Listas,2014EP,02-140-002,871,251,0,251,0,0,251
Listas,2014EP,02-140-003,937,255,0,255,0,0,255
Listas,2014EP,02-140-004,888,226,0,226,0,0,226
Listas,2014EP,02-140-005,968,199,0,199,0,1,198
Listas,2014EP,02-141-001,165,40,0,40,0,2,38
Listas,2014EP,02-142-001,202,32,0,32,0,0,32
Listas,2014EP,02-143-001,560,157,0,157,0,1,156
Listas,2014EP,02-144-001,831,134,0,134,0,0,134
Listas,2014EP,02-145-001,561,163,0,163,0,0,163
Listas,2014EP,02-145-002,495,73,0,73,0,0,73
Listas,2014EP,02-146-001,277,72,0,72,0,0,72
Listas,2014EP,02-147-001,160,60,0,60,0,0,60
Listas,2014EP,02-148-001,1094,265,0,265,0,2,263
Listas,2014EP,02-148-002,1007,200,0,200,0,1,199
Listas,2014EP,02-149-001,327,57,0,57,0,1,56
Listas,2014EP,02-150-001,436,93,0,93,0,1,92
Listas,2014EP,02-151-001,184,40,0,40,0,0,40
Listas,2014EP,02-152-001,216,59,0,59,0,0,59
Listas,2014EP,02-153-001,228,32,0,32,0,0,32
Listas,2014EP,02-154-001,179,34,0,34,0,0,34
Listas,2014EP,02-155-001,825,177,0,177,0,2,175
Listas,2014EP,02-156-001,652,158,0,158,0,0,158
Listas,2014EP,02-157-001,461,136,0,136,0,0,136
Listas,2014EP,02-157-002,106,44,0,44,0,0,44
Listas,2014EP,02-158-001,64,16,0,16,0,0,16
Listas,2014EP,02-159-001,255,35,0,35,0,0,35
Listas,2014EP,02-160-001,270,66,0,66,0,0,66
Listas,2014EP,02-161-001,899,259,0,259,0,0,259
Listas,2014EP,02-162-001,171,45,0,45,0,1,44
Listas,2014EP,02-163-001,805,157,0,157,0,0,157
Listas,2014EP,02-164-001,164,46,0,46,0,1,45
Listas,2014EP,02-165-001,51,17,0,17,0,0,17
Listas,2014EP,02-166-001,82,39,0,39,0,0,39
Listas,2014EP,02-167-001,187,68,0,68,0,1,67
Listas,2014EP,02-168-001,287,82,0,82,0,0,82
Listas,2014EP,02-169-001,1019,220,0,220,0,4,216
Listas,2014EP,02-169-002,987,220,0,219,-1,1,218
Listas,2014EP,02-170-001,708,151,0,151,0,1,150
Listas,2014EP,02-171-001,176,58,0,58,0,0,58
Listas,2014EP,02-172-001,424,88,0,88,0,0,88
Listas,2014EP,02-173-001,380,111,0,111,0,0,111
Listas,2014EP,02-174-001,767,187,0,187,0,0,187
Listas,2014EP,02-174-002,255,66,0,66,0,0,66
Listas,2014EP,02-175-001,698,185,0,185,0,1,184
Listas,2014EP,02-175-002,658,191,0,191,0,0,191
Listas,2014EP,02-176-001,358,98,0,98,0,0,98
Listas,2014EP,02-177-001,250,57,0,57,0,2,55
Listas,2014EP,02-178-001,229,51,0,51,0,0,51
Listas,2014EP,02-179-001,111,32,0,32,0,0,32
Listas,2014EP,02-180-001,292,69,0,69,0,0,69
Listas,2014EP,02-180-002,398,109,0,109,0,0,109
Listas,2014EP,02-181-001,861,293,0,293,0,0,293
Listas,2014EP,02-181-002,777,203,0,203,0,0,203
Listas,2014EP,02-181-003,608,182,0,182,0,2,180
Listas,2014EP,02-181-004,703,166,0,166,0,4,162
Listas,2014EP,02-181-005,765,200,0,200,0,0,200
Listas,2014EP,02-181-006,725,218,0,218,0,0,218
Listas,2014EP,02-181-007,966,223,0,223,0,0,223
Listas,2014EP,02-181-008,791,152,0,152,0,0,152
Listas,2014EP,02-181-009,767,162,0,162,0,0,162
Listas,2014EP,02-181-010,796,284,0,284,0,2,282
Listas,2014EP,02-181-011,937,264,0,264,0,2,262
Listas,2014EP,02-181-012,808,167,0,167,0,0,167
Listas,2014EP,02-181-013,790,254,0,254,0,1,253
Listas,2014EP,02-181-014,810,268,0,268,0,2,266
Listas,2014EP,02-181-015,769,155,0,155,0,0,155
Listas,2014EP,02-181-016,833,166,0,166,0,1,165
Listas,2014EP,02-181-017,1000,216,0,216,0,0,216
Listas,2014EP,02-181-018,726,184,0,184,0,0,184
Listas,2014EP,02-181-019,480,66,0,66,0,1,65
Listas,2014EP,02-181-020,103,15,0,15,0,0,15
Listas,2014EP,02-181-021,216,50,0,50,0,0,50
Listas,2014EP,02-181-022,75,13,0,13,0,0,13
Listas,2014EP,02-181-023,510,131,0,131,0,1,130
Listas,2014EP,02-182-001,164,38,0,38,0,0,38
Listas,2014EP,02-183-001,130,41,0,41,0,0,41
Listas,2014EP,02-184-001,459,86,0,86,0,0,86
Listas,2014EP,02-184-002,264,26,0,26,0,0,26
Listas,2014EP,02-185-001,161,44,0,44,0,1,43
Listas,2014EP,02-186-001,125,25,0,25,0,0,25
Listas,2014EP,02-187-001,516,75,0,75,0,0,75
Listas,2014EP,02-188-001,285,68,0,68,0,0,68
Listas,2014EP,02-189-001,616,107,0,107,0,1,106
Listas,2014EP,02-189-002,615,128,0,128,0,0,128
Listas,2014EP,02-190-001,753,190,0,190,0,0,190
Listas,2014EP,02-190-002,754,185,0,185,0,0,185
Listas,2014EP,02-191-001,596,264,0,264,0,0,264
Listas,2014EP,02-192-001,344,84,0,84,0,1,83
Listas,2014EP,02-193-001,550,99,0,99,0,0,99
Listas,2014EP,02-194-001,305,67,0,67,0,0,67
Listas,2014EP,02-195-001,292,62,0,62,0,0,62
Listas,2014EP,02-196-001,109,29,0,29,0,0,29
Listas,2014EP,02-196-002,103,25,0,25,0,0,25
Listas,2014EP,02-197-001,197,41,0,41,0,0,41
Listas,2014EP,02-198-001,141,23,0,23,0,0,23
Listas,2014EP,02-199-001,68,14,0,14,0,0,14
Listas,2014EP,02-200-001,502,134,0,134,0,0,134
Listas,2014EP,02-201-001,257,54,0,54,0,1,53
Listas,2014EP,02-202-001,860,275,0,275,0,0,275
Listas,2014EP,02-203-001,256,48,0,48,0,0,48
Listas,2014EP,02-204-001,133,49,0,49,0,0,49
Listas,2014EP,02-205-001,358,73,0,73,0,0,73
Listas,2014EP,02-206-001,283,86,0,86,0,0,86
Listas,2014EP,02-207-001,125,30,0,30,0,0,30
Listas,2014EP,02-208-001,84,27,0,27,0,0,27
Listas,2014EP,02-209-001,251,73,0,73,0,0,73
Listas,2014EP,02-210-001,366,131,0,131,0,0,131
Listas,2014EP,02-210-002,422,132,0,132,0,0,132
Listas,2014EP,02-211-001,295,42,0,42,0,2,40
Listas,2014EP,02-212-001,144,41,0,41,0,0,41
Listas,2014EP,02-213-001,923,195,0,195,0,0,195
Listas,2014EP,02-213-002,899,237,0,237,0,0,237
Listas,2014EP,02-214-001,134,48,0,48,0,0,48
Listas,2014EP,02-215-001,163,39,0,39,0,0,39
Listas,2014EP,02-216-001,102,28,0,28,0,1,27
Listas,2014EP,02-217-001,803,159,0,159,0,1,158
Listas,2014EP,02-217-002,617,144,0,144,0,0,144
Listas,2014EP,02-217-003,650,100,0,100,0,0,100
Listas,2014EP,02-217-004,623,129,0,129,0,0,129
Listas,2014EP,02-217-005,833,217,0,217,0,1,216
Listas,2014EP,02-217-006,906,184,0,184,0,1,183
Listas,2014EP,02-217-007,946,197,0,197,0,0,197
Listas,2014EP,02-217-008,896,128,0,128,0,0,128
Listas,2014EP,02-217-009,1071,239,0,239,0,0,239
Listas,2014EP,02-217-010,859,172,0,172,0,0,172
Listas,2014EP,02-217-011,707,228,0,228,0,0,228
Listas,2014EP,02-217-012,977,186,0,186,0,0,186
Listas,2014EP,02-217-013,769,226,0,226,0,3,223
Listas,2014EP,02-217-014,709,134,0,134,0,3,131
Listas,2014EP,02-217-015,634,121,0,121,0,0,121
Listas,2014EP,02-217-016,806,129,0,129,0,0,129
Listas,2014EP,02-217-017,630,160,0,160,0,0,160
Listas,2014EP,02-217-018,864,297,0,297,0,1,296
Listas,2014EP,02-217-019,876,252,0,252,0,0,252
Listas,2014EP,02-217-020,735,158,0,158,0,0,158
Listas,2014EP,02-217-021,970,285,0,285,0,0,285
Listas,2014EP,02-217-022,1157,269,0,267,-2,1,266
Listas,2014EP,02-217-023,983,293,0,293,0,2,291
Listas,2014EP,02-217-024,170,54,0,54,0,0,54
Listas,2014EP,02-217-025,768,180,0,180,0,0,180
Listas,2014EP,02-217-026,639,171,0,171,0,0,171
Listas,2014EP,02-217-027,1094,383,0,383,0,0,383
Listas,2014EP,02-217-028,901,298,0,298,0,1,297
Listas,2014EP,02-217-029,748,230,0,230,0,1,229
Listas,2014EP,02-217-030,712,243,0,243,0,0,243
Listas,2014EP,02-217-031,678,207,0,205,-2,1,204
Listas,2014EP,02-217-032,986,281,1,280,-1,1,279
Listas,2014EP,02-217-033,800,284,0,284,0,0,284
Listas,2014EP,02-217-034,751,296,0,296,0,0,296
Listas,2014EP,02-217-035,637,186,0,186,0,0,186
Listas,2014EP,02-217-036,674,228,0,228,0,0,228
Listas,2014EP,02-217-037,731,259,0,259,0,1,258
Listas,2014EP,02-217-038,961,272,0,272,0,0,272
Listas,2014EP,02-217-039,841,186,0,186,0,2,184
Listas,2014EP,02-217-040,696,146,0,146,0,0,146
Listas,2014EP,02-217-041,1089,363,0,363,0,1,362
Listas,2014EP,02-217-042,632,148,0,148,0,0,148
Listas,2014EP,02-217-043,594,189,0,189,0,0,189
Listas,2014EP,02-217-044,588,154,0,154,0,0,154
Listas,2014EP,02-217-045,601,228,0,228,0,0,228
Listas,2014EP,02-217-046,812,318,0,318,0,1,317
Listas,2014EP,02-217-047,2157,882,0,882,0,1,881
Listas,2014EP,02-217-048,620,255,0,255,0,0,255
Listas,2014EP,02-217-049,704,283,0,282,-1,0,282
Listas,2014EP,02-217-050,661,276,0,276,0,1,275
Listas,2014EP,02-217-051,724,290,0,290,0,3,287
Listas,2014EP,02-217-052,750,284,0,284,0,2,282
Listas,2014EP,02-217-053,805,296,0,296,0,0,296
Listas,2014EP,02-217-054,951,424,0,424,0,0,424
Listas,2014EP,02-217-055,649,294,0,294,0,1,293
Listas,2014EP,02-217-056,767,285,0,285,0,0,285
Listas,2014EP,02-217-057,618,251,0,251,0,0,251
Listas,2014EP,02-217-058,790,303,0,303,0,1,302
Listas,2014EP,02-217-059,780,253,0,253,0,0,253
Listas,2014EP,02-217-060,844,353,0,353,0,1,352
Listas,2014EP,02-217-061,797,270,0,270,0,0,270
Listas,2014EP,02-217-062,603,239,1,238,-1,0,238
Listas,2014EP,02-217-063,881,333,0,333,0,2,331
Listas,2014EP,02-217-064,602,256,2,254,-2,1,253
Listas,2014EP,02-217-065,638,256,0,256,0,0,256
Listas,2014EP,02-217-066,677,320,0,320,0,2,318
Listas,2014EP,02-217-067,737,302,0,302,0,0,302
Listas,2014EP,02-217-068,593,287,0,287,0,0,287
Listas,2014EP,02-217-069,788,348,0,348,0,1,347
Listas,2014EP,02-217-070,1000,463,0,463,0,2,461
Listas,2014EP,02-217-071,925,414,0,414,0,8,406
Listas,2014EP,02-217-072,638,288,0,288,0,1,287
Listas,2014EP,02-217-073,669,213,0,213,0,1,212
Listas,2014EP,02-217-074,811,261,0,261,0,3,258
Listas,2014EP,02-217-075,607,235,0,235,0,0,235
Listas,2014EP,02-217-076,939,365,0,365,0,0,365
Listas,2014EP,02-217-077,930,408,0,407,-1,0,407
Listas,2014EP,02-217-078,627,219,0,219,0,1,218
Listas,2014EP,02-217-079,689,228,0,227,-1,0,227
Listas,2014EP,02-217-080,612,167,0,167,0,0,167
Listas,2014EP,02-217-081,709,216,2,214,-2,3,211
Listas,2014EP,02-217-082,792,250,0,250,0,0,250
Listas,2014EP,02-217-083,821,272,0,272,0,1,271
Listas,2014EP,02-217-084,628,192,0,192,0,1,191
Listas,2014EP,02-217-085,648,189,0,189,0,2,187
Listas,2014EP,02-217-086,634,259,0,259,0,1,258
Listas,2014EP,02-217-087,809,281,0,281,0,1,280
Listas,2014EP,02-217-088,811,305,0,305,0,0,305
Listas,2014EP,02-217-089,662,234,0,234,0,1,233
Listas,2014EP,02-217-090,806,190,0,190,0,2,188
Listas,2014EP,02-217-091,693,236,0,236,0,2,234
Listas,2014EP,02-217-092,650,236,0,236,0,1,235
Listas,2014EP,02-217-093,1137,356,0,356,0,0,356
Listas,2014EP,02-217-094,929,262,0,262,0,0,262
Listas,2014EP,02-217-095,1039,315,0,315,0,1,314
Listas,2014EP,02-217-096,919,257,0,254,-3,2,252
Listas,2014EP,02-217-097,914,313,0,313,0,0,313
Listas,2014EP,02-217-098,1096,397,0,397,0,1,396
Listas,2014EP,02-217-099,1009,379,0,379,0,2,377
Listas,2014EP,02-217-100,1077,397,0,397,0,1,396
Listas,2014EP,02-217-101,1079,320,0,318,-2,0,318
Listas,2014EP,02-217-102,1121,329,0,329,0,0,329
Listas,2014EP,02-217-103,1041,361,0,361,0,0,361
Listas,2014EP,02-217-104,832,335,0,334,-1,1,333
Listas,2014EP,02-217-105,758,248,0,248,0,1,247
Listas,2014EP,02-217-106,650,229,0,229,0,0,229
Listas,2014EP,02-217-107,794,238,0,237,-1,0,237
Listas,2014EP,02-217-108,793,230,0,230,0,2,228
Listas,2014EP,02-217-109,711,196,0,196,0,3,193
Listas,2014EP,02-217-110,730,184,0,184,0,0,184
Listas,2014EP,02-217-111,870,254,0,254,0,1,253
Listas,2014EP,02-217-112,773,175,0,175,0,1,174
Listas,2014EP,02-217-113,747,212,0,212,0,0,212
Listas,2014EP,02-217-114,640,195,0,195,0,0,195
Listas,2014EP,02-217-115,792,194,0,194,0,0,194
Listas,2014EP,02-217-116,854,268,0,268,0,1,267
Listas,2014EP,02-217-117,713,195,0,195,0,1,194
Listas,2014EP,02-217-118,744,204,0,204,0,0,204
Listas,2014EP,02-217-119,847,182,0,182,0,2,180
Listas,2014EP,02-217-120,659,189,0,188,-1,1,187
Listas,2014EP,02-217-121,693,169,0,169,0,0,169
Listas,2014EP,02-217-122,668,167,0,167,0,0,167
Listas,2014EP,02-217-123,880,220,0,219,-1,0,219
Listas,2014EP,02-217-124,1179,344,0,344,0,1,343
Listas,2014EP,02-217-125,974,321,0,321,0,0,321
Listas,2014EP,02-217-126,696,189,0,189,0,0,189
Listas,2014EP,02-217-127,647,188,0,188,0,1,187
Listas,2014EP,02-217-128,870,224,0,224,0,0,224
Listas,2014EP,02-217-129,953,204,0,204,0,2,202
Listas,2014EP,02-217-130,949,215,0,215,0,1,214
Listas,2014EP,02-217-131,945,193,0,193,0,0,193
Listas,2014EP,02-217-132,641,164,0,164,0,1,163
Listas,2014EP,02-217-133,1027,293,0,293,0,1,292
Listas,2014EP,02-217-134,877,224,0,224,0,0,224
Listas,2014EP,02-217-135,715,179,0,179,0,2,177
Listas,2014EP,02-217-136,1064,250,0,250,0,1,249
Listas,2014EP,02-217-137,1022,232,0,232,0,0,232
Listas,2014EP,02-217-138,1275,335,0,335,0,1,334
Listas,2014EP,02-217-139,987,231,0,231,0,0,231
Listas,2014EP,02-217-140,1137,238,0,238,0,0,238
Listas,2014EP,02-217-141,814,178,0,178,0,0,178
Listas,2014EP,02-217-142,1029,266,0,266,0,1,265
Listas,2014EP,02-217-143,1099,268,0,268,0,0,268
Listas,2014EP,02-217-144,930,260,0,260,0,0,260
Listas,2014EP,02-217-145,1012,235,0,235,0,0,235
Listas,2014EP,02-217-146,1074,284,0,284,0,1,283
Listas,2014EP,02-217-147,881,191,0,191,0,0,191
Listas,2014EP,02-217-148,852,221,0,221,0,1,220
Listas,2014EP,02-217-149,706,156,0,156,0,0,156
Listas,2014EP,02-218-001,89,24,0,24,0,0,24
Listas,2014EP,02-219-001,89,32,0,32,0,1,31
Listas,2014EP,02-220-001,646,211,0,211,0,0,211
Listas,2014EP,02-221-001,1154,379,0,379,0,0,379
Listas,2014EP,02-221-002,1148,347,0,347,0,0,347
Listas,2014EP,02-221-003,1015,221,0,221,0,1,220
Listas,2014EP,02-222-001,176,87,0,88,1,2,86
Listas,2014EP,02-223-001,1010,263,0,263,0,1,262
Listas,2014EP,02-224-001,150,51,0,51,0,0,51
Listas,2014EP,02-225-001,174,45,0,45,0,2,43
Listas,2014EP,02-226-001,156,37,0,37,0,0,37
Listas,2014EP,02-227-001,396,88,0,88,0,0,88
Listas,2014EP,02-228-001,310,39,0,39,0,0,39
Listas,2014EP,02-229-001,172,56,0,56,0,1,55
Listas,2014EP,02-230-001,103,30,0,30,0,2,28
Listas,2014EP,02-231-001,680,129,0,129,0,1,128
Listas,2014EP,02-231-002,609,136,0,136,0,1,135
Listas,2014EP,02-231-003,825,189,0,189,0,0,189
Listas,2014EP,02-231-004,588,142,0,142,0,0,142
Listas,2014EP,02-232-001,540,141,0,141,0,1,140
Listas,2014EP,02-233-001,846,156,0,156,0,1,155
Listas,2014EP,02-233-002,809,150,0,150,0,0,150
Listas,2014EP,02-233-003,717,166,0,166,0,0,166
Listas,2014EP,02-234-001,651,153,0,153,0,1,152
Listas,2014EP,02-234-002,584,122,0,122,0,2,120
Listas,2014EP,02-234-003,911,198,0,198,0,1,197
Listas,2014EP,02-234-004,973,275,0,275,0,1,274
Listas,2014EP,02-234-005,1035,255,0,255,0,0,255
Listas,2014EP,02-234-006,1024,268,0,268,0,3,265
Listas,2014EP,02-234-007,1035,213,0,213,0,0,213
Listas,2014EP,02-234-008,893,218,0,218,0,0,218
Listas,2014EP,02-234-009,1101,262,0,262,0,3,259
Listas,2014EP,02-235-001,104,25,0,25,0,0,25
Listas,2014EP,02-236-001,314,41,0,41,0,0,41
Listas,2014EP,02-237-001,689,194,0,194,0,2,192
Listas,2014EP,02-237-002,620,153,0,153,0,0,153
Listas,2014EP,02-238-001,384,90,0,90,0,2,88
Listas,2014EP,02-239-001,262,50,0,50,0,0,50
Listas,2014EP,02-240-001,212,43,0,43,0,1,42
Listas,2014EP,02-240-002,137,29,0,29,0,0,29
Listas,2014EP,02-241-001,193,39,0,39,0,0,39
Listas,2014EP,02-242-001,151,50,0,50,0,0,50
Listas,2014EP,02-243-001,305,36,0,36,0,0,36
Listas,2014EP,02-243-002,75,24,0,24,0,0,24
Listas,2014EP,02-244-001,663,150,0,150,0,0,150
Listas,2014EP,02-245-001,669,227,0,227,0,0,227
Listas,2014EP,02-246-001,293,83,0,83,0,0,83
Listas,2014EP,02-247-001,803,176,0,176,0,3,173
Listas,2014EP,02-247-002,170,35,0,35,0,0,35
Listas,2014EP,02-248-001,187,69,0,69,0,0,69
Listas,2014EP,02-249-001,272,58,0,58,0,0,58
Listas,2014EP,02-250-001,130,69,0,69,0,0,69
Listas,2014EP,02-251-001,37,15,0,15,0,0,15
Listas,2014EP,02-252-001,1052,217,0,217,0,0,217
Listas,2014EP,02-252-002,1023,197,0,197,0,0,197
Listas,2014EP,02-253-001,318,121,0,121,0,3,118
Listas,2014EP,02-254-001,766,177,0,177,0,1,176
Listas,2014EP,02-254-002,761,126,0,126,0,0,126
Listas,2014EP,02-255-001,119,44,0,44,0,0,44
Listas,2014EP,02-256-001,386,101,0,101,0,0,101
Listas,2014EP,02-257-001,249,37,0,37,0,0,37
Listas,2014EP,02-258-001,325,63,0,63,0,0,63
Listas,2014EP,02-259-001,78,33,0,33,0,0,33
Listas,2014EP,02-260-001,417,75,0,75,0,2,73
Listas,2014EP,02-260-002,253,55,0,55,0,0,55
Listas,2014EP,02-261-001,962,211,0,211,0,2,209
Listas,2014EP,02-261-002,643,115,0,115,0,0,115
Listas,2014EP,02-261-003,669,165,0,165,0,0,165
Listas,2014EP,02-261-004,741,194,0,194,0,1,193
Listas,2014EP,02-261-005,840,140,0,140,0,1,139
Listas,2014EP,02-261-006,801,153,0,153,0,1,152
Listas,2014EP,02-261-007,724,191,0,191,0,0,191
Listas,2014EP,02-261-008,181,31,0,31,0,0,31
Listas,2014EP,02-262-001,523,153,0,153,0,0,153
Listas,2014EP,02-263-001,1079,266,0,266,0,1,265
Listas,2014EP,02-263-002,1097,319,0,319,0,0,319
Listas,2014EP,02-263-003,1082,233,0,233,0,0,233
Listas,2014EP,02-263-004,672,184,0,184,0,3,181
Listas,2014EP,02-263-005,599,143,0,143,0,0,143
Listas,2014EP,02-263-006,1114,227,0,227,0,3,224
Listas,2014EP,02-263-007,1116,303,0,303,0,1,302
Listas,2014EP,02-263-008,721,196,0,196,0,0,196
Listas,2014EP,02-263-009,630,137,0,137,0,0,137
Listas,2014EP,02-263-010,248,49,0,49,0,1,48
Listas,2014EP,02-263-011,503,106,0,106,0,0,106
Listas,2014EP,02-264-001,233,60,0,60,0,0,60
Listas,2014EP,02-265-001,135,41,0,41,0,0,41
Listas,2014EP,02-266-001,53,17,0,17,0,0,17
Listas,2014EP,02-267-001,107,25,0,25,0,0,25
Listas,2014EP,02-268-001,319,70,0,70,0,0,70
Listas,2014EP,02-269-001,200,43,0,43,0,0,43
Listas,2014EP,02-270-001,246,77,0,77,0,0,77
Listas,2014EP,02-271-001,93,36,0,36,0,0,36
Listas,2014EP,02-272-001,276,44,0,44,0,1,43
Listas,2014EP,02-273-001,53,20,0,20,0,0,20
Listas,2014EP,02-274-001,203,26,0,26,0,0,26
Listas,2014EP,02-275-001,157,37,0,37,0,0,37
Listas,2014EP,02-276-001,233,43,0,43,0,0,43
Listas,2014EP,02-277-001,251,65,0,65,0,1,64
Listas,2014EP,02-278-001,107,41,0,41,0,0,41
Listas,2014EP,02-279-001,142,38,0,38,0,0,38
Listas,2014EP,02-280-001,460,76,0,76,0,0,76
Listas,2014EP,02-281-001,241,88,0,88,0,2,86
Listas,2014EP,02-282-001,135,65,0,65,0,0,65
Listas,2014EP,02-283-001,848,158,0,158,0,0,158
Listas,2014EP,02-284-001,754,187,0,187,0,0,187
Listas,2014EP,02-284-002,786,148,0,148,0,0,148
Listas,2014EP,02-285-001,72,31,0,31,0,0,31
Listas,2014EP,02-286-001,100,22,0,22,0,0,22
Listas,2014EP,02-287-001,147,22,0,22,0,0,22
Listas,2014EP,02-288-001,943,138,0,138,0,1,137
Listas,2014EP,02-289-001,114,18,0,18,0,0,18
Listas,2014EP,02-290-001,141,40,0,40,0,0,40
Listas,2014EP,02-291-001,118,23,0,23,0,0,23
Listas,2014EP,02-292-001,669,76,0,76,0,1,75
Listas,2014EP,02-293-001,121,43,0,43,0,1,42
Listas,2014EP,02-294-001,656,192,0,192,0,0,192
Listas,2014EP,02-294-002,531,145,0,145,0,0,145
Listas,2014EP,02-295-001,996,272,0,272,0,1,271
Listas,2014EP,02-295-002,911,304,0,304,0,0,304
Listas,2014EP,02-295-003,180,53,0,53,0,0,53
Listas,2014EP,02-296-001,244,76,0,76,0,0,76
Listas,2014EP,02-297-001,703,158,0,158,0,0,158
Listas,2014EP,02-298-001,213,78,0,78,0,0,78
Listas,2014EP,02-299-001,270,59,0,59,0,0,59
Listas,2014EP,02-300-001,362,102,0,101,-1,0,101
Listas,2014EP,02-301-001,251,64,0,64,0,0,64
Listas,2014EP,03-001-001,1410,330,0,330,0,0,330
Listas,2014EP,03-001-002,1381,295,0,294,-1,2,292
Listas,2014EP,03-002-001,840,201,0,201,0,0,201
Listas,2014EP,03-002-002,832,185,0,185,0,0,185
Listas,2014EP,03-003-001,789,178,0,178,0,0,178
Listas,2014EP,03-003-002,778,157,0,157,0,4,153
Listas,2014EP,03-004-001,1078,263,0,263,0,0,263
Listas,2014EP,03-004-002,1118,289,0,289,0,1,288
Listas,2014EP,03-004-003,901,299,0,299,0,1,298
Listas,2014EP,03-004-004,1055,298,0,298,0,5,293
Listas,2014EP,03-004-005,1074,333,0,333,0,2,331
Listas,2014EP,03-004-006,1100,334,1,334,0,1,333
Listas,2014EP,03-004-007,958,348,0,348,0,3,345
Listas,2014EP,03-004-008,798,270,0,270,0,0,270
Listas,2014EP,03-004-009,958,345,0,345,0,1,344
Listas,2014EP,03-004-010,1093,359,0,359,0,4,355
Listas,2014EP,03-004-011,1077,397,0,397,0,0,397
Listas,2014EP,03-004-012,966,359,0,359,0,2,357
Listas,2014EP,03-004-013,913,276,0,276,0,0,276
Listas,2014EP,03-004-014,1102,293,0,293,0,5,288
Listas,2014EP,03-004-015,1146,272,0,272,0,1,271
Listas,2014EP,03-004-016,1171,294,0,294,0,0,294
Listas,2014EP,03-004-017,1011,313,0,313,0,0,313
Listas,2014EP,03-004-018,985,269,0,269,0,2,267
Listas,2014EP,03-004-019,702,218,0,218,0,1,217
Listas,2014EP,03-004-020,1020,236,0,236,0,2,234
Listas,2014EP,03-004-021,1087,300,0,300,0,0,300
Listas,2014EP,03-004-022,1163,294,0,294,0,0,294
Listas,2014EP,03-004-023,1060,289,0,289,0,2,287
Listas,2014EP,03-004-024,1104,292,0,292,0,2,290
Listas,2014EP,03-004-025,982,218,0,218,0,1,217
Listas,2014EP,03-004-026,930,241,0,241,0,0,241
Listas,2014EP,03-004-027,1019,290,0,290,0,2,288
Listas,2014EP,03-004-028,918,232,0,232,0,1,231
Listas,2014EP,03-004-029,943,199,0,199,0,1,198
Listas,2014EP,03-004-030,313,39,0,39,0,0,39
Listas,2014EP,03-004-031,362,67,0,67,0,0,67
Listas,2014EP,03-004-032,481,99,0,99,0,1,98
Listas,2014EP,03-005-001,787,264,0,264,0,0,264
Listas,2014EP,03-005-002,902,157,0,157,0,1,156
Listas,2014EP,03-005-003,986,246,0,246,0,3,243
Listas,2014EP,03-006-001,1094,199,0,199,0,0,199
Listas,2014EP,03-006-002,159,32,0,32,0,0,32
Listas,2014EP,03-007-001,977,176,0,176,0,2,174
Listas,2014EP,03-007-002,976,155,0,155,0,0,155
Listas,2014EP,03-007-003,886,208,0,208,0,0,208
Listas,2014EP,03-007-004,995,176,0,176,0,1,175
Listas,2014EP,03-007-005,965,201,0,201,0,1,200
Listas,2014EP,03-007-006,948,251,0,251,0,1,250
Listas,2014EP,03-008-001,774,183,0,183,0,2,181
Listas,2014EP,03-008-002,738,156,0,156,0,1,155
Listas,2014EP,03-008-003,849,109,0,109,0,0,109
Listas,2014EP,03-009-001,1003,192,0,192,0,0,192
Listas,2014EP,03-010-001,151,53,0,53,0,0,53
Listas,2014EP,03-011-001,305,74,0,74,0,1,73
Listas,2014EP,03-012-001,675,152,0,152,0,0,152
Listas,2014EP,03-012-002,674,166,0,166,0,1,165
Listas,2014EP,03-013-001,880,243,0,243,0,4,239
Listas,2014EP,03-013-002,889,250,0,250,0,3,247
Listas,2014EP,03-014-001,1129,248,0,248,0,4,244
Listas,2014EP,03-015-001,770,159,0,159,0,2,157
Listas,2014EP,03-015-002,712,148,0,148,0,0,148
Listas,2014EP,03-016-001,1000,203,0,203,0,0,203
Listas,2014EP,03-016-002,941,185,0,185,0,0,185
Listas,2014EP,03-016-003,98,14,0,14,0,0,14
Listas,2014EP,03-016-004,260,69,0,69,0,1,68
Listas,2014EP,03-017-001,241,47,0,47,0,0,47
Listas,2014EP,03-018-001,685,167,0,167,0,0,167
Listas,2014EP,03-018-002,676,166,0,166,0,0,166
Listas,2014EP,03-018-003,694,201,0,201,0,0,201
Listas,2014EP,03-019-001,642,170,0,170,0,0,170
Listas,2014EP,03-019-002,653,143,0,143,0,3,140
Listas,2014EP,03-020-001,700,158,0,158,0,0,158
Listas,2014EP,03-020-002,895,149,0,149,0,0,149
Listas,2014EP,03-021-001,839,213,0,213,0,1,212
Listas,2014EP,03-021-002,914,202,0,202,0,0,202
Listas,2014EP,03-022-001,706,139,0,139,0,0,139
Listas,2014EP,03-023-001,700,121,0,121,0,1,120
Listas,2014EP,03-023-002,641,111,0,111,0,0,111
Listas,2014EP,03-024-001,783,158,0,158,0,0,158
Listas,2014EP,03-024-002,786,175,0,175,0,1,174
Listas,2014EP,03-024-003,175,37,0,37,0,0,37
Listas,2014EP,03-025-001,299,103,0,103,0,0,103
Listas,2014EP,03-026-001,616,112,0,112,0,0,112
Listas,2014EP,03-026-002,607,83,0,83,0,0,83
Listas,2014EP,03-027-001,791,173,0,173,0,0,173
Listas,2014EP,03-028-001,940,260,0,260,0,0,260
Listas,2014EP,03-028-002,889,231,0,231,0,0,231
Listas,2014EP,03-028-003,968,180,0,179,-1,0,179
Listas,2014EP,03-029-001,731,166,0,166,0,0,166
Listas,2014EP,03-030-001,493,68,0,68,0,0,68
Listas,2014EP,03-031-001,769,210,0,210,0,0,210
Listas,2014EP,03-031-002,816,193,0,193,0,0,193
Listas,2014EP,03-031-003,820,184,0,184,0,0,184
Listas,2014EP,03-031-004,788,126,0,126,0,0,126
Listas,2014EP,03-032-001,808,238,0,238,0,1,237
Listas,2014EP,03-032-002,886,241,0,241,0,3,238
Listas,2014EP,03-032-003,865,231,0,231,0,0,231
Listas,2014EP,03-033-001,1093,242,0,242,0,1,241
Listas,2014EP,03-033-002,1192,235,0,235,0,3,232
Listas,2014EP,03-034-001,522,126,0,126,0,3,123
Listas,2014EP,03-035-001,809,185,0,185,0,0,185
Listas,2014EP,03-035-002,626,177,0,177,0,2,175
Listas,2014EP,03-036-001,748,181,0,181,0,1,180
Listas,2014EP,03-037-001,959,205,0,205,0,0,205
Listas,2014EP,03-037-002,606,140,0,140,0,0,140
Listas,2014EP,03-038-001,716,176,0,176,0,1,175
Listas,2014EP,03-038-002,636,156,0,156,0,1,155
Listas,2014EP,03-039-001,734,197,0,197,0,1,196
Listas,2014EP,03-040-001,902,260,0,260,0,0,260
Listas,2014EP,03-041-001,962,172,0,172,0,1,171
Listas,2014EP,03-041-002,908,182,0,182,0,3,179
Listas,2014EP,03-042-001,775,158,0,158,0,1,157
Listas,2014EP,03-042-002,961,171,0,171,0,0,171
Listas,2014EP,03-043-001,818,222,0,222,0,2,220
Listas,2014EP,03-044-001,844,212,0,212,0,0,212
Listas,2014EP,03-045-001,940,216,0,216,0,1,215
Listas,2014EP,03-045-002,922,182,0,182,0,0,182
Listas,2014EP,03-045-003,801,171,0,171,0,0,171
Listas,2014EP,03-046-001,730,195,0,195,0,2,193
Listas,2014EP,03-047-001,922,329,0,329,0,0,329
Listas,2014EP,03-047-002,990,263,0,263,0,2,261
Listas,2014EP,03-047-003,969,271,1,270,-1,0,270
Listas,2014EP,03-047-004,64,39,0,39,0,0,39
Listas,2014EP,03-047-005,100,16,0,16,0,0,16
Listas,2014EP,03-048-001,1266,219,0,219,0,0,219
Listas,2014EP,03-048-002,1181,269,0,269,0,1,268
Listas,2014EP,03-048-003,1095,144,0,144,0,0,144
Listas,2014EP,03-049-001,894,175,0,175,0,2,173
Listas,2014EP,03-049-002,842,127,0,127,0,1,126
Listas,2014EP,03-050-001,703,195,0,195,0,0,195
Listas,2014EP,03-050-002,207,51,0,51,0,1,50
Listas,2014EP,03-050-003,144,30,0,30,0,0,30
Listas,2014EP,03-050-004,144,44,0,44,0,0,44
Listas,2014EP,03-051-001,571,118,0,118,0,2,116
Listas,2014EP,03-052-001,839,255,0,255,0,1,254
Listas,2014EP,03-052-002,1044,255,0,255,0,0,255
Listas,2014EP,03-052-003,821,208,0,208,0,1,207
Listas,2014EP,03-052-004,838,163,0,163,0,1,162
Listas,2014EP,03-052-005,1004,267,0,267,0,3,264
Listas,2014EP,03-052-006,273,54,0,54,0,0,54
Listas,2014EP,03-053-001,1137,298,0,298,0,6,292
Listas,2014EP,03-053-002,1026,212,0,212,0,0,212
Listas,2014EP,03-054-001,917,174,0,174,0,1,173
Listas,2014EP,03-054-002,958,283,0,283,0,4,279
Listas,2014EP,03-054-003,906,255,0,255,0,1,254
Listas,2014EP,03-054-004,920,197,0,197,0,5,192
Listas,2014EP,03-054-005,895,213,0,213,0,0,213
Listas,2014EP,03-054-006,841,244,1,243,-1,2,241
Listas,2014EP,03-054-007,883,212,0,212,0,0,212
Listas,2014EP,03-054-008,1007,222,0,222,0,0,222
Listas,2014EP,03-055-001,1099,282,0,282,0,1,281
Listas,2014EP,03-055-002,1002,272,0,272,0,0,272
Listas,2014EP,03-056-001,946,297,1,296,-1,1,295
Listas,2014EP,03-056-002,876,275,0,273,-2,2,271
Listas,2014EP,03-056-003,938,297,0,297,0,0,297
Listas,2014EP,03-056-004,842,217,0,217,0,0,217
Listas,2014EP,03-056-005,821,201,0,200,-1,0,200
Listas,2014EP,03-056-006,1112,303,0,303,0,0,303
Listas,2014EP,03-056-007,904,269,0,269,0,1,268
Listas,2014EP,03-056-008,888,203,0,203,0,0,203
Listas,2014EP,03-056-009,158,49,0,49,0,0,49
Listas,2014EP,03-056-010,817,120,0,120,0,0,120
Listas,2014EP,03-056-011,828,181,0,181,0,0,181
Listas,2014EP,03-056-012,658,180,0,180,0,0,180
Listas,2014EP,03-056-013,997,293,0,293,0,0,293
Listas,2014EP,03-056-014,737,248,0,248,0,0,248
Listas,2014EP,03-056-015,819,295,0,295,0,2,293
Listas,2014EP,03-056-016,907,258,0,258,0,0,258
Listas,2014EP,03-056-017,838,193,0,193,0,0,193
Listas,2014EP,03-057-001,834,187,0,187,0,0,187
Listas,2014EP,03-058-001,814,179,0,177,-2,1,176
Listas,2014EP,03-058-002,803,167,0,167,0,1,166
Listas,2014EP,03-059-001,1011,181,0,181,0,1,180
Listas,2014EP,03-059-002,1015,198,0,198,0,0,198
Listas,2014EP,03-059-003,870,279,0,279,0,3,276
Listas,2014EP,03-059-004,768,247,0,247,0,0,247
Listas,2014EP,03-059-005,974,227,0,227,0,1,226
Listas,2014EP,03-059-006,1004,228,0,228,0,0,228
Listas,2014EP,03-059-007,594,81,0,81,0,1,80
Listas,2014EP,03-059-008,811,168,0,168,0,0,168
Listas,2014EP,03-060-001,876,309,0,309,0,0,309
Listas,2014EP,03-060-002,1077,396,0,396,0,1,395
Listas,2014EP,03-060-003,845,277,0,277,0,0,277
Listas,2014EP,03-060-004,945,383,0,383,0,1,382
Listas,2014EP,03-060-005,636,236,0,236,0,0,236
Listas,2014EP,03-060-006,922,195,0,195,0,1,194
Listas,2014EP,03-060-007,1054,240,0,240,0,2,238
Listas,2014EP,03-060-008,1180,248,0,248,0,0,248
Listas,2014EP,03-060-009,965,295,0,295,0,0,295
Listas,2014EP,03-060-010,852,243,0,243,0,2,241
Listas,2014EP,03-060-011,1083,322,0,322,0,0,322
Listas,2014EP,03-060-012,860,244,0,244,0,2,242
Listas,2014EP,03-060-013,830,284,0,284,0,4,280
Listas,2014EP,03-060-014,923,320,0,320,0,0,320
Listas,2014EP,03-060-015,950,371,0,371,0,0,371
Listas,2014EP,03-060-016,838,399,0,399,0,1,398
Listas,2014EP,03-060-017,855,334,0,334,0,3,331
Listas,2014EP,03-060-018,847,239,0,239,0,2,237
Listas,2014EP,03-060-019,1030,283,0,283,0,0,283
Listas,2014EP,03-060-020,915,282,0,282,0,1,281
Listas,2014EP,03-060-021,910,253,0,253,0,1,252
Listas,2014EP,03-060-022,1048,243,0,243,0,0,243
Listas,2014EP,03-060-023,1014,267,0,267,0,0,267
Listas,2014EP,03-060-024,1135,229,0,229,0,0,229
Listas,2014EP,03-060-025,642,142,0,142,0,0,142
Listas,2014EP,03-060-026,1106,254,0,254,0,0,254
Listas,2014EP,03-060-027,872,390,0,390,0,4,386
Listas,2014EP,03-060-028,1163,268,0,268,0,2,266
Listas,2014EP,03-060-029,1178,293,0,293,0,0,293
Listas,2014EP,03-060-030,852,229,0,229,0,0,229
Listas,2014EP,03-060-031,774,257,0,257,0,0,257
Listas,2014EP,03-060-032,854,203,0,203,0,0,203
Listas,2014EP,03-060-033,583,143,0,143,0,1,142
Listas,2014EP,03-060-034,1202,319,0,319,0,2,317
Listas,2014EP,03-060-035,916,229,0,229,0,1,228
Listas,2014EP,03-060-036,1050,293,0,293,0,0,293
Listas,2014EP,03-060-037,1169,268,0,268,0,4,264
Listas,2014EP,03-060-038,832,171,0,171,0,0,171
Listas,2014EP,03-060-039,648,271,0,271,0,1,270
Listas,2014EP,03-060-040,1012,420,0,420,0,0,420
Listas,2014EP,03-060-041,1036,345,0,345,0,0,345
Listas,2014EP,03-060-042,848,323,0,322,-1,1,321
Listas,2014EP,03-060-043,1074,289,0,289,0,0,289
Listas,2014EP,03-060-044,991,254,0,254,0,0,254
Listas,2014EP,03-060-045,691,303,0,303,0,0,303
Listas,2014EP,03-060-046,1086,359,0,359,0,0,359
Listas,2014EP,03-060-047,1289,624,0,624,0,3,621
Listas,2014EP,03-060-048,1155,453,0,453,0,1,452
Listas,2014EP,03-060-049,860,276,2,274,-2,1,273
Listas,2014EP,03-060-050,561,231,0,231,0,1,230
Listas,2014EP,03-060-051,802,254,0,254,0,0,254
Listas,2014EP,03-060-052,1112,348,0,348,0,2,346
Listas,2014EP,03-060-053,1157,383,0,382,-1,0,382
Listas,2014EP,03-060-054,997,331,0,330,-1,2,328
Listas,2014EP,03-060-055,763,71,0,70,-1,0,70
Listas,2014EP,03-060-056,733,80,0,80,0,0,80
Listas,2014EP,03-060-057,938,296,0,296,0,1,295
Listas,2014EP,03-060-058,1170,438,0,438,0,0,438
Listas,2014EP,03-060-059,1107,360,0,360,0,0,360
Listas,2014EP,03-060-060,632,228,0,228,0,0,228
Listas,2014EP,03-060-061,633,210,0,210,0,0,210
Listas,2014EP,03-060-062,874,318,0,318,0,0,318
Listas,2014EP,03-060-063,829,247,0,247,0,1,246
Listas,2014EP,03-060-064,1056,362,0,362,0,0,362
Listas,2014EP,03-060-065,946,254,0,254,0,2,252
Listas,2014EP,03-060-066,951,260,0,260,0,0,260
Listas,2014EP,03-060-067,1027,334,0,334,0,0,334
Listas,2014EP,03-060-068,644,145,0,145,0,0,145
Listas,2014EP,03-060-069,1049,310,0,310,0,0,310
Listas,2014EP,03-060-070,1072,275,0,276,1,8,268
Listas,2014EP,03-060-071,736,108,0,108,0,1,107
Listas,2014EP,03-060-072,787,121,0,121,0,2,119
Listas,2014EP,03-060-073,1148,237,0,237,0,1,236
Listas,2014EP,03-060-074,1102,404,0,404,0,1,403
Listas,2014EP,03-060-075,1104,312,0,311,-1,1,310
Listas,2014EP,03-060-076,821,139,0,139,0,0,139
Listas,2014EP,03-060-077,591,99,0,99,0,0,99
Listas,2014EP,03-060-078,629,118,0,118,0,2,116
Listas,2014EP,03-060-079,1026,305,0,305,0,1,304
Listas,2014EP,03-060-080,801,246,0,246,0,0,246
Listas,2014EP,03-060-081,974,329,0,328,-1,3,325
Listas,2014EP,03-060-082,1176,374,0,374,0,1,373
Listas,2014EP,03-060-083,840,213,0,213,0,1,212
Listas,2014EP,03-060-084,614,229,1,229,0,1,228
Listas,2014EP,03-060-085,1100,162,1,161,-1,0,161
Listas,2014EP,03-060-086,1267,229,0,229,0,0,229
Listas,2014EP,03-060-087,980,240,0,240,0,0,240
Listas,2014EP,03-060-088,1207,316,0,316,0,0,316
Listas,2014EP,03-060-089,1135,163,0,163,0,0,163
Listas,2014EP,03-060-090,958,188,0,188,0,0,188
Listas,2014EP,03-060-091,571,65,0,65,0,1,64
Listas,2014EP,03-060-092,941,309,0,309,0,1,308
Listas,2014EP,03-060-093,739,184,0,184,0,1,183
Listas,2014EP,03-060-094,886,221,1,220,-1,0,220
Listas,2014EP,03-060-095,688,88,0,88,0,1,87
Listas,2014EP,03-060-096,660,140,0,140,0,1,139
Listas,2014EP,03-061-001,628,107,0,107,0,0,107
Listas,2014EP,03-061-002,710,115,0,115,0,0,115
Listas,2014EP,03-061-003,737,120,0,120,0,1,119
Listas,2014EP,03-061-004,102,21,0,21,0,0,21
Listas,2014EP,03-062-001,964,222,0,222,0,1,221
Listas,2014EP,03-062-002,978,256,0,256,0,1,255
Listas,2014EP,03-062-003,1001,227,0,227,0,1,226
Listas,2014EP,03-062-004,952,253,0,253,0,1,252
Listas,2014EP,03-062-005,1056,220,0,220,0,0,220
Listas,2014EP,03-063-001,363,81,0,81,0,0,81
Listas,2014EP,03-064-001,821,252,0,252,0,0,252
Listas,2014EP,03-064-002,720,214,0,214,0,0,214
Listas,2014EP,03-064-003,733,201,0,201,0,0,201
Listas,2014EP,03-064-004,753,177,0,177,0,0,177
Listas,2014EP,03-064-005,707,225,2,222,-3,0,222
Listas,2014EP,03-064-006,731,237,0,237,0,0,237
Listas,2014EP,03-064-007,732,236,0,236,0,1,235
Listas,2014EP,03-064-008,807,167,0,167,0,1,166
Listas,2014EP,03-064-009,751,216,0,216,0,1,215
Listas,2014EP,03-064-010,753,243,0,243,0,0,243
Listas,2014EP,03-064-011,780,233,0,233,0,1,232
Listas,2014EP,03-064-012,705,156,0,156,0,0,156
Listas,2014EP,03-064-013,690,157,0,157,0,0,157
Listas,2014EP,03-064-014,731,212,0,212,0,1,211
Listas,2014EP,03-064-015,687,222,0,222,0,1,221
Listas,2014EP,03-064-016,794,250,0,250,0,0,250
Listas,2014EP,03-065-001,877,229,0,229,0,0,229
Listas,2014EP,03-065-002,896,320,0,319,-1,1,318
Listas,2014EP,03-065-003,750,189,0,189,0,0,189
Listas,2014EP,03-065-004,759,189,0,189,0,0,189
Listas,2014EP,03-065-005,813,245,0,245,0,1,244
Listas,2014EP,03-065-006,874,257,0,257,0,0,257
Listas,2014EP,03-065-007,795,255,0,255,0,2,253
Listas,2014EP,03-065-008,707,210,0,210,0,1,209
Listas,2014EP,03-065-009,753,253,0,253,0,1,252
Listas,2014EP,03-065-010,836,250,0,250,0,0,250
Listas,2014EP,03-065-011,957,321,0,321,0,2,319
Listas,2014EP,03-065-012,857,257,0,257,0,2,255
Listas,2014EP,03-065-013,691,188,0,188,0,1,187
Listas,2014EP,03-065-014,952,259,0,259,0,2,257
Listas,2014EP,03-065-015,879,213,0,213,0,0,213
Listas,2014EP,03-065-016,1074,221,0,221,0,3,218
Listas,2014EP,03-065-017,963,183,0,183,0,0,183
Listas,2014EP,03-065-018,201,29,0,29,0,0,29
Listas,2014EP,03-065-019,317,69,0,68,-1,0,68
Listas,2014EP,03-065-020,978,174,0,174,0,1,173
Listas,2014EP,03-065-021,1145,220,0,220,0,1,219
Listas,2014EP,03-065-022,414,106,0,106,0,0,106
Listas,2014EP,03-065-023,704,131,0,131,0,0,131
Listas,2014EP,03-065-024,789,152,0,152,0,0,152
Listas,2014EP,03-065-025,921,225,0,225,0,1,224
Listas,2014EP,03-065-026,869,254,0,254,0,0,254
Listas,2014EP,03-065-027,705,208,0,208,0,1,207
Listas,2014EP,03-065-028,868,267,0,267,0,0,267
Listas,2014EP,03-065-029,578,77,0,77,0,0,77
Listas,2014EP,03-065-030,977,152,0,152,0,0,152
Listas,2014EP,03-065-031,1091,202,0,202,0,1,201
Listas,2014EP,03-066-001,740,258,0,258,0,0,258
Listas,2014EP,03-066-002,672,194,0,194,0,0,194
Listas,2014EP,03-066-003,858,158,0,158,0,0,158
Listas,2014EP,03-066-004,1046,99,0,99,0,0,99
Listas,2014EP,03-066-005,844,265,0,265,0,0,265
Listas,2014EP,03-066-006,769,223,0,223,0,2,221
Listas,2014EP,03-066-007,696,188,0,188,0,0,188
Listas,2014EP,03-066-008,763,199,0,199,0,0,199
Listas,2014EP,03-066-009,881,274,0,274,0,0,274
Listas,2014EP,03-066-010,1188,137,0,137,0,0,137
Listas,2014EP,03-066-011,826,178,0,178,0,0,178
Listas,2014EP,03-066-012,753,176,0,176,0,0,176
Listas,2014EP,03-066-013,836,205,0,205,0,1,204
Listas,2014EP,03-066-014,711,96,0,96,0,0,96
Listas,2014EP,03-066-015,755,220,0,220,0,0,220
Listas,2014EP,03-066-016,682,223,0,223,0,1,222
Listas,2014EP,03-066-017,704,188,0,188,0,0,188
Listas,2014EP,03-066-018,931,246,0,246,0,0,246
Listas,2014EP,03-066-019,710,195,0,195,0,0,195
Listas,2014EP,03-066-020,782,190,0,190,0,0,190
Listas,2014EP,03-066-021,775,177,0,177,0,0,177
Listas,2014EP,03-066-022,734,273,0,273,0,1,272
Listas,2014EP,03-066-023,662,177,0,177,0,0,177
Listas,2014EP,03-066-024,702,125,0,125,0,0,125
Listas,2014EP,03-066-025,726,209,0,209,0,1,208
Listas,2014EP,03-066-026,646,167,0,167,0,1,166
Listas,2014EP,03-066-027,740,155,0,155,0,0,155
Listas,2014EP,03-066-028,641,127,0,127,0,0,127
Listas,2014EP,03-066-029,877,198,0,198,0,0,198
Listas,2014EP,03-066-030,784,136,0,136,0,0,136
Listas,2014EP,03-067-001,923,184,0,184,0,1,183
Listas,2014EP,03-067-002,1210,335,0,335,0,3,332
Listas,2014EP,03-067-003,1110,295,0,293,-2,1,292
Listas,2014EP,03-067-004,1085,286,0,286,0,2,284
Listas,2014EP,03-067-005,1151,244,0,244,0,0,244
Listas,2014EP,03-067-006,1198,226,0,226,0,2,224
Listas,2014EP,03-067-007,1179,185,0,185,0,1,184
Listas,2014EP,03-067-008,1170,158,0,158,0,0,158
Listas,2014EP,03-067-009,253,42,0,42,0,1,41
Listas,2014EP,03-068-001,249,25,0,25,0,0,25
Listas,2014EP,03-068-002,936,209,0,209,0,1,208
Listas,2014EP,03-068-003,926,168,0,168,0,1,167
Listas,2014EP,03-069-001,576,132,0,132,0,0,132
Listas,2014EP,03-070-001,1308,219,0,218,-1,1,217
Listas,2014EP,03-071-001,631,121,0,121,0,0,121
Listas,2014EP,03-071-002,720,144,0,144,0,0,144
Listas,2014EP,03-072-001,523,126,0,126,0,2,124
Listas,2014EP,03-073-001,917,229,0,229,0,0,229
Listas,2014EP,03-073-002,770,185,0,185,0,1,184
Listas,2014EP,03-073-003,129,28,0,28,0,0,28
Listas,2014EP,03-074-001,583,132,0,132,0,1,131
Listas,2014EP,03-075-001,1373,315,0,315,0,0,315
Listas,2014EP,03-076-001,842,231,0,231,0,3,228
Listas,2014EP,03-076-002,948,213,0,213,0,1,212
Listas,2014EP,03-076-003,774,135,0,135,0,1,134
Listas,2014EP,03-076-004,852,225,0,225,0,0,225
Listas,2014EP,03-076-005,883,274,0,274,0,2,272
Listas,2014EP,03-076-006,1071,263,0,263,0,0,263
Listas,2014EP,03-076-007,1109,253,0,253,0,1,252
Listas,2014EP,03-076-008,296,46,0,46,0,1,45
Listas,2014EP,03-077-001,1371,262,0,262,0,16,246
Listas,2014EP,03-078-001,1130,365,0,365,0,2,363
Listas,2014EP,03-078-002,1133,379,0,379,0,0,379
Listas,2014EP,03-078-003,1116,243,0,243,0,0,243
Listas,2014EP,03-078-004,1137,186,0,186,0,0,186
Listas,2014EP,03-078-005,1151,129,0,129,0,2,127
Listas,2014EP,03-078-006,1100,288,0,288,0,0,288
Listas,2014EP,03-078-007,1189,186,0,186,0,1,185
Listas,2014EP,03-078-008,548,82,0,82,0,1,81
Listas,2014EP,03-078-009,594,125,0,125,0,0,125
Listas,2014EP,03-079-001,829,212,0,212,0,2,210
Listas,2014EP,03-079-002,650,166,0,166,0,0,166
Listas,2014EP,03-079-003,743,193,0,193,0,0,193
Listas,2014EP,03-079-004,1112,227,0,227,0,0,227
Listas,2014EP,03-079-005,359,58,0,58,0,1,57
Listas,2014EP,03-080-001,807,170,0,170,0,3,167
Listas,2014EP,03-080-002,823,170,0,170,0,0,170
Listas,2014EP,03-080-003,799,109,0,109,0,1,108
Listas,2014EP,03-081-001,428,91,0,91,0,4,87
Listas,2014EP,03-082-001,814,230,0,230,0,0,230
Listas,2014EP,03-082-002,858,213,0,213,0,0,213
Listas,2014EP,03-082-003,832,192,0,192,0,1,191
Listas,2014EP,03-082-004,859,160,0,160,0,0,160
Listas,2014EP,03-082-005,866,148,0,148,0,0,148
Listas,2014EP,03-082-006,108,24,0,24,0,0,24
Listas,2014EP,03-083-001,714,161,0,161,0,1,160
Listas,2014EP,03-083-002,716,219,0,219,0,1,218
Listas,2014EP,03-084-001,399,118,0,118,0,0,118
Listas,2014EP,03-085-001,1004,198,0,198,0,0,198
Listas,2014EP,03-085-002,954,192,0,192,0,1,191
Listas,2014EP,03-086-001,897,112,0,112,0,1,111
Listas,2014EP,03-086-002,670,151,0,151,0,0,151
Listas,2014EP,03-087-001,972,257,0,257,0,1,256
Listas,2014EP,03-087-002,902,205,0,205,0,3,202
Listas,2014EP,03-088-001,392,93,0,93,0,1,92
Listas,2014EP,03-089-001,930,176,0,176,0,0,176
Listas,2014EP,03-089-002,881,172,0,172,0,0,172
Listas,2014EP,03-089-003,829,170,0,170,0,0,170
Listas,2014EP,03-090-001,686,145,0,145,0,2,143
Listas,2014EP,03-091-001,986,238,0,238,0,2,236
Listas,2014EP,03-092-001,763,163,0,163,0,1,162
Listas,2014EP,03-092-002,724,135,0,135,0,0,135
Listas,2014EP,03-093-001,644,180,0,180,0,0,180
Listas,2014EP,03-093-002,606,99,0,99,0,0,99
Listas,2014EP,03-094-001,820,176,0,176,0,4,172
Listas,2014EP,03-095-001,1035,176,0,176,0,0,176
Listas,2014EP,03-096-001,783,222,0,222,0,1,221
Listas,2014EP,03-096-002,1013,192,0,192,0,4,188
Listas,2014EP,03-096-003,715,199,0,199,0,0,199
Listas,2014EP,03-096-004,897,207,0,207,0,2,205
Listas,2014EP,03-096-005,978,200,0,200,0,0,200
Listas,2014EP,03-096-006,1042,220,0,220,0,2,218
Listas,2014EP,03-097-001,1071,267,0,267,0,3,264
Listas,2014EP,03-098-001,1194,352,0,352,0,0,352
Listas,2014EP,03-098-002,1198,274,0,274,0,0,274
Listas,2014EP,03-098-003,964,287,0,286,-1,2,284
Listas,2014EP,03-098-004,945,156,0,156,0,0,156
Listas,2014EP,03-098-005,874,196,0,196,0,0,196
Listas,2014EP,03-098-006,853,238,0,238,0,1,237
Listas,2014EP,03-099-001,1044,207,0,207,0,0,207
Listas,2014EP,03-099-002,1010,219,0,219,0,1,218
Listas,2014EP,03-099-003,1070,222,0,222,0,0,222
Listas,2014EP,03-100-001,661,109,0,109,0,0,109
Listas,2014EP,03-100-002,715,151,0,151,0,0,151
Listas,2014EP,03-100-003,718,185,0,185,0,4,181
Listas,2014EP,03-100-004,683,132,0,132,0,0,132
Listas,2014EP,03-100-005,659,109,0,109,0,0,109
Listas,2014EP,03-100-006,678,149,0,148,-1,0,148
Listas,2014EP,03-100-007,738,141,0,141,0,1,140
Listas,2014EP,03-100-008,316,58,0,58,0,0,58
Listas,2014EP,03-101-001,1014,252,0,252,0,8,244
Listas,2014EP,03-102-001,793,166,0,166,0,0,166
Listas,2014EP,03-102-002,842,196,0,196,0,2,194
Listas,2014EP,03-102-003,710,155,0,155,0,0,155
Listas,2014EP,03-103-001,1050,288,0,288,0,1,287
Listas,2014EP,03-103-002,943,310,0,310,0,0,310
Listas,2014EP,03-104-001,650,124,0,124,0,0,124
Listas,2014EP,03-104-002,901,308,0,308,0,2,306
Listas,2014EP,03-105-001,629,150,0,150,0,0,150
Listas,2014EP,03-105-002,622,160,0,160,0,1,159
Listas,2014EP,03-106-001,929,205,0,205,0,1,204
Listas,2014EP,03-107-001,1128,298,0,298,0,2,296
Listas,2014EP,03-107-002,1218,203,0,203,0,1,202
Listas,2014EP,03-108-002,1069,243,1,242,-1,3,239
Listas,2014EP,03-109-001,723,190,0,190,0,1,189
Listas,2014EP,03-109-002,683,135,0,135,0,0,135
Listas,2014EP,03-110-001,758,164,0,164,0,1,163
Listas,2014EP,03-110-002,705,147,0,147,0,0,147
Listas,2014EP,03-110-003,671,129,0,129,0,0,129
Listas,2014EP,03-110-004,676,75,0,75,0,0,75
Listas,2014EP,03-110-005,647,137,0,137,0,0,137
Listas,2014EP,03-110-006,657,113,0,113,0,1,112
Listas,2014EP,03-111-001,1213,311,0,311,0,0,311
Listas,2014EP,03-111-002,1318,467,0,467,0,0,467
Listas,2014EP,03-111-003,1302,393,0,393,0,0,393
Listas,2014EP,03-111-004,1252,315,0,315,0,0,315
Listas,2014EP,03-111-005,1173,309,0,309,0,1,308
Listas,2014EP,03-111-006,1155,237,0,237,0,2,235
Listas,2014EP,03-111-007,683,101,0,101,0,1,100
Listas,2014EP,03-111-008,427,82,0,82,0,0,82
Listas,2014EP,03-111-009,413,98,0,98,0,0,98
Listas,2014EP,03-111-010,366,59,0,59,0,3,56
Listas,2014EP,03-112-001,665,147,0,147,0,1,146
Listas,2014EP,03-113-001,601,88,0,88,0,3,85
Listas,2014EP,03-113-002,833,146,0,146,0,1,145
Listas,2014EP,03-113-003,800,146,0,146,0,2,144
Listas,2014EP,03-113-004,841,124,0,124,0,1,123
Listas,2014EP,03-113-005,733,102,0,102,0,1,101
Listas,2014EP,03-114-001,857,182,0,182,0,2,180
Listas,2014EP,03-115-001,190,96,0,96,0,0,96
Listas,2014EP,03-116-001,347,107,0,107,0,1,106
Listas,2014EP,03-117-001,976,230,0,230,0,1,229
Listas,2014EP,03-117-002,1017,246,0,246,0,0,246
Listas,2014EP,03-117-003,908,224,0,224,0,0,224
Listas,2014EP,03-118-001,999,234,0,234,0,2,232
Listas,2014EP,03-118-002,827,163,0,163,0,1,162
Listas,2014EP,03-119-001,659,153,0,153,0,2,151
Listas,2014EP,04-001-001,768,171,0,171,0,2,169
Listas,2014EP,04-002-001,672,131,0,131,0,1,130
Listas,2014EP,04-002-002,745,150,0,150,0,0,150
Listas,2014EP,04-002-003,586,106,0,106,0,0,106
Listas,2014EP,04-002-004,870,131,0,131,0,1,130
Listas,2014EP,04-002-005,980,173,0,172,-1,1,171
Listas,2014EP,04-002-006,848,99,0,99,0,0,99
Listas,2014EP,04-003-001,1159,236,0,236,0,0,236
Listas,2014EP,04-003-002,1105,229,0,229,0,3,226
Listas,2014EP,04-003-003,1132,332,0,332,0,1,331
Listas,2014EP,04-003-004,1141,351,0,351,0,0,351
Listas,2014EP,04-003-005,1142,371,0,371,0,2,369
Listas,2014EP,04-003-006,1156,334,0,334,0,7,327
Listas,2014EP,04-003-007,986,302,0,301,-1,2,299
Listas,2014EP,04-003-008,978,232,1,231,-1,0,231
Listas,2014EP,04-003-009,993,257,0,257,0,0,257
Listas,2014EP,04-003-010,1007,198,0,198,0,0,198
Listas,2014EP,04-003-011,929,204,0,204,0,0,204
Listas,2014EP,04-003-012,977,156,0,156,0,0,156
Listas,2014EP,04-003-013,940,252,0,252,0,0,252
Listas,2014EP,04-003-014,954,254,0,254,0,1,253
Listas,2014EP,04-003-015,955,209,0,209,0,1,208
Listas,2014EP,04-003-016,919,87,0,87,0,1,86
Listas,2014EP,04-004-001,645,229,0,229,0,1,228
Listas,2014EP,04-004-002,606,229,0,229,0,1,228
Listas,2014EP,04-004-003,676,247,0,247,0,2,245
Listas,2014EP,04-004-004,921,353,0,354,1,9,345
Listas,2014EP,04-004-005,897,354,0,354,0,2,352
Listas,2014EP,04-004-006,583,227,0,227,0,0,227
Listas,2014EP,04-004-007,906,263,0,261,-2,0,261
Listas,2014EP,04-004-008,689,185,0,185,0,1,184
Listas,2014EP,04-004-009,809,205,0,205,0,0,205
Listas,2014EP,04-004-010,829,234,0,234,0,0,234
Listas,2014EP,04-004-011,967,309,0,309,0,0,309
Listas,2014EP,04-004-012,644,166,0,166,0,1,165
Listas,2014EP,04-004-013,540,186,0,186,0,0,186
Listas,2014EP,04-004-014,706,241,0,241,0,0,241
Listas,2014EP,04-004-015,827,315,0,315,0,0,315
Listas,2014EP,04-004-016,844,203,0,203,0,0,203
Listas,2014EP,04-004-017,885,286,0,286,0,4,282
Listas,2014EP,04-004-018,645,224,0,224,0,2,222
Listas,2014EP,04-004-019,1016,357,0,355,-2,1,354
Listas,2014EP,04-004-020,890,302,0,302,0,3,299
Listas,2014EP,04-004-021,745,249,0,249,0,0,249
Listas,2014EP,04-004-022,757,207,0,207,0,1,206
Listas,2014EP,04-004-023,751,168,0,168,0,1,167
Listas,2014EP,04-004-024,633,172,0,172,0,2,170
Listas,2014EP,04-004-025,557,171,0,171,0,0,171
Listas,2014EP,04-004-026,622,216,0,216,0,2,214
Listas,2014EP,04-004-027,765,183,0,183,0,1,182
Listas,2014EP,04-004-028,936,283,0,283,0,0,283
Listas,2014EP,04-004-029,1102,468,0,468,0,0,468
Listas,2014EP,04-004-030,1004,368,0,368,0,1,367
Listas,2014EP,04-004-031,630,179,0,179,0,0,179
Listas,2014EP,04-004-032,695,186,0,186,0,0,186
Listas,2014EP,04-004-033,697,205,1,204,-1,0,204
Listas,2014EP,04-004-034,697,253,0,253,0,2,251
Listas,2014EP,04-004-035,801,168,0,168,0,0,168
Listas,2014EP,04-004-036,753,224,0,224,0,0,224
Listas,2014EP,04-004-037,729,238,0,238,0,3,235
Listas,2014EP,04-004-038,761,276,0,275,-1,0,275
Listas,2014EP,04-004-039,812,241,0,241,0,3,238
Listas,2014EP,04-004-040,694,225,0,225,0,0,225
Listas,2014EP,04-004-041,1066,260,0,260,0,0,260
Listas,2014EP,04-004-042,777,241,0,241,0,0,241
Listas,2014EP,04-004-043,603,185,0,185,0,0,185
Listas,2014EP,04-004-044,802,212,0,212,0,1,211
Listas,2014EP,04-004-045,595,140,0,140,0,2,138
Listas,2014EP,04-004-046,895,241,0,241,0,1,240
Listas,2014EP,04-004-047,981,260,0,260,0,0,260
Listas,2014EP,04-004-048,954,272,0,272,0,0,272
Listas,2014EP,04-004-049,823,226,0,226,0,2,224
Listas,2014EP,04-004-050,872,280,0,280,0,2,278
Listas,2014EP,04-004-051,990,248,0,248,0,3,245
Listas,2014EP,04-004-052,862,203,0,203,0,2,201
Listas,2014EP,04-004-053,587,212,0,212,0,0,212
Listas,2014EP,04-004-054,177,29,0,29,0,0,29
Listas,2014EP,04-004-055,236,43,0,43,0,0,43
Listas,2014EP,04-004-056,800,231,0,231,0,1,230
Listas,2014EP,04-004-057,867,202,0,202,0,1,201
Listas,2014EP,04-004-058,602,172,0,172,0,0,172
Listas,2014EP,04-004-059,614,142,0,142,0,0,142
Listas,2014EP,04-004-060,832,242,0,242,0,0,242
Listas,2014EP,04-004-061,275,63,0,63,0,0,63
Listas,2014EP,04-004-062,1065,270,0,270,0,4,266
Listas,2014EP,04-004-063,635,231,0,231,0,0,231
Listas,2014EP,04-004-064,778,261,2,259,-2,0,259
Listas,2014EP,04-004-065,615,167,0,167,0,0,167
Listas,2014EP,04-004-066,506,135,0,135,0,3,132
Listas,2014EP,04-004-067,750,141,0,141,0,2,139
Listas,2014EP,04-004-068,806,175,0,175,0,1,174
Listas,2014EP,04-005-001,662,128,0,128,0,1,127
Listas,2014EP,04-005-002,662,129,0,129,0,0,129
Listas,2014EP,04-005-003,674,112,0,112,0,0,112
Listas,2014EP,04-006-001,442,190,0,190,0,0,190
Listas,2014EP,04-006-002,445,148,0,148,0,1,147
Listas,2014EP,04-006-003,483,127,0,127,0,1,126
Listas,2014EP,04-006-004,472,153,0,153,0,0,153
Listas,2014EP,04-006-005,707,186,0,186,0,0,186
Listas,2014EP,04-006-006,526,178,0,178,0,2,176
Listas,2014EP,04-006-007,49,23,0,23,0,0,23
Listas,2014EP,04-007-001,863,191,0,191,0,1,190
Listas,2014EP,04-008-001,850,283,0,283,0,0,283
Listas,2014EP,04-009-001,968,168,0,168,0,0,168
Listas,2014EP,04-009-002,925,187,0,187,0,1,186
Listas,2014EP,04-010-001,709,219,0,219,0,2,217
Listas,2014EP,04-010-002,729,189,0,189,0,0,189
Listas,2014EP,04-010-003,103,18,0,18,0,0,18
Listas,2014EP,04-011-001,284,76,0,76,0,0,76
Listas,2014EP,04-012-001,1045,249,0,249,0,0,249
Listas,2014EP,04-012-002,1139,213,0,213,0,1,212
Listas,2014EP,04-013-001,362,108,0,108,0,1,107
Listas,2014EP,04-014-001,871,229,0,229,0,1,228
Listas,2014EP,04-014-002,873,137,0,137,0,0,137
Listas,2014EP,04-014-003,869,189,0,189,0,0,189
Listas,2014EP,04-014-004,822,162,0,162,0,3,159
Listas,2014EP,04-014-005,861,198,0,198,0,3,195
Listas,2014EP,04-015-001,829,154,0,154,0,3,151
Listas,2014EP,04-015-002,825,153,0,153,0,1,152
Listas,2014EP,04-015-003,884,165,0,165,0,0,165
Listas,2014EP,04-015-004,711,169,0,169,0,3,166
Listas,2014EP,04-015-005,714,169,0,169,0,1,168
Listas,2014EP,04-015-006,753,160,0,160,0,0,160
Listas,2014EP,04-015-007,843,159,0,159,0,0,159
Listas,2014EP,04-015-008,874,150,0,150,0,2,148
Listas,2014EP,04-016-001,837,150,0,150,0,1,149
Listas,2014EP,04-016-002,651,117,0,117,0,1,116
Listas,2014EP,04-016-003,711,160,0,160,0,0,160
Listas,2014EP,04-016-004,642,141,0,141,0,0,141
Listas,2014EP,04-016-005,664,141,0,141,0,0,141
Listas,2014EP,04-017-001,714,149,0,149,0,1,148
Listas,2014EP,04-017-002,631,155,0,155,0,0,155
Listas,2014EP,04-017-003,470,97,0,97,0,0,97
Listas,2014EP,04-018-001,506,159,0,159,0,2,157
Listas,2014EP,04-019-001,531,76,0,76,0,0,76
Listas,2014EP,04-019-002,555,103,0,103,0,2,101
Listas,2014EP,04-020-001,503,104,0,104,0,1,103
Listas,2014EP,04-020-002,633,177,0,177,0,1,176
Listas,2014EP,04-020-003,666,119,0,119,0,1,118
Listas,2014EP,04-020-004,648,174,0,174,0,1,173
Listas,2014EP,04-020-005,697,175,0,175,0,0,175
Listas,2014EP,04-020-006,746,77,0,77,0,2,75
Listas,2014EP,04-021-001,619,112,0,112,0,0,112
Listas,2014EP,04-021-002,672,172,0,172,0,0,172
Listas,2014EP,04-021-003,635,174,0,174,0,0,174
Listas,2014EP,04-021-004,680,163,0,163,0,0,163
Listas,2014EP,04-021-005,660,114,0,114,0,0,114
Listas,2014EP,04-021-006,728,168,0,168,0,0,168
Listas,2014EP,04-021-007,771,168,0,168,0,1,167
Listas,2014EP,04-022-001,1019,164,0,164,0,2,162
Listas,2014EP,04-022-002,1083,223,0,223,0,0,223
Listas,2014EP,04-022-003,1026,214,0,214,0,0,214
Listas,2014EP,04-023-001,618,212,0,212,0,1,211
Listas,2014EP,04-023-002,518,201,0,201,0,1,200
Listas,2014EP,04-024-001,622,115,0,115,0,0,115
Listas,2014EP,04-025-001,721,222,0,222,0,0,222
Listas,2014EP,04-025-002,751,213,0,213,0,0,213
Listas,2014EP,04-025-003,677,173,0,173,0,1,172
Listas,2014EP,04-025-004,788,195,0,195,0,2,193
Listas,2014EP,04-025-005,714,227,0,227,0,0,227
Listas,2014EP,04-025-006,744,203,0,203,0,3,200
Listas,2014EP,04-025-007,782,137,0,137,0,0,137
Listas,2014EP,04-025-008,650,125,0,125,0,1,124
Listas,2014EP,04-025-009,715,147,0,147,0,0,147
Listas,2014EP,04-025-010,662,174,0,174,0,0,174
Listas,2014EP,04-025-011,808,157,0,157,0,0,157
Listas,2014EP,04-025-012,744,137,0,137,0,2,135
Listas,2014EP,04-025-013,675,89,0,89,0,0,89
Listas,2014EP,04-025-014,608,139,0,139,0,0,139
Listas,2014EP,04-025-015,138,38,0,38,0,0,38
Listas,2014EP,04-025-016,854,216,0,216,0,0,216
Listas,2014EP,04-025-017,592,57,0,57,0,1,56
Listas,2014EP,04-026-001,1162,362,0,362,0,1,361
Listas,2014EP,04-026-002,1126,428,0,428,0,1,427
Listas,2014EP,04-026-003,983,397,0,397,0,1,396
Listas,2014EP,04-026-004,850,273,2,271,-2,1,270
Listas,2014EP,04-026-005,832,198,0,197,-1,2,195
Listas,2014EP,04-026-006,969,306,0,306,0,0,306
Listas,2014EP,04-026-007,1094,280,0,278,-2,1,277
Listas,2014EP,04-026-008,1025,370,0,370,0,0,370
Listas,2014EP,04-026-009,767,301,0,301,0,1,300
Listas,2014EP,04-026-010,833,312,0,312,0,2,310
Listas,2014EP,04-026-011,802,210,0,210,0,0,210
Listas,2014EP,04-026-012,763,180,0,180,0,1,179
Listas,2014EP,04-026-013,730,154,0,154,0,0,154
Listas,2014EP,04-026-014,1113,227,0,227,0,0,227
Listas,2014EP,04-026-015,874,299,0,299,0,0,299
Listas,2014EP,04-026-016,999,314,0,314,0,3,311
Listas,2014EP,04-026-017,764,214,0,214,0,0,214
Listas,2014EP,04-026-018,758,191,0,191,0,0,191
Listas,2014EP,04-026-019,1152,260,0,260,0,1,259
Listas,2014EP,04-026-020,798,261,0,261,0,0,261
Listas,2014EP,04-026-021,944,282,0,282,0,0,282
Listas,2014EP,04-026-022,913,243,0,243,0,0,243
Listas,2014EP,04-026-023,1099,294,0,294,0,0,294
Listas,2014EP,04-026-024,763,176,0,176,0,0,176
Listas,2014EP,04-026-025,941,301,0,301,0,2,299
Listas,2014EP,04-026-026,828,188,0,188,0,0,188
Listas,2014EP,04-026-027,655,139,0,139,0,0,139
Listas,2014EP,04-026-028,656,168,0,168,0,2,166
Listas,2014EP,04-026-029,702,138,0,138,0,0,138
Listas,2014EP,04-026-030,162,19,0,19,0,0,19
Listas,2014EP,04-027-001,571,188,0,187,-1,1,186
Listas,2014EP,04-028-001,489,153,0,152,-1,1,151
Listas,2014EP,04-028-002,399,104,0,104,0,0,104
Listas,2014EP,04-029-001,573,150,0,150,0,0,150
Listas,2014EP,04-030-001,754,170,0,170,0,1,169
Listas,2014EP,04-031-001,750,212,0,212,0,1,211
Listas,2014EP,04-031-002,738,156,0,156,0,3,153
Listas,2014EP,04-031-003,129,29,0,29,0,0,29
Listas,2014EP,04-032-001,325,63,0,63,0,0,63
Listas,2014EP,04-033-001,815,206,0,206,0,2,204
Listas,2014EP,04-033-002,785,197,0,197,0,6,191
Listas,2014EP,04-034-001,766,164,0,164,0,0,164
Listas,2014EP,04-034-002,772,132,0,132,0,1,131
Listas,2014EP,04-034-003,859,165,0,165,0,1,164
Listas,2014EP,04-034-004,691,129,0,127,-2,1,126
Listas,2014EP,04-035-001,818,303,0,303,0,2,301
Listas,2014EP,04-035-002,343,70,0,70,0,0,70
Listas,2014EP,04-036-001,415,125,0,125,0,0,125
Listas,2014EP,04-037-001,634,145,0,145,0,0,145
Listas,2014EP,04-037-002,691,171,0,171,0,0,171
Listas,2014EP,04-037-003,682,180,0,180,0,1,179
Listas,2014EP,04-037-004,619,131,0,131,0,2,129
Listas,2014EP,04-037-005,671,113,0,113,0,2,111
Listas,2014EP,04-037-006,635,169,0,169,0,0,169
Listas,2014EP,04-037-007,512,74,0,74,0,0,74
Listas,2014EP,04-038-001,852,174,0,174,0,0,174
Listas,2014EP,04-038-002,969,118,0,118,0,1,117
Listas,2014EP,04-038-003,972,158,0,158,0,1,157
Listas,2014EP,04-038-004,951,258,0,258,0,3,255
Listas,2014EP,04-039-001,546,188,0,188,0,1,187
Listas,2014EP,04-040-001,717,165,0,165,0,1,164
Listas,2014EP,04-040-002,718,164,0,164,0,0,164
Listas,2014EP,04-040-003,744,164,0,164,0,1,163
Listas,2014EP,04-041-001,432,104,0,104,0,0,104
Listas,2014EP,04-042-001,615,141,0,141,0,0,141
Listas,2014EP,04-042-002,642,167,0,167,0,1,166
Listas,2014EP,04-043-001,703,157,0,157,0,2,155
Listas,2014EP,04-043-002,687,129,0,129,0,0,129
Listas,2014EP,04-043-003,850,155,0,155,0,2,153
Listas,2014EP,04-044-001,869,209,0,209,0,0,209
Listas,2014EP,04-044-002,707,170,0,170,0,1,169
Listas,2014EP,04-045-001,656,188,0,188,0,1,187
Listas,2014EP,04-045-002,537,138,0,138,0,2,136
Listas,2014EP,04-045-003,615,148,0,148,0,2,146
Listas,2014EP,04-046-001,193,61,0,61,0,1,60
Listas,2014EP,04-047-001,592,142,0,142,0,1,141
Listas,2014EP,04-047-002,291,71,0,71,0,0,71
Listas,2014EP,04-048-001,987,261,0,261,0,0,261
Listas,2014EP,04-048-002,857,284,0,284,0,3,281
Listas,2014EP,04-048-003,880,248,0,248,0,4,244
Listas,2014EP,04-048-004,294,55,0,55,0,0,55
Listas,2014EP,04-049-001,1105,188,0,188,0,1,187
Listas,2014EP,04-049-002,1062,238,0,238,0,1,237
Listas,2014EP,04-049-003,1108,268,0,268,0,4,264
Listas,2014EP,04-049-004,1058,234,0,234,0,2,232
Listas,2014EP,04-049-005,957,286,0,286,0,3,283
Listas,2014EP,04-049-006,1164,198,0,198,0,0,198
Listas,2014EP,04-049-007,1102,310,0,310,0,0,310
Listas,2014EP,04-049-008,1050,249,0,249,0,2,247
Listas,2014EP,04-050-001,816,165,0,165,0,0,165
Listas,2014EP,04-050-002,85,30,0,30,0,0,30
Listas,2014EP,04-051-001,737,120,0,120,0,0,120
Listas,2014EP,04-051-002,652,136,0,136,0,1,135
Listas,2014EP,04-051-003,794,162,0,162,0,1,161
Listas,2014EP,04-051-004,805,231,0,231,0,1,230
Listas,2014EP,04-051-005,844,166,0,166,0,1,165
Listas,2014EP,04-051-006,777,133,0,133,0,2,131
Listas,2014EP,04-052-001,862,256,0,256,0,3,253
Listas,2014EP,04-052-002,988,308,0,308,0,1,307
Listas,2014EP,04-052-003,1113,242,1,241,-1,1,240
Listas,2014EP,04-052-004,1140,242,0,242,0,0,242
Listas,2014EP,04-052-005,1041,200,0,200,0,1,199
Listas,2014EP,04-053-001,845,103,0,103,0,0,103
Listas,2014EP,04-053-002,902,146,0,146,0,2,144
Listas,2014EP,04-054-001,529,109,0,109,0,0,109
Listas,2014EP,04-054-002,565,105,0,105,0,1,104
Listas,2014EP,04-055-001,1134,315,0,315,0,0,315
Listas,2014EP,04-056-001,389,88,0,88,0,0,88
Listas,2014EP,04-056-002,360,95,0,95,0,0,95
Listas,2014EP,04-056-003,421,85,0,85,0,1,84
Listas,2014EP,04-057-001,661,137,0,137,0,1,136
Listas,2014EP,04-057-002,577,171,0,171,0,5,166
Listas,2014EP,04-057-003,696,197,0,197,0,0,197
Listas,2014EP,04-057-004,578,155,0,155,0,0,155
Listas,2014EP,04-057-005,644,169,0,169,0,2,167
Listas,2014EP,04-057-006,608,172,0,172,0,3,169
Listas,2014EP,04-057-007,632,152,0,152,0,1,151
Listas,2014EP,04-058-001,1037,172,0,171,-1,0,171
Listas,2014EP,04-058-002,952,186,0,186,0,1,185
Listas,2014EP,04-059-001,761,281,0,281,0,0,281
Listas,2014EP,04-059-002,737,169,0,169,0,1,168
Listas,2014EP,04-059-003,692,140,0,140,0,0,140
Listas,2014EP,04-059-004,826,186,0,186,0,0,186
Listas,2014EP,04-059-005,624,197,0,197,0,2,195
Listas,2014EP,04-059-006,871,242,0,242,0,1,241
Listas,2014EP,04-059-007,458,166,0,166,0,1,165
Listas,2014EP,04-059-008,559,171,0,171,0,0,171
Listas,2014EP,04-059-009,528,174,0,174,0,0,174
Listas,2014EP,04-059-010,817,239,0,239,0,1,238
Listas,2014EP,04-059-011,645,210,0,210,0,0,210
Listas,2014EP,04-059-012,740,234,0,234,0,0,234
Listas,2014EP,04-059-013,648,193,0,193,0,1,192
Listas,2014EP,04-059-014,658,198,0,198,0,1,197
Listas,2014EP,04-059-015,579,190,0,190,0,0,190
Listas,2014EP,04-059-016,149,28,0,28,0,0,28
Listas,2014EP,04-059-017,715,167,0,167,0,0,167
Listas,2014EP,04-059-018,543,173,0,173,0,0,173
Listas,2014EP,04-059-019,772,251,0,251,0,1,250
Listas,2014EP,04-059-020,960,267,0,266,-1,0,266
Listas,2014EP,04-059-021,774,257,0,257,0,1,256
Listas,2014EP,04-059-022,769,198,0,198,0,2,196
Listas,2014EP,04-059-023,1030,295,0,295,0,0,295
Listas,2014EP,04-059-024,1010,308,0,308,0,0,308
Listas,2014EP,04-059-025,925,321,1,320,-1,0,320
Listas,2014EP,04-059-026,862,222,0,222,0,3,219
Listas,2014EP,04-059-027,805,205,0,205,0,1,204
Listas,2014EP,04-059-028,373,112,0,112,0,0,112
Listas,2014EP,04-059-029,381,86,0,86,0,0,86
Listas,2014EP,04-059-030,884,156,0,156,0,0,156
Listas,2014EP,04-059-031,880,200,0,200,0,0,200
Listas,2014EP,04-059-032,678,143,0,143,0,3,140
Listas,2014EP,04-059-033,747,141,0,141,0,0,141
Listas,2014EP,04-059-034,154,42,0,42,0,0,42
Listas,2014EP,04-059-035,184,45,0,45,0,0,45
Listas,2014EP,04-059-036,700,172,0,172,0,0,172
Listas,2014EP,04-059-037,97,34,0,34,0,0,34
Listas,2014EP,04-060-001,352,104,0,104,0,0,104
Listas,2014EP,04-061-001,819,186,0,186,0,2,184
Listas,2014EP,04-061-002,595,115,0,115,0,0,115
Listas,2014EP,04-062-001,262,122,0,122,0,3,119
Listas,2014EP,04-062-002,78,37,0,37,0,0,37
Listas,2014EP,04-063-001,1017,200,0,200,0,1,199
Listas,2014EP,04-063-002,1047,208,0,208,0,0,208
Listas,2014EP,04-063-003,1078,190,0,190,0,0,190
Listas,2014EP,04-063-004,1088,260,0,260,0,1,259
Listas,2014EP,04-063-005,1059,104,0,104,0,1,103
Listas,2014EP,04-063-006,933,194,0,194,0,2,192
Listas,2014EP,04-063-007,1089,249,0,249,0,0,249
Listas,2014EP,04-063-008,940,207,0,207,0,0,207
Listas,2014EP,04-064-001,598,128,0,128,0,0,128
Listas,2014EP,04-064-002,597,158,0,158,0,3,155
Listas,2014EP,04-064-003,150,44,0,44,0,2,42
Listas,2014EP,04-064-004,60,32,0,32,0,0,32
Listas,2014EP,04-065-001,681,161,0,161,0,4,157
Listas,2014EP,04-065-002,817,215,0,215,0,0,215
Listas,2014EP,04-065-003,733,131,0,131,0,1,130
Listas,2014EP,04-066-001,972,373,0,373,0,1,372
Listas,2014EP,04-066-002,1024,237,0,237,0,1,236
Listas,2014EP,04-066-003,837,277,0,277,0,0,277
Listas,2014EP,04-066-004,685,240,0,240,0,1,239
Listas,2014EP,04-066-005,808,315,0,315,0,0,315
Listas,2014EP,04-066-006,706,202,0,202,0,0,202
Listas,2014EP,04-066-007,693,149,0,149,0,1,148
Listas,2014EP,04-066-008,1007,278,0,278,0,0,278
Listas,2014EP,04-066-009,172,41,0,41,0,0,41
Listas,2014EP,04-066-010,1134,453,0,453,0,0,453
Listas,2014EP,04-066-011,968,247,0,247,0,0,247
Listas,2014EP,04-066-012,970,301,0,301,0,0,301
Listas,2014EP,04-066-013,818,236,0,236,0,0,236
Listas,2014EP,04-066-014,923,222,0,222,0,1,221
Listas,2014EP,04-066-015,776,199,0,199,0,1,198
Listas,2014EP,04-066-016,258,58,0,58,0,0,58
Listas,2014EP,04-066-017,64,15,0,15,0,1,14
Listas,2014EP,04-066-018,437,110,0,110,0,1,109
Listas,2014EP,04-066-019,509,114,0,114,0,1,113
Listas,2014EP,04-067-001,1089,242,0,242,0,1,241
Listas,2014EP,04-067-002,1116,311,0,311,0,2,309
Listas,2014EP,04-067-003,1081,262,0,262,0,2,260
Listas,2014EP,04-067-004,1093,270,0,270,0,1,269
Listas,2014EP,04-067-005,1065,213,0,213,0,2,211
Listas,2014EP,04-067-006,1132,262,0,262,0,2,260
Listas,2014EP,04-067-007,1171,105,0,105,0,0,105
Listas,2014EP,04-068-001,689,141,0,141,0,2,139
Listas,2014EP,04-068-002,45,6,0,6,0,0,6
Listas,2014EP,04-069-001,618,170,0,170,0,1,169
Listas,2014EP,04-069-002,725,179,0,179,0,1,178
Listas,2014EP,04-070-001,498,155,0,155,0,2,153
Listas,2014EP,04-070-002,684,170,0,170,0,2,168
Listas,2014EP,04-070-003,570,225,0,225,0,2,223
Listas,2014EP,04-070-004,513,160,0,160,0,1,159
Listas,2014EP,04-070-005,552,119,0,119,0,1,118
Listas,2014EP,04-070-006,521,168,0,168,0,0,168
Listas,2014EP,04-070-007,822,245,0,245,0,0,245
Listas,2014EP,04-070-008,765,216,0,216,0,2,214
Listas,2014EP,04-070-009,68,20,0,20,0,0,20
Listas,2014EP,04-071-001,807,152,0,152,0,3,149
Listas,2014EP,04-071-002,661,143,0,143,0,1,142
Listas,2014EP,04-071-003,747,138,0,138,0,1,137
Listas,2014EP,04-071-004,844,236,0,236,0,0,236
Listas,2014EP,04-071-005,736,218,0,218,0,1,217
Listas,2014EP,04-071-006,637,132,0,132,0,1,131
Listas,2014EP,04-072-001,93,29,0,29,0,1,28
Listas,2014EP,04-073-001,1034,260,0,260,0,0,260
Listas,2014EP,04-073-002,145,31,0,31,0,0,31
Listas,2014EP,04-074-001,726,143,0,143,0,1,142
Listas,2014EP,04-074-002,704,152,0,152,0,1,151
Listas,2014EP,04-074-003,739,198,0,198,0,0,198
Listas,2014EP,04-074-004,736,152,0,152,0,0,152
Listas,2014EP,04-074-005,980,164,0,164,0,0,164
Listas,2014EP,04-074-006,897,138,0,138,0,1,137
Listas,2014EP,04-074-007,897,110,0,110,0,3,107
Listas,2014EP,04-075-001,680,138,0,138,0,0,138
Listas,2014EP,04-075-002,645,152,0,152,0,0,152
Listas,2014EP,05-001-001,74,22,0,22,0,0,22
Listas,2014EP,05-002-001,450,115,0,115,0,0,115
Listas,2014EP,05-002-002,74,21,0,21,0,0,21
Listas,2014EP,05-003-001,80,31,0,31,0,1,30
Listas,2014EP,05-004-001,840,127,0,127,0,0,127
Listas,2014EP,05-004-002,828,142,0,142,0,0,142
Listas,2014EP,05-004-003,814,194,0,194,0,0,194
Listas,2014EP,05-005-001,117,23,0,23,0,0,23
Listas,2014EP,05-006-001,192,59,0,59,0,0,59
Listas,2014EP,05-007-001,181,68,0,68,0,0,68
Listas,2014EP,05-008-001,468,137,0,137,0,0,137
Listas,2014EP,05-009-001,655,92,0,92,0,0,92
Listas,2014EP,05-010-001,633,104,0,104,0,3,101
Listas,2014EP,05-011-001,259,91,0,91,0,0,91
Listas,2014EP,05-012-001,88,47,0,47,0,0,47
Listas,2014EP,05-013-001,172,64,0,64,0,5,59
Listas,2014EP,05-014-001,368,101,0,101,0,0,101
Listas,2014EP,05-015-001,123,58,0,58,0,1,57
Listas,2014EP,05-016-001,1123,220,0,220,0,0,220
Listas,2014EP,05-017-001,766,242,0,242,0,0,242
Listas,2014EP,05-017-002,779,194,0,194,0,1,193
Listas,2014EP,05-017-003,947,123,0,123,0,0,123
Listas,2014EP,05-017-004,876,232,0,232,0,1,231
Listas,2014EP,05-017-005,972,271,0,271,0,7,264
Listas,2014EP,05-018-001,78,38,0,38,0,0,38
Listas,2014EP,05-019-001,901,86,0,86,0,0,86
Listas,2014EP,05-019-002,918,125,0,125,0,0,125
Listas,2014EP,05-019-003,919,105,0,105,0,1,104
Listas,2014EP,05-020-001,912,311,0,311,0,1,310
Listas,2014EP,05-020-002,1137,360,0,360,0,0,360
Listas,2014EP,05-021-001,702,121,0,121,0,1,120
Listas,2014EP,05-021-002,698,129,0,129,0,0,129
Listas,2014EP,05-022-001,871,218,0,218,0,0,218
Listas,2014EP,05-023-001,559,123,0,123,0,2,121
Listas,2014EP,05-024-001,327,87,0,87,0,0,87
Listas,2014EP,05-025-001,171,89,0,89,0,0,89
Listas,2014EP,05-026-001,594,145,0,145,0,0,145
Listas,2014EP,05-026-002,637,154,0,154,0,1,153
Listas,2014EP,05-027-001,1067,328,0,328,0,3,325
Listas,2014EP,05-028-001,38,21,0,21,0,0,21
Listas,2014EP,05-029-001,1026,222,0,222,0,1,221
Listas,2014EP,05-029-002,1064,238,0,238,0,1,237
Listas,2014EP,05-030-001,983,190,0,190,0,1,189
Listas,2014EP,05-031-001,204,37,0,37,0,0,37
Listas,2014EP,05-032-001,735,132,0,132,0,0,132
Listas,2014EP,05-033-001,1096,162,0,162,0,0,162
Listas,2014EP,05-034-001,997,255,0,255,0,4,251
Listas,2014EP,05-035-001,738,187,0,187,0,3,184
Listas,2014EP,05-036-001,758,153,0,153,0,3,150
Listas,2014EP,05-037-001,747,247,0,247,0,0,247
Listas,2014EP,05-037-002,912,212,0,212,0,1,211
Listas,2014EP,05-038-001,361,57,0,57,0,0,57
Listas,2014EP,05-039-001,792,181,0,181,0,2,179
Listas,2014EP,05-040-001,996,126,0,126,0,0,126
Listas,2014EP,05-040-002,859,219,0,219,0,0,219
Listas,2014EP,05-041-001,694,141,0,141,0,1,140
Listas,2014EP,05-042-001,250,102,0,102,0,0,102
Listas,2014EP,05-043-001,420,113,0,113,0,0,113
Listas,2014EP,05-044-001,602,118,0,118,0,0,118
Listas,2014EP,05-044-002,673,125,0,125,0,0,125
Listas,2014EP,05-044-003,613,139,0,139,0,0,139
Listas,2014EP,05-044-004,728,214,0,214,0,3,211
Listas,2014EP,05-045-001,1025,233,0,233,0,1,232
Listas,2014EP,05-046-001,930,182,0,182,0,1,181
Listas,2014EP,05-047-001,128,37,0,37,0,0,37
Listas,2014EP,05-048-001,89,20,0,20,0,0,20
Listas,2014EP,05-049-001,897,264,0,264,0,4,260
Listas,2014EP,05-050-001,161,63,0,63,0,0,63
Listas,2014EP,05-051-001,818,176,0,176,0,1,175
Listas,2014EP,05-051-002,642,139,0,139,0,0,139
Listas,2014EP,05-051-003,719,167,0,167,0,0,167
Listas,2014EP,05-052-001,1197,290,0,290,0,0,290
Listas,2014EP,05-053-001,623,213,0,213,0,0,213
Listas,2014EP,05-053-002,762,211,0,211,0,0,211
Listas,2014EP,05-054-001,114,42,0,42,0,0,42
Listas,2014EP,05-055-001,1039,299,0,299,0,1,298
Listas,2014EP,05-056-001,860,275,0,275,0,0,275
Listas,2014EP,05-057-001,184,42,0,42,0,2,40
Listas,2014EP,05-058-001,847,110,0,110,0,0,110
Listas,2014EP,05-058-002,780,83,0,83,0,0,83
Listas,2014EP,05-058-003,726,76,0,76,0,1,75
Listas,2014EP,05-059-001,245,49,0,49,0,1,48
Listas,2014EP,05-060-001,872,270,0,270,0,0,270
Listas,2014EP,05-061-001,388,127,0,127,0,0,127
Listas,2014EP,05-062-001,620,142,0,142,0,0,142
Listas,2014EP,05-063-001,481,124,0,124,0,1,123
Listas,2014EP,05-064-001,567,118,0,118,0,1,117
Listas,2014EP,05-065-001,536,151,0,151,0,2,149
Listas,2014EP,05-066-001,722,159,0,159,0,0,159
Listas,2014EP,05-067-001,213,74,0,74,0,1,73
Listas,2014EP,05-068-001,292,51,0,51,0,0,51
Listas,2014EP,05-069-001,21,16,0,16,0,0,16
Listas,2014EP,05-070-001,222,73,0,73,0,1,72
Listas,2014EP,05-071-001,655,133,0,133,0,0,133
Listas,2014EP,05-071-002,620,132,0,132,0,0,132
Listas,2014EP,05-072-001,653,141,0,141,0,2,139
Listas,2014EP,05-073-001,251,78,0,78,0,0,78
Listas,2014EP,05-074-001,258,58,0,58,0,0,58
Listas,2014EP,05-075-001,996,257,0,257,0,1,256
Listas,2014EP,05-075-002,1068,316,0,315,-1,0,315
Listas,2014EP,05-075-003,1157,253,0,253,0,0,253
Listas,2014EP,05-075-004,922,285,0,285,0,0,285
Listas,2014EP,05-075-005,922,306,0,306,0,2,304
Listas,2014EP,05-075-006,889,254,0,253,-1,1,252
Listas,2014EP,05-075-007,1101,274,0,274,0,0,274
Listas,2014EP,05-075-008,1009,127,0,127,0,0,127
Listas,2014EP,05-076-001,459,183,0,183,0,0,183
Listas,2014EP,05-077-001,765,135,0,135,0,0,135
Listas,2014EP,05-077-002,796,168,0,168,0,1,167
Listas,2014EP,05-077-003,848,184,0,184,0,0,184
Listas,2014EP,05-077-004,868,149,0,149,0,0,149
Listas,2014EP,05-077-005,860,179,0,179,0,2,177
Listas,2014EP,05-078-001,853,259,0,259,0,2,257
Listas,2014EP,05-078-002,900,225,0,225,0,1,224
Listas,2014EP,05-078-003,621,78,0,78,0,2,76
Listas,2014EP,05-078-004,811,210,0,210,0,1,209
Listas,2014EP,05-078-005,785,265,0,265,0,1,264
Listas,2014EP,05-078-006,650,139,0,139,0,0,139
Listas,2014EP,05-078-007,426,78,0,78,0,1,77
Listas,2014EP,05-079-001,1009,284,0,284,0,0,284
Listas,2014EP,05-080-001,478,128,0,128,0,1,127
Listas,2014EP,05-081-001,56,37,0,37,0,0,37
Listas,2014EP,05-082-001,280,84,0,84,0,0,84
Listas,2014EP,05-083-001,700,180,0,180,0,1,179
Listas,2014EP,05-083-002,586,158,0,158,0,4,154
Listas,2014EP,05-084-001,240,52,0,52,0,1,51
Listas,2014EP,05-085-001,223,59,0,59,0,0,59
Listas,2014EP,05-086-001,677,140,0,140,0,1,139
Listas,2014EP,05-087-001,149,26,0,26,0,0,26
Listas,2014EP,05-088-001,313,81,0,81,0,2,79
Listas,2014EP,05-089-001,816,182,0,182,0,0,182
Listas,2014EP,05-090-001,203,39,0,39,0,0,39
Listas,2014EP,05-091-001,629,103,0,103,0,1,102
Listas,2014EP,05-092-001,369,52,0,52,0,0,52
Listas,2014EP,05-093-001,750,275,0,274,-1,1,273
Listas,2014EP,05-093-002,943,314,0,314,0,1,313
Listas,2014EP,05-093-003,1143,320,0,320,0,1,319
Listas,2014EP,05-093-004,711,249,0,249,0,1,248
Listas,2014EP,05-093-005,888,236,0,236,0,1,235
Listas,2014EP,05-093-006,1036,261,0,261,0,2,259
Listas,2014EP,05-094-001,96,35,0,35,0,1,34
Listas,2014EP,05-095-001,281,66,0,66,0,1,65
Listas,2014EP,05-096-001,952,215,0,215,0,1,214
Listas,2014EP,05-096-002,985,230,0,230,0,1,229
Listas,2014EP,05-097-001,254,32,0,32,0,0,32
Listas,2014EP,05-098-001,369,141,0,141,0,0,141
Listas,2014EP,05-099-001,110,44,0,44,0,1,43
Listas,2014EP,05-100-001,288,93,0,93,0,2,91
Listas,2014EP,05-101-001,255,68,0,68,0,1,67
Listas,2014EP,05-102-001,166,48,0,48,0,0,48
Listas,2014EP,05-103-001,29,10,0,10,0,0,10
Listas,2014EP,05-104-001,149,45,0,45,0,0,45
Listas,2014EP,05-105-001,168,46,0,46,0,0,46
Listas,2014EP,05-106-001,87,44,0,44,0,1,43
Listas,2014EP,05-107-001,331,144,0,144,0,1,143
Listas,2014EP,05-108-001,491,242,0,242,0,3,239
Listas,2014EP,05-109-001,706,150,0,150,0,0,150
Listas,2014EP,05-109-002,606,162,0,162,0,1,161
Listas,2014EP,05-109-003,663,184,0,184,0,1,183
Listas,2014EP,05-109-004,206,31,0,31,0,0,31
Listas,2014EP,05-110-001,598,167,0,167,0,0,167
Listas,2014EP,05-111-001,472,141,0,141,0,1,140
Listas,2014EP,05-112-001,73,41,0,41,0,0,41
Listas,2014EP,05-113-001,878,263,0,263,0,1,262
Listas,2014EP,05-113-002,787,159,0,159,0,0,159
Listas,2014EP,05-114-001,479,90,0,90,0,0,90
Listas,2014EP,05-115-001,460,85,0,85,0,0,85
Listas,2014EP,05-116-001,671,198,0,198,0,1,197
Listas,2014EP,05-116-002,700,113,0,113,0,0,113
Listas,2014EP,05-117-001,484,124,0,124,0,0,124
Listas,2014EP,05-118-001,645,102,0,102,0,0,102
Listas,2014EP,05-118-002,622,125,0,125,0,0,125
Listas,2014EP,05-119-001,809,199,0,199,0,1,198
Listas,2014EP,05-119-002,846,244,0,244,0,1,243
Listas,2014EP,05-120-001,126,67,0,67,0,1,66
Listas,2014EP,05-121-001,100,42,0,42,0,0,42
Listas,2014EP,05-122-001,201,86,0,86,0,0,86
Listas,2014EP,05-123-001,605,146,0,146,0,0,146
Listas,2014EP,05-123-002,610,137,0,137,0,0,137
Listas,2014EP,05-124-001,868,241,0,241,0,2,239
Listas,2014EP,05-125-001,265,97,0,97,0,0,97
Listas,2014EP,05-126-001,895,135,0,135,0,0,135
Listas,2014EP,05-127-001,531,216,0,216,0,0,216
Listas,2014EP,05-128-001,573,203,0,203,0,2,201
Listas,2014EP,05-129-001,121,42,0,42,0,0,42
Listas,2014EP,05-130-001,177,51,0,51,0,1,50
Listas,2014EP,05-131-001,111,33,0,33,0,0,33
Listas,2014EP,05-131-002,1158,323,0,323,0,2,321
Listas,2014EP,05-132-001,268,81,0,81,0,4,77
Listas,2014EP,05-133-001,905,209,0,209,0,1,208
Listas,2014EP,05-133-002,899,220,0,220,0,2,218
Listas,2014EP,05-133-003,914,191,0,191,0,1,190
Listas,2014EP,05-134-001,162,42,0,42,0,1,41
Listas,2014EP,05-135-001,317,72,0,72,0,0,72
Listas,2014EP,05-136-001,151,52,0,52,0,1,51
Listas,2014EP,05-137-001,654,127,0,127,0,0,127
Listas,2014EP,05-138-001,431,85,0,85,0,0,85
Listas,2014EP,05-139-001,831,221,0,221,0,0,221
Listas,2014EP,05-140-001,514,137,0,137,0,3,134
Listas,2014EP,05-141-001,807,172,0,172,0,0,172
Listas,2014EP,05-142-001,756,139,0,139,0,2,137
Listas,2014EP,05-143-001,958,145,0,145,0,0,145
Listas,2014EP,05-144-001,84,52,0,52,0,0,52
Listas,2014EP,05-145-001,969,260,0,260,0,3,257
Listas,2014EP,05-146-001,69,42,0,42,0,0,42
Listas,2014EP,05-147-001,681,167,0,167,0,0,167
Listas,2014EP,05-147-002,653,113,0,113,0,0,113
Listas,2014EP,05-148-001,398,111,0,111,0,0,111
Listas,2014EP,05-149-001,770,168,0,168,0,1,167
Listas,2014EP,05-149-002,631,131,0,131,0,1,130
Listas,2014EP,05-150-001,263,70,0,70,0,0,70
Listas,2014EP,05-151-001,721,89,0,89,0,0,89
Listas,2014EP,05-151-002,746,121,0,121,0,0,121
Listas,2014EP,05-152-001,393,93,0,93,0,0,93
Listas,2014EP,05-153-001,747,244,0,244,0,1,243
Listas,2014EP,05-153-002,728,228,0,228,0,0,228
Listas,2014EP,05-153-003,792,149,0,149,0,0,149
Listas,2014EP,05-153-004,672,151,0,151,0,1,150
Listas,2014EP,05-153-005,1027,351,1,350,-1,0,350
Listas,2014EP,05-153-006,773,220,0,220,0,0,220
Listas,2014EP,05-153-007,750,125,0,125,0,1,124
Listas,2014EP,05-153-008,783,82,0,82,0,1,81
Listas,2014EP,05-153-009,823,124,0,124,0,1,123
Listas,2014EP,05-153-010,1025,196,0,196,0,0,196
Listas,2014EP,05-153-011,655,190,1,189,-1,0,189
Listas,2014EP,05-153-012,602,153,0,153,0,0,153
Listas,2014EP,05-153-013,871,270,0,270,0,1,269
Listas,2014EP,05-153-014,615,190,0,190,0,0,190
Listas,2014EP,05-153-015,842,222,0,221,-1,0,221
Listas,2014EP,05-153-016,1071,218,0,218,0,0,218
Listas,2014EP,05-153-017,831,211,0,211,0,0,211
Listas,2014EP,05-153-018,997,215,0,215,0,0,215
Listas,2014EP,05-153-019,938,223,0,223,0,0,223
Listas,2014EP,05-153-020,839,226,0,226,0,1,225
Listas,2014EP,05-153-021,650,140,0,140,0,0,140
Listas,2014EP,05-153-022,598,136,0,136,0,0,136
Listas,2014EP,05-153-023,1061,200,0,200,0,1,199
Listas,2014EP,05-153-024,1008,221,0,221,0,8,213
Listas,2014EP,05-153-025,908,219,0,218,-1,1,217
Listas,2014EP,05-153-026,792,163,0,163,0,0,163
Listas,2014EP,05-153-027,642,154,0,154,0,1,153
Listas,2014EP,05-153-028,690,174,0,174,0,1,173
Listas,2014EP,05-153-029,760,154,0,154,0,0,154
Listas,2014EP,05-153-030,854,171,0,171,0,1,170
Listas,2014EP,05-154-001,460,180,0,180,0,1,179
Listas,2014EP,05-155-001,147,51,0,51,0,0,51
Listas,2014EP,05-156-001,54,22,0,22,0,0,22
Listas,2014EP,05-157-001,698,122,0,122,0,1,121
Listas,2014EP,05-158-001,370,121,0,121,0,3,118
Listas,2014EP,05-159-001,996,209,0,209,0,1,208
Listas,2014EP,05-160-001,45,20,0,20,0,0,20
Listas,2014EP,05-161-001,642,178,0,178,0,0,178
Listas,2014EP,05-161-002,669,148,0,148,0,2,146
Listas,2014EP,05-162-001,170,54,0,54,0,0,54
Listas,2014EP,05-163-001,146,39,0,39,0,0,39
Listas,2014EP,05-163-002,577,76,0,76,0,0,76
Listas,2014EP,05-164-001,137,44,0,44,0,0,44
Listas,2014EP,05-165-001,678,180,0,180,0,0,180
Listas,2014EP,05-165-002,622,132,0,132,0,1,131
Listas,2014EP,05-166-001,295,82,0,82,0,2,80
Listas,2014EP,05-167-001,278,89,0,89,0,0,89
Listas,2014EP,05-168-001,144,40,0,40,0,0,40
Listas,2014EP,05-169-001,271,107,0,107,0,0,107
Listas,2014EP,05-170-001,858,231,0,231,0,1,230
Listas,2014EP,05-170-002,894,172,0,172,0,0,172
Listas,2014EP,05-171-001,213,94,0,94,0,1,93
Listas,2014EP,05-172-001,236,107,0,107,0,1,106
Listas,2014EP,05-173-001,501,121,0,121,0,0,121
Listas,2014EP,05-174-001,252,68,0,68,0,1,67
Listas,2014EP,05-175-001,475,46,0,46,0,1,45
Listas,2014EP,05-176-001,863,346,0,346,0,5,341
Listas,2014EP,05-177-001,381,65,0,65,0,1,64
Listas,2014EP,05-178-001,137,60,0,60,0,2,58
Listas,2014EP,05-179-001,560,103,0,103,0,1,102
Listas,2014EP,05-179-002,777,183,0,183,0,0,183
Listas,2014EP,05-180-001,458,199,0,199,0,0,199
Listas,2014EP,05-181-001,231,54,0,54,0,0,54
Listas,2014EP,05-182-001,222,79,0,79,0,0,79
Listas,2014EP,05-183-001,596,96,0,96,0,3,93
Listas,2014EP,05-183-002,658,108,0,108,0,1,107
Listas,2014EP,05-184-001,367,76,0,76,0,2,74
Listas,2014EP,05-185-001,255,74,0,74,0,1,73
Listas,2014EP,05-186-001,40,18,0,18,0,0,18
Listas,2014EP,05-187-001,735,102,0,102,0,0,102
Listas,2014EP,05-188-001,347,108,0,108,0,0,108
Listas,2014EP,05-189-001,647,115,0,115,0,0,115
Listas,2014EP,05-189-002,634,146,0,146,0,1,145
Listas,2014EP,05-189-003,662,173,0,173,0,5,168
Listas,2014EP,05-190-001,771,199,0,199,0,0,199
Listas,2014EP,05-190-002,728,176,0,176,0,0,176
Listas,2014EP,05-190-003,726,203,0,203,0,1,202
Listas,2014EP,05-190-004,681,180,0,180,0,0,180
Listas,2014EP,05-190-005,684,201,0,201,0,2,199
Listas,2014EP,05-191-001,426,115,0,115,0,0,115
Listas,2014EP,05-192-001,666,63,0,63,0,0,63
Listas,2014EP,05-192-002,623,113,0,113,0,0,113
Listas,2014EP,05-192-003,702,150,0,150,0,0,150
Listas,2014EP,05-193-001,165,68,0,68,0,1,67
Listas,2014EP,05-194-001,980,186,0,186,0,2,184
Listas,2014EP,05-194-002,923,204,0,204,0,0,204
Listas,2014EP,05-194-003,1021,212,0,212,0,1,211
Listas,2014EP,05-194-004,876,168,0,168,0,3,165
Listas,2014EP,05-194-005,986,211,0,211,0,1,210
Listas,2014EP,05-195-001,687,145,0,145,0,0,145
Listas,2014EP,05-195-002,609,168,0,168,0,0,168
Listas,2014EP,05-195-003,616,158,0,158,0,0,158
Listas,2014EP,05-195-004,625,139,0,139,0,1,138
Listas,2014EP,05-195-005,652,135,0,135,0,1,134
Listas,2014EP,05-196-001,982,355,0,355,0,1,354
Listas,2014EP,05-196-002,922,297,0,297,0,0,297
Listas,2014EP,05-196-003,795,298,0,298,0,0,298
Listas,2014EP,05-196-004,1010,334,0,334,0,1,333
Listas,2014EP,05-196-005,899,185,0,185,0,1,184
Listas,2014EP,05-196-006,823,260,0,260,0,2,258
Listas,2014EP,05-196-007,816,259,0,259,0,0,259
Listas,2014EP,05-196-008,848,299,0,299,0,1,298
Listas,2014EP,05-196-009,783,287,0,287,0,2,285
Listas,2014EP,05-196-010,1049,379,0,379,0,2,377
Listas,2014EP,05-196-011,898,249,0,249,0,2,247
Listas,2014EP,05-196-012,728,255,0,255,0,0,255
Listas,2014EP,05-196-013,850,289,0,288,-1,0,288
Listas,2014EP,05-196-014,688,240,0,240,0,0,240
Listas,2014EP,05-196-015,870,326,0,326,0,0,326
Listas,2014EP,05-196-016,784,265,0,265,0,0,265
Listas,2014EP,05-197-001,887,247,0,247,0,3,244
Listas,2014EP,05-198-001,716,172,0,172,0,1,171
Listas,2014EP,05-198-002,641,154,0,154,0,0,154
Listas,2014EP,05-199-001,979,163,0,163,0,0,163
Listas,2014EP,05-199-002,854,108,0,108,0,2,106
Listas,2014EP,05-200-001,645,117,0,117,0,0,117
Listas,2014EP,05-200-002,658,113,0,113,0,0,113
Listas,2014EP,05-201-001,455,140,0,140,0,2,138
Listas,2014EP,05-202-001,676,95,0,95,0,0,95
Listas,2014EP,05-202-002,747,136,0,136,0,1,135
Listas,2014EP,05-202-003,595,245,0,245,0,0,245
Listas,2014EP,05-202-004,578,189,0,189,0,0,189
Listas,2014EP,05-202-005,688,216,0,216,0,0,216
Listas,2014EP,05-202-006,617,219,0,219,0,0,219
Listas,2014EP,05-202-007,722,278,0,278,0,1,277
Listas,2014EP,05-202-008,884,285,0,285,0,0,285
Listas,2014EP,05-202-009,822,199,0,199,0,0,199
Listas,2014EP,05-202-010,750,268,0,268,0,0,268
Listas,2014EP,05-202-011,962,291,0,291,0,1,290
Listas,2014EP,05-202-012,722,196,0,196,0,1,195
Listas,2014EP,05-202-013,776,221,0,221,0,0,221
Listas,2014EP,05-202-014,817,278,0,278,0,0,278
Listas,2014EP,05-202-015,970,332,0,332,0,1,331
Listas,2014EP,05-202-016,1077,308,0,308,0,1,307
Listas,2014EP,05-202-017,1149,413,0,413,0,3,410
Listas,2014EP,05-202-018,1132,368,0,368,0,2,366
Listas,2014EP,05-202-019,645,131,0,131,0,2,129
Listas,2014EP,05-202-020,968,284,0,283,-1,0,283
Listas,2014EP,05-202-021,908,307,0,307,0,0,307
Listas,2014EP,05-202-022,818,275,0,275,0,0,275
Listas,2014EP,05-202-023,803,262,0,262,0,0,262
Listas,2014EP,05-202-024,890,300,0,300,0,0,300
Listas,2014EP,05-202-025,702,234,0,234,0,0,234
Listas,2014EP,05-202-026,1029,419,0,419,0,2,417
Listas,2014EP,05-202-027,963,364,0,364,0,1,363
Listas,2014EP,05-202-028,849,277,0,277,0,0,277
Listas,2014EP,05-202-029,704,273,0,273,0,1,272
Listas,2014EP,05-202-030,697,231,0,231,0,2,229
Listas,2014EP,05-202-031,730,211,0,211,0,1,210
Listas,2014EP,05-202-032,1003,340,0,340,0,1,339
Listas,2014EP,05-202-033,858,181,0,181,0,1,180
Listas,2014EP,05-202-034,975,208,0,208,0,1,207
Listas,2014EP,05-202-035,1033,215,0,215,0,0,215
Listas,2014EP,05-202-036,1029,257,0,257,0,1,256
Listas,2014EP,05-202-037,878,223,0,223,0,0,223
Listas,2014EP,05-202-038,975,244,0,244,0,1,243
Listas,2014EP,05-202-039,1026,229,0,229,0,0,229
Listas,2014EP,05-202-040,981,218,0,218,0,0,218
Listas,2014EP,05-202-041,792,147,0,147,0,0,147
Listas,2014EP,05-202-042,907,209,0,209,0,1,208
Listas,2014EP,05-202-043,886,175,0,175,0,1,174
Listas,2014EP,05-202-044,1005,205,0,205,0,0,205
Listas,2014EP,05-202-045,958,194,0,194,0,2,192
Listas,2014EP,05-202-046,1088,249,0,249,0,1,248
Listas,2014EP,05-202-047,1034,232,0,232,0,0,232
Listas,2014EP,05-202-048,893,221,0,221,0,0,221
Listas,2014EP,05-202-049,986,202,0,202,0,1,201
Listas,2014EP,05-202-050,821,241,0,241,0,1,240
Listas,2014EP,05-202-051,703,172,0,172,0,1,171
Listas,2014EP,05-202-052,695,163,1,162,-1,0,162
Listas,2014EP,05-202-053,948,279,0,278,-1,0,278
Listas,2014EP,05-202-054,991,272,0,272,0,1,271
Listas,2014EP,05-202-055,677,369,0,369,0,0,369
Listas,2014EP,05-202-056,625,314,0,314,0,0,314
Listas,2014EP,05-202-057,927,261,0,261,0,0,261
Listas,2014EP,05-202-058,731,181,0,181,0,2,179
Listas,2014EP,05-202-059,638,245,0,245,0,0,245
Listas,2014EP,05-202-060,798,419,0,419,0,2,417
Listas,2014EP,05-202-061,603,322,0,322,0,0,322
Listas,2014EP,05-202-062,848,344,1,343,-1,1,342
Listas,2014EP,05-202-063,721,214,0,214,0,0,214
Listas,2014EP,05-202-064,942,324,0,324,0,2,322
Listas,2014EP,05-202-065,617,170,0,170,0,0,170
Listas,2014EP,05-202-066,608,169,0,169,0,1,168
Listas,2014EP,05-202-067,705,186,0,186,0,0,186
Listas,2014EP,05-202-068,817,223,0,223,0,2,221
Listas,2014EP,05-202-069,1010,354,0,354,0,0,354
Listas,2014EP,05-202-070,1014,366,0,366,0,0,366
Listas,2014EP,05-202-071,659,186,0,186,0,0,186
Listas,2014EP,05-202-072,641,250,0,250,0,0,250
Listas,2014EP,05-202-073,769,274,0,274,0,1,273
Listas,2014EP,05-202-074,1043,214,0,214,0,1,213
Listas,2014EP,05-202-075,617,183,0,183,0,0,183
Listas,2014EP,05-202-076,848,266,0,266,0,1,265
Listas,2014EP,05-202-077,757,216,0,216,0,0,216
Listas,2014EP,05-202-078,643,251,0,251,0,2,249
Listas,2014EP,05-202-079,592,188,0,188,0,1,187
Listas,2014EP,05-202-080,912,262,0,262,0,0,262
Listas,2014EP,05-202-081,963,290,0,290,0,1,289
Listas,2014EP,05-202-082,934,347,0,347,0,3,344
Listas,2014EP,05-202-083,722,331,0,331,0,3,328
Listas,2014EP,05-202-084,818,287,0,287,0,0,287
Listas,2014EP,05-202-085,733,243,0,243,0,1,242
Listas,2014EP,05-202-086,1033,382,0,382,0,1,381
Listas,2014EP,05-202-087,618,169,0,169,0,0,169
Listas,2014EP,05-202-088,745,262,0,262,0,1,261
Listas,2014EP,05-202-089,842,296,0,296,0,1,295
Listas,2014EP,05-202-090,707,128,0,128,0,0,128
Listas,2014EP,05-202-091,1064,378,0,378,0,1,377
Listas,2014EP,05-202-092,669,127,0,127,0,0,127
Listas,2014EP,05-202-093,639,218,0,218,0,0,218
Listas,2014EP,05-202-094,666,133,0,133,0,3,130
Listas,2014EP,05-202-095,616,145,0,145,0,0,145
Listas,2014EP,05-202-096,1554,628,0,628,0,4,624
Listas,2014EP,05-202-097,704,223,0,223,0,0,223
Listas,2014EP,05-202-098,748,233,0,233,0,0,233
Listas,2014EP,05-202-099,673,233,0,233,0,0,233
Listas,2014EP,05-202-100,655,168,0,168,0,1,167
Listas,2014EP,05-202-101,925,276,0,276,0,0,276
Listas,2014EP,05-202-102,739,228,0,228,0,1,227
Listas,2014EP,05-202-103,959,288,0,288,0,1,287
Listas,2014EP,05-202-104,1000,348,0,348,0,2,346
Listas,2014EP,05-202-105,679,199,0,199,0,0,199
Listas,2014EP,05-202-106,1125,407,0,407,0,1,406
Listas,2014EP,05-202-107,950,298,0,298,0,1,297
Listas,2014EP,05-202-108,1037,283,0,282,-1,0,282
Listas,2014EP,05-202-109,661,156,0,156,0,0,156
Listas,2014EP,05-202-110,691,213,0,213,0,0,213
Listas,2014EP,05-202-111,1055,374,0,374,0,1,373
Listas,2014EP,05-202-112,605,242,0,242,0,0,242
Listas,2014EP,05-202-113,596,205,0,205,0,1,204
Listas,2014EP,05-202-114,614,203,0,203,0,1,202
Listas,2014EP,05-202-115,802,262,0,262,0,1,261
Listas,2014EP,05-202-116,579,249,0,249,0,1,248
Listas,2014EP,05-202-117,1044,276,0,276,0,3,273
Listas,2014EP,05-202-118,1093,99,0,99,0,0,99
Listas,2014EP,05-202-119,825,230,0,230,0,2,228
Listas,2014EP,05-202-120,988,204,0,204,0,1,203
Listas,2014EP,05-202-121,804,271,0,271,0,0,271
Listas,2014EP,05-202-122,752,262,0,262,0,1,261
Listas,2014EP,05-202-123,896,159,0,159,0,0,159
Listas,2014EP,05-202-124,1002,262,0,262,0,1,261
Listas,2014EP,05-202-125,1011,349,0,349,0,1,348
Listas,2014EP,05-202-126,1129,339,0,339,0,0,339
Listas,2014EP,05-202-127,1092,184,0,184,0,1,183
Listas,2014EP,05-202-128,1025,175,0,175,0,1,174
Listas,2014EP,05-202-129,500,152,0,152,0,1,151
Listas,2014EP,05-202-130,673,171,0,171,0,2,169
Listas,2014EP,05-202-131,794,332,0,332,0,0,332
Listas,2014EP,05-202-132,629,233,0,233,0,1,232
Listas,2014EP,05-202-133,1058,295,0,295,0,1,294
Listas,2014EP,05-202-134,891,337,0,337,0,3,334
Listas,2014EP,05-202-135,817,344,0,344,0,2,342
Listas,2014EP,05-202-136,937,362,0,362,0,1,361
Listas,2014EP,05-202-137,876,369,0,369,0,0,369
Listas,2014EP,05-202-138,941,309,0,309,0,0,309
Listas,2014EP,05-202-139,647,148,0,148,0,1,147
Listas,2014EP,05-202-140,695,159,0,159,0,0,159
Listas,2014EP,05-202-141,654,186,0,186,0,0,186
Listas,2014EP,05-202-142,863,179,0,179,0,0,179
Listas,2014EP,05-202-143,773,205,0,205,0,0,205
Listas,2014EP,05-202-144,670,212,0,212,0,0,212
Listas,2014EP,05-202-145,731,254,0,254,0,0,254
Listas,2014EP,05-202-146,1143,337,0,337,0,1,336
Listas,2014EP,05-202-147,1062,309,0,309,0,4,305
Listas,2014EP,05-202-148,1089,369,0,369,0,1,368
Listas,2014EP,05-202-149,1058,267,0,267,0,0,267
Listas,2014EP,05-202-150,793,202,0,202,0,0,202
Listas,2014EP,05-202-151,773,246,0,246,0,0,246
Listas,2014EP,05-202-152,912,283,0,283,0,1,282
Listas,2014EP,05-202-153,759,243,0,243,0,0,243
Listas,2014EP,05-202-154,956,333,0,333,0,0,333
Listas,2014EP,05-202-155,437,158,0,158,0,0,158
Listas,2014EP,05-202-156,628,176,0,176,0,0,176
Listas,2014EP,05-202-157,779,230,0,230,0,1,229
Listas,2014EP,05-202-158,896,342,0,342,0,3,339
Listas,2014EP,05-202-159,1005,291,0,291,0,0,291
Listas,2014EP,05-202-160,157,70,0,70,0,2,68
Listas,2014EP,05-203-001,74,46,0,46,0,0,46
Listas,2014EP,05-204-001,187,26,0,26,0,0,26
Listas,2014EP,05-205-001,628,166,0,166,0,0,166
Listas,2014EP,05-205-002,641,200,0,200,0,0,200
Listas,2014EP,05-206-001,428,147,0,147,0,2,145
Listas,2014EP,05-207-001,915,253,0,253,0,1,252
Listas,2014EP,05-207-002,776,137,0,137,0,3,134
Listas,2014EP,05-207-003,885,163,0,163,0,0,163
Listas,2014EP,05-208-001,699,137,0,137,0,2,135
Listas,2014EP,05-209-001,620,175,0,175,0,0,175
Listas,2014EP,05-210-001,70,29,0,29,0,1,28
Listas,2014EP,05-211-001,275,66,0,66,0,0,66
Listas,2014EP,05-212-001,581,82,0,82,0,0,82
Listas,2014EP,05-213-001,662,144,0,144,0,0,144
Listas,2014EP,05-214-001,741,160,0,160,0,1,159
Listas,2014EP,05-215-001,247,81,0,81,0,0,81
Listas,2014EP,05-216-001,1086,169,0,169,0,0,169
Listas,2014EP,05-217-001,910,279,0,279,0,0,279
Listas,2014EP,05-217-002,808,222,0,222,0,0,222
Listas,2014EP,05-217-003,829,185,0,185,0,0,185
Listas,2014EP,05-217-004,810,233,0,233,0,1,232
Listas,2014EP,05-217-005,906,202,0,202,0,1,201
Listas,2014EP,05-218-001,43,23,0,23,0,0,23
Listas,2014EP,05-219-001,336,96,0,96,0,1,95
Listas,2014EP,05-220-001,272,79,0,79,0,0,79
Listas,2014EP,05-221-001,624,179,0,179,0,2,177
Listas,2014EP,05-221-002,661,88,0,88,0,2,86
Listas,2014EP,05-222-001,728,169,0,169,0,1,168
Listas,2014EP,05-222-002,823,134,0,134,0,1,133
Listas,2014EP,05-222-003,951,249,0,249,0,0,249
Listas,2014EP,05-222-004,946,254,0,254,0,1,253
Listas,2014EP,05-222-005,181,37,0,37,0,0,37
Listas,2014EP,05-222-006,98,33,0,33,0,2,31
Listas,2014EP,05-223-001,629,98,0,98,0,1,97
Listas,2014EP,05-223-002,651,149,0,148,-1,1,147
Listas,2014EP,05-224-001,326,77,0,77,0,1,76
Listas,2014EP,05-225-001,922,210,0,210,0,0,210
Listas,2014EP,05-225-002,956,241,0,241,0,2,239
Listas,2014EP,05-226-001,724,149,0,149,0,0,149
Listas,2014EP,05-226-002,933,247,0,247,0,1,246
Listas,2014EP,05-226-003,926,197,0,197,0,1,196
Listas,2014EP,05-226-004,1087,243,0,243,0,0,243
Listas,2014EP,05-226-005,934,203,0,203,0,0,203
Listas,2014EP,05-226-006,1331,313,0,313,0,0,313
Listas,2014EP,05-226-007,885,192,0,192,0,0,192
Listas,2014EP,05-226-008,760,132,0,132,0,0,132
Listas,2014EP,05-226-009,670,201,0,201,0,1,200
Listas,2014EP,05-226-010,749,137,0,137,0,0,137
Listas,2014EP,05-226-011,971,218,0,218,0,3,215
Listas,2014EP,05-226-012,994,247,0,247,0,0,247
Listas,2014EP,05-226-013,890,235,0,235,0,0,235
Listas,2014EP,05-226-014,819,151,0,151,0,1,150
Listas,2014EP,05-226-015,818,230,0,230,0,0,230
Listas,2014EP,05-226-016,756,268,0,268,0,0,268
Listas,2014EP,05-226-017,709,197,0,197,0,1,196
Listas,2014EP,05-226-018,346,87,0,87,0,0,87
Listas,2014EP,05-226-019,700,123,0,123,0,0,123
Listas,2014EP,05-226-020,781,147,0,147,0,0,147
Listas,2014EP,05-226-021,452,110,0,110,0,0,110
Listas,2014EP,05-226-022,206,94,0,94,0,1,93
Listas,2014EP,05-226-023,847,193,0,193,0,1,192
Listas,2014EP,05-226-024,875,165,0,165,0,0,165
Listas,2014EP,05-226-025,858,125,0,125,0,3,122
Listas,2014EP,05-226-026,770,141,0,141,0,2,139
Listas,2014EP,05-226-027,714,110,0,110,0,0,110
Listas,2014EP,05-226-028,779,144,0,144,0,0,144
Listas,2014EP,05-226-029,233,42,0,42,0,2,40
Listas,2014EP,05-226-030,215,46,0,46,0,1,45
Listas,2014EP,05-226-031,890,153,0,153,0,0,153
Listas,2014EP,05-226-032,1006,194,0,194,0,0,194
Listas,2014EP,05-226-033,999,259,0,259,0,0,259
Listas,2014EP,05-226-034,865,147,0,147,0,1,146
Listas,2014EP,05-226-035,1010,140,0,140,0,1,139
Listas,2014EP,05-226-036,498,63,0,63,0,0,63
Listas,2014EP,05-226-037,293,46,0,46,0,0,46
Listas,2014EP,05-227-001,39,9,0,9,0,0,9
Listas,2014EP,05-228-001,991,181,0,181,0,1,180
Listas,2014EP,05-229-001,1145,173,0,173,0,0,173
Listas,2014EP,05-230-001,942,254,0,254,0,0,254
Listas,2014EP,05-231-001,63,25,0,25,0,0,25
Listas,2014EP,05-232-001,270,71,0,71,0,2,69
Listas,2014EP,05-233-001,29,20,0,20,0,0,20
Listas,2014EP,05-234-001,708,168,0,168,0,1,167
Listas,2014EP,05-235-001,941,198,0,198,0,4,194
Listas,2014EP,05-235-002,952,215,0,215,0,4,211
Listas,2014EP,05-236-001,188,72,0,72,0,0,72
Listas,2014EP,05-237-001,163,41,0,41,0,0,41
Listas,2014EP,05-238-001,855,251,0,251,0,5,246
Listas,2014EP,05-238-002,669,155,0,155,0,5,150
Listas,2014EP,05-238-003,553,193,0,193,0,1,192
Listas,2014EP,05-238-004,716,217,0,217,0,2,215
Listas,2014EP,05-238-005,669,169,0,169,0,3,166
Listas,2014EP,05-238-006,824,293,0,293,0,2,291
Listas,2014EP,05-238-007,597,220,0,220,0,4,216
Listas,2014EP,05-238-008,307,90,0,90,0,0,90
Listas,2014EP,05-239-001,515,114,0,114,0,0,114
Listas,2014EP,05-240-001,550,85,0,85,0,0,85
Listas,2014EP,05-241-001,584,104,0,104,0,1,103
Listas,2014EP,05-242-001,283,85,0,85,0,0,85
Listas,2014EP,05-243-001,439,90,0,90,0,0,90
Listas,2014EP,05-244-001,816,211,0,211,0,0,211
Listas,2014EP,05-245-001,84,45,0,45,0,0,45
Listas,2014EP,05-246-001,416,161,0,161,0,0,161
Listas,2014EP,05-247-001,408,73,0,73,0,1,72
Listas,2014EP,05-248-001,636,141,0,141,0,1,140
Listas,2014EP,05-248-002,656,130,0,130,0,2,128
Listas,2014EP,05-249-001,757,133,0,133,0,0,133
Listas,2014EP,05-249-002,738,135,0,135,0,1,134
Listas,2014EP,05-249-003,607,133,0,133,0,0,133
Listas,2014EP,05-250-001,603,85,0,85,0,0,85
Listas,2014EP,05-251-001,802,252,0,252,0,0,252
Listas,2014EP,05-251-002,684,187,0,187,0,4,183
Listas,2014EP,05-251-003,769,207,0,207,0,0,207
Listas,2014EP,05-252-001,923,264,0,264,0,0,264
Listas,2014EP,05-253-001,292,87,0,87,0,1,86
Listas,2014EP,05-254-001,781,182,0,182,0,1,181
Listas,2014EP,05-255-001,527,147,0,147,0,1,146
Listas,2014EP,05-256-001,811,120,0,120,0,1,119
Listas,2014EP,05-256-002,600,109,0,109,0,0,109
Listas,2014EP,05-256-003,829,129,0,129,0,0,129
Listas,2014EP,05-257-001,335,72,0,72,0,1,71
Listas,2014EP,05-258-001,1271,352,0,352,0,14,338
Listas,2014EP,05-259-001,1160,320,0,320,0,0,320
Listas,2014EP,05-259-002,1203,256,0,256,0,2,254
Listas,2014EP,05-260-001,354,77,0,77,0,1,76
Listas,2014EP,05-261-001,194,58,0,58,0,1,57
Listas,2014EP,05-262-001,388,70,0,70,0,2,68
Listas,2014EP,05-263-001,1057,292,0,292,0,1,291
Listas,2014EP,05-264-001,640,180,0,180,0,1,179
Listas,2014EP,05-265-001,1149,200,0,200,0,1,199
Listas,2014EP,05-266-001,412,92,0,92,0,1,91
Listas,2014EP,05-267-001,336,109,0,109,0,1,108
Listas,2014EP,05-268-001,1163,297,0,297,0,1,296
Listas,2014EP,05-268-002,710,111,0,111,0,0,111
Listas,2014EP,05-268-003,713,169,0,169,0,2,167
Listas,2014EP,05-268-004,1197,288,0,288,0,2,286
Listas,2014EP,05-268-005,1037,56,0,56,0,0,56
Listas,2014EP,05-268-006,310,92,0,92,0,1,91
Listas,2014EP,05-268-007,1100,287,0,287,0,0,287
Listas,2014EP,05-268-008,1156,259,0,259,0,0,259
Listas,2014EP,05-268-009,1337,275,0,275,0,0,275
Listas,2014EP,05-268-010,1380,271,0,271,0,1,270
Listas,2014EP,05-269-001,890,240,0,240,0,0,240
Listas,2014EP,05-269-002,998,252,0,252,0,1,251
Listas,2014EP,05-270-001,909,211,0,211,0,0,211
Listas,2014EP,05-270-002,885,155,0,155,0,0,155
Listas,2014EP,05-271-001,650,153,0,153,0,1,152
Listas,2014EP,05-272-001,599,166,0,166,0,1,165
Listas,2014EP,05-272-002,727,173,0,173,0,0,173
Listas,2014EP,05-273-001,216,85,0,85,0,0,85
Listas,2014EP,05-274-001,760,238,0,238,0,2,236
Listas,2014EP,05-274-002,693,208,0,208,0,1,207
Listas,2014EP,05-274-003,704,208,0,208,0,1,207
Listas,2014EP,05-274-004,636,173,0,173,0,0,173
Listas,2014EP,05-274-005,749,194,0,194,0,1,193
Listas,2014EP,05-274-006,791,253,0,253,0,0,253
Listas,2014EP,05-274-007,779,183,0,183,0,1,182
Listas,2014EP,05-274-008,792,162,0,162,0,0,162
Listas,2014EP,05-274-009,625,195,0,195,0,0,195
Listas,2014EP,05-274-010,749,198,0,198,0,1,197
Listas,2014EP,05-274-011,731,172,0,172,0,1,171
Listas,2014EP,05-274-012,766,186,0,186,0,2,184
Listas,2014EP,05-274-013,455,107,0,107,0,0,107
Listas,2014EP,05-274-014,631,125,0,125,0,0,125
Listas,2014EP,05-274-015,209,29,0,29,0,0,29
Listas,2014EP,05-274-016,295,54,0,54,0,0,54
Listas,2014EP,05-274-017,132,37,0,37,0,0,37
Listas,2014EP,05-275-001,966,142,0,142,0,0,142
Listas,2014EP,05-276-001,473,126,0,126,0,0,126
Listas,2014EP,05-276-002,634,140,0,140,0,2,138
Listas,2014EP,05-276-003,594,130,0,130,0,1,129
Listas,2014EP,05-276-004,239,57,0,57,0,0,57
Listas,2014EP,05-276-005,698,260,0,260,0,1,259
Listas,2014EP,05-276-006,718,138,0,138,0,0,138
Listas,2014EP,05-276-007,825,219,0,219,0,1,218
Listas,2014EP,05-276-008,691,106,0,106,0,2,104
Listas,2014EP,05-276-009,900,276,0,275,-1,8,267
Listas,2014EP,05-276-010,865,266,0,266,0,0,266
Listas,2014EP,05-276-011,705,192,0,192,0,2,190
Listas,2014EP,05-276-012,811,202,0,202,0,3,199
Listas,2014EP,05-276-013,764,223,0,223,0,1,222
Listas,2014EP,05-276-014,772,208,0,208,0,0,208
Listas,2014EP,05-276-015,789,193,0,193,0,0,193
Listas,2014EP,05-276-016,732,237,0,237,0,1,236
Listas,2014EP,05-276-017,693,186,0,186,0,0,186
Listas,2014EP,05-276-018,557,131,0,131,0,0,131
Listas,2014EP,05-276-019,279,119,0,119,0,0,119
Listas,2014EP,05-277-001,342,83,0,83,0,1,82
Listas,2014EP,05-278-001,374,41,0,41,0,0,41
Listas,2014EP,05-279-001,814,125,0,125,0,0,125
Listas,2014EP,05-280-001,29,18,0,18,0,0,18
Listas,2014EP,05-281-001,204,100,0,100,0,1,99
Listas,2014EP,05-282-001,87,46,0,46,0,0,46
Listas,2014EP,05-283-001,393,94,0,94,0,2,92
Listas,2014EP,05-284-001,810,97,0,97,0,0,97
Listas,2014EP,05-285-001,752,117,0,117,0,0,117
Listas,2014EP,05-286-001,105,34,0,34,0,0,34
Listas,2014EP,05-287-001,252,70,0,70,0,1,69
Listas,2014EP,05-288-001,204,69,0,69,0,1,68
Listas,2014EP,05-289-001,260,44,0,44,0,1,43
Listas,2014EP,05-290-001,781,136,0,136,0,0,136
Listas,2014EP,05-290-002,834,126,0,126,0,4,122
Listas,2014EP,05-290-003,705,184,0,184,0,0,184
Listas,2014EP,05-290-004,774,136,0,136,0,0,136
Listas,2014EP,05-291-001,1224,157,0,157,0,1,156
Listas,2014EP,05-292-001,656,202,0,202,0,0,202
Listas,2014EP,05-292-002,716,223,0,223,0,0,223
Listas,2014EP,05-292-003,676,238,0,238,0,1,237
Listas,2014EP,05-293-001,223,91,0,91,0,1,90
Listas,2014EP,05-294-001,850,282,0,282,0,4,278
Listas,2014EP,05-294-002,829,301,0,301,0,0,301
Listas,2014EP,05-294-003,831,317,0,317,0,0,317
Listas,2014EP,05-294-004,837,253,0,253,0,0,253
Listas,2014EP,05-294-005,772,187,0,187,0,2,185
Listas,2014EP,05-294-006,842,276,0,276,0,3,273
Listas,2014EP,05-294-007,889,283,0,283,0,2,281
Listas,2014EP,05-294-008,921,241,0,241,0,0,241
Listas,2014EP,05-294-009,593,157,0,157,0,0,157
Listas,2014EP,05-294-010,494,162,0,162,0,0,162
Listas,2014EP,05-295-001,628,185,0,185,0,3,182
Listas,2014EP,05-295-002,794,157,0,157,0,1,156
Listas,2014EP,05-295-003,700,233,0,233,0,0,233
Listas,2014EP,05-295-004,634,108,0,108,0,1,107
Listas,2014EP,05-295-005,635,175,0,175,0,0,175
Listas,2014EP,05-295-006,620,165,0,165,0,2,163
Listas,2014EP,05-295-007,642,148,0,148,0,1,147
Listas,2014EP,05-296-001,524,215,0,215,0,5,210
Listas,2014EP,05-297-001,191,62,0,62,0,1,61
Listas,2014EP,05-298-001,1028,267,0,267,0,0,267
Listas,2014EP,05-298-002,943,223,0,223,0,0,223
Listas,2014EP,05-298-003,902,228,0,228,0,1,227
Listas,2014EP,05-298-004,862,202,0,202,0,1,201
Listas,2014EP,05-299-001,1281,331,0,331,0,2,329
Listas,2014EP,05-300-001,596,163,0,163,0,1,162
Listas,2014EP,05-301-001,112,45,0,45,0,0,45
Listas,2014EP,05-302-001,149,48,0,48,0,0,48
Listas,2014EP,05-303-001,798,174,0,174,0,0,174
Listas,2014EP,05-304-001,923,199,0,199,0,0,199
Listas,2014EP,05-305-001,430,56,0,56,0,0,56
Listas,2014EP,05-306-001,891,214,0,214,0,0,214
Listas,2014EP,05-306-002,701,148,0,148,0,0,148
Listas,2014EP,05-306-003,592,109,0,109,0,0,109
Listas,2014EP,05-306-004,635,93,0,93,0,0,93
Listas,2014EP,05-307-001,868,185,0,185,0,2,183
Listas,2014EP,05-308-001,730,98,0,98,0,0,98
Listas,2014EP,05-308-002,733,101,0,101,0,0,101
Listas,2014EP,05-309-001,1208,224,0,224,0,1,223
Listas,2014EP,05-309-002,1165,219,0,219,0,1,218
Listas,2014EP,05-310-001,1065,304,0,304,0,1,303
Listas,2014EP,05-311-001,909,187,0,187,0,0,187
Listas,2014EP,05-312-001,891,151,0,151,0,0,151
Listas,2014EP,05-312-002,709,177,0,177,0,2,175
Listas,2014EP,05-313-001,510,139,0,139,0,4,135
Listas,2014EP,05-314-001,25,17,0,17,0,0,17
Listas,2014EP,05-315-001,1161,235,0,235,0,1,234
Listas,2014EP,05-316-001,315,141,0,141,0,0,141
Listas,2014EP,05-317-001,432,63,0,63,0,0,63
Listas,2014EP,05-318-001,368,119,0,119,0,0,119
Listas,2014EP,05-319-001,783,135,0,135,0,2,133
Listas,2014EP,05-319-002,861,63,0,63,0,1,62
Listas,2014EP,05-319-003,212,25,0,25,0,0,25
Listas,2014EP,05-320-001,763,160,0,160,0,0,160
Listas,2014EP,05-320-002,649,102,0,102,0,1,101
Listas,2014EP,05-320-003,696,143,0,143,0,2,141
Listas,2014EP,05-321-001,533,189,0,189,0,2,187
Listas,2014EP,05-322-001,795,102,0,101,-1,0,101
Listas,2014EP,05-322-002,948,202,0,202,0,0,202
Listas,2014EP,05-322-003,781,132,0,132,0,0,132
Listas,2014EP,05-322-004,746,72,0,72,0,0,72
Listas,2014EP,05-322-005,796,111,0,111,0,0,111
Listas,2014EP,05-323-001,1161,248,0,248,0,0,248
Listas,2014EP,05-324-001,182,71,0,71,0,0,71
Listas,2014EP,05-325-001,1043,194,0,194,0,1,193
Listas,2014EP,05-326-001,685,164,0,164,0,2,162
Listas,2014EP,05-326-002,731,119,0,119,0,0,119
Listas,2014EP,05-326-003,232,94,0,94,0,0,94
Listas,2014EP,05-326-004,914,214,0,214,0,0,214
Listas,2014EP,05-326-005,874,244,0,244,0,0,244
Listas,2014EP,05-326-006,879,342,0,342,0,2,340
Listas,2014EP,05-326-007,959,299,0,299,0,2,297
Listas,2014EP,05-326-008,974,328,0,328,0,1,327
Listas,2014EP,05-326-009,975,278,0,278,0,0,278
Listas,2014EP,05-326-010,799,223,0,223,0,0,223
Listas,2014EP,05-326-011,877,226,0,226,0,0,226
Listas,2014EP,05-326-012,906,237,0,237,0,0,237
Listas,2014EP,05-326-013,905,241,0,240,-1,1,239
Listas,2014EP,05-326-014,928,228,0,228,0,0,228
Listas,2014EP,05-326-015,898,228,0,228,0,0,228
Listas,2014EP,05-326-016,846,197,0,197,0,1,196
Listas,2014EP,05-326-017,1018,329,0,328,-1,1,327
Listas,2014EP,05-327-001,283,108,0,108,0,1,107
Listas,2014EP,05-328-001,577,173,0,173,0,4,169
Listas,2014EP,05-328-002,507,185,0,185,0,1,184
Listas,2014EP,05-328-003,682,228,0,228,0,0,228
Listas,2014EP,05-328-004,823,184,0,184,0,0,184
Listas,2014EP,05-328-005,772,172,0,172,0,1,171
Listas,2014EP,05-329-001,933,211,0,211,0,0,211
Listas,2014EP,05-329-002,577,129,0,129,0,0,129
Listas,2014EP,05-330-001,194,59,0,59,0,2,57
Listas,2014EP,05-331-001,23,13,0,13,0,0,13
Listas,2014EP,05-332-001,16,11,0,11,0,0,11
Listas,2014EP,05-333-001,342,133,0,133,0,0,133
Listas,2014EP,05-334-001,186,63,0,63,0,0,63
Listas,2014EP,05-335-001,169,58,0,58,0,0,58
Listas,2014EP,05-336-001,347,110,0,110,0,1,109
Listas,2014EP,05-337-001,201,76,0,76,0,0,76
Listas,2014EP,05-338-001,298,78,0,78,0,0,78
Listas,2014EP,05-339-001,681,102,0,102,0,1,101
Listas,2014EP,05-340-001,519,122,0,122,0,0,122
Listas,2014EP,05-341-001,1003,160,0,160,0,1,159
Listas,2014EP,05-342-001,958,219,0,219,0,0,219
Listas,2014EP,05-343-001,55,31,0,31,0,0,31
Listas,2014EP,05-344-001,735,237,0,237,0,2,235
Listas,2014EP,05-345-001,84,46,0,46,0,1,45
Listas,2014EP,05-346-001,658,186,0,186,0,1,185
Listas,2014EP,05-347-001,939,87,0,86,-1,1,85
Listas,2014EP,05-348-001,230,80,0,80,0,0,80
Listas,2014EP,05-349-001,518,75,0,75,0,0,75
Listas,2014EP,05-350-001,61,35,0,35,0,1,34
Listas,2014EP,05-351-001,639,123,0,123,0,0,123
Listas,2014EP,05-352-001,198,93,0,93,0,1,92
Listas,2014EP,05-353-001,347,53,0,53,0,1,52
Listas,2014EP,05-354-001,597,149,0,149,0,2,147
Listas,2014EP,05-355-001,296,75,0,75,0,0,75
Listas,2014EP,05-356-001,140,45,0,45,0,1,44
Listas,2014EP,05-357-001,487,123,0,123,0,0,123
Listas,2014EP,05-358-001,295,88,0,88,0,0,88
Listas,2014EP,06-001-001,1131,299,0,299,0,2,297
Listas,2014EP,06-001-002,1076,211,0,211,0,0,211
Listas,2014EP,06-001-003,987,199,0,199,0,1,198
Listas,2014EP,06-001-004,1164,209,0,209,0,4,205
Listas,2014EP,06-002-001,404,125,0,125,0,2,123
Listas,2014EP,06-003-001,825,190,0,190,0,0,190
Listas,2014EP,06-003-002,845,162,0,162,0,2,160
Listas,2014EP,06-003-003,863,164,0,164,0,0,164
Listas,2014EP,06-004-001,447,142,0,142,0,0,142
Listas,2014EP,06-005-001,802,150,0,150,0,0,150
Listas,2014EP,06-005-002,793,152,0,152,0,1,151
Listas,2014EP,06-005-003,772,152,0,152,0,0,152
Listas,2014EP,06-005-004,469,77,0,77,0,0,77
Listas,2014EP,06-005-005,495,74,0,74,0,1,73
Listas,2014EP,06-006-001,849,163,0,163,0,0,163
Listas,2014EP,06-006-002,783,153,0,153,0,3,150
Listas,2014EP,06-007-001,720,196,0,196,0,3,193
Listas,2014EP,06-007-002,785,180,0,180,0,0,180
Listas,2014EP,06-007-003,365,62,0,62,0,1,61
Listas,2014EP,06-007-004,410,75,0,75,0,1,74
Listas,2014EP,06-007-005,248,45,0,45,0,0,45
Listas,2014EP,06-007-006,290,39,0,39,0,0,39
Listas,2014EP,06-008-001,889,180,0,180,0,0,180
Listas,2014EP,06-008-002,885,181,0,181,0,3,178
Listas,2014EP,06-008-003,885,117,0,117,0,2,115
Listas,2014EP,06-009-001,374,106,0,106,0,0,106
Listas,2014EP,06-010-001,818,181,0,181,0,1,180
Listas,2014EP,06-010-002,827,163,0,163,0,2,161
Listas,2014EP,06-010-003,801,169,0,169,0,1,168
Listas,2014EP,06-011-001,736,116,0,116,0,1,115
Listas,2014EP,06-011-002,765,123,0,123,0,2,121
Listas,2014EP,06-011-003,763,97,0,97,0,1,96
Listas,2014EP,06-012-001,835,213,0,213,0,1,212
Listas,2014EP,06-012-002,743,107,0,107,0,0,107
Listas,2014EP,06-013-001,1012,229,0,229,0,1,228
Listas,2014EP,06-013-002,820,219,0,219,0,2,217
Listas,2014EP,06-013-003,814,276,0,276,0,1,275
Listas,2014EP,06-013-004,962,226,0,226,0,3,223
Listas,2014EP,06-013-005,817,190,0,190,0,0,190
Listas,2014EP,06-013-006,957,185,0,185,0,0,185
Listas,2014EP,06-013-007,870,264,0,264,0,1,263
Listas,2014EP,06-013-008,1080,400,0,400,0,0,400
Listas,2014EP,06-013-009,844,271,0,271,0,0,271
Listas,2014EP,06-013-010,1025,277,0,277,0,1,276
Listas,2014EP,06-013-011,809,240,0,240,0,1,239
Listas,2014EP,06-013-012,841,254,0,254,0,0,254
Listas,2014EP,06-013-013,985,314,0,314,0,0,314
Listas,2014EP,06-013-014,920,289,0,289,0,0,289
Listas,2014EP,06-013-015,490,87,0,87,0,1,86
Listas,2014EP,06-013-016,789,190,0,190,0,3,187
Listas,2014EP,06-014-001,444,112,0,112,0,2,110
Listas,2014EP,06-014-002,617,136,0,136,0,3,133
Listas,2014EP,06-014-003,192,43,0,43,0,0,43
Listas,2014EP,06-015-001,909,250,0,250,0,2,248
Listas,2014EP,06-015-002,624,161,0,161,0,2,159
Listas,2014EP,06-015-003,704,192,0,192,0,2,190
Listas,2014EP,06-015-004,702,185,0,185,0,0,185
Listas,2014EP,06-016-001,884,197,0,197,0,1,196
Listas,2014EP,06-016-002,1012,238,0,238,0,1,237
Listas,2014EP,06-016-003,908,217,0,217,0,2,215
Listas,2014EP,06-016-004,1078,235,0,235,0,1,234
Listas,2014EP,06-017-001,462,111,0,111,0,0,111
Listas,2014EP,06-017-002,156,33,0,33,0,0,33
Listas,2014EP,06-018-001,467,98,0,98,0,1,97
Listas,2014EP,06-019-001,617,120,0,120,0,0,120
Listas,2014EP,06-019-002,570,135,0,135,0,1,134
Listas,2014EP,06-019-003,543,123,0,123,0,1,122
Listas,2014EP,06-020-001,594,157,0,157,0,1,156
Listas,2014EP,06-020-002,454,114,0,114,0,1,113
Listas,2014EP,06-021-001,567,143,0,143,0,0,143
Listas,2014EP,06-022-001,839,215,0,215,0,0,215
Listas,2014EP,06-022-002,880,184,0,184,0,0,184
Listas,2014EP,06-023-001,931,170,0,170,0,1,169
Listas,2014EP,06-023-002,863,161,0,161,0,4,157
Listas,2014EP,06-023-003,780,128,0,128,0,0,128
Listas,2014EP,06-024-001,802,260,0,259,-1,1,258
Listas,2014EP,06-024-002,737,180,0,180,0,0,180
Listas,2014EP,06-024-003,824,242,0,242,0,0,242
Listas,2014EP,06-024-004,893,256,0,256,0,2,254
Listas,2014EP,06-024-005,724,245,0,245,0,1,244
Listas,2014EP,06-024-006,777,280,0,280,0,4,276
Listas,2014EP,06-024-007,657,234,0,233,-1,1,232
Listas,2014EP,06-024-008,653,243,0,243,0,2,241
Listas,2014EP,06-024-009,705,273,0,273,0,2,271
Listas,2014EP,06-024-010,792,323,0,322,-1,0,322
Listas,2014EP,06-024-011,823,183,0,183,0,0,183
Listas,2014EP,06-024-012,660,166,0,166,0,0,166
Listas,2014EP,06-024-013,595,172,0,172,0,5,167
Listas,2014EP,06-024-014,1006,248,0,248,0,0,248
Listas,2014EP,06-024-015,830,186,0,186,0,0,186
Listas,2014EP,06-024-016,827,162,0,162,0,0,162
Listas,2014EP,06-024-017,980,254,0,254,0,1,253
Listas,2014EP,06-024-018,980,269,0,269,0,0,269
Listas,2014EP,06-024-019,848,237,0,237,0,1,236
Listas,2014EP,06-024-020,957,289,0,289,0,3,286
Listas,2014EP,06-024-021,846,282,0,282,0,1,281
Listas,2014EP,06-024-022,808,219,0,219,0,1,218
Listas,2014EP,06-024-023,1060,313,0,313,0,1,312
Listas,2014EP,06-024-024,610,186,0,186,0,0,186
Listas,2014EP,06-024-025,729,222,0,222,0,0,222
Listas,2014EP,06-024-026,875,218,0,218,0,1,217
Listas,2014EP,06-024-027,810,181,0,181,0,0,181
Listas,2014EP,06-024-028,810,184,0,184,0,1,183
Listas,2014EP,06-024-029,644,152,0,152,0,0,152
Listas,2014EP,06-024-030,701,225,0,224,-1,5,219
Listas,2014EP,06-024-031,540,126,0,126,0,1,125
Listas,2014EP,06-024-032,736,189,0,189,0,0,189
Listas,2014EP,06-024-033,930,237,0,237,0,1,236
Listas,2014EP,06-024-034,1074,280,0,280,0,0,280
Listas,2014EP,06-024-035,1086,266,0,266,0,1,265
Listas,2014EP,06-024-036,635,202,0,202,0,1,201
Listas,2014EP,06-024-037,920,276,0,276,0,0,276
Listas,2014EP,06-024-038,885,266,0,265,-1,1,264
Listas,2014EP,06-024-039,927,250,0,250,0,2,248
Listas,2014EP,06-024-040,802,181,0,181,0,1,180
Listas,2014EP,06-024-041,972,395,0,393,-2,5,388
Listas,2014EP,06-024-042,234,70,0,70,0,0,70
Listas,2014EP,06-024-043,515,132,0,132,0,3,129
Listas,2014EP,06-024-044,268,66,0,66,0,0,66
Listas,2014EP,06-024-045,480,100,0,100,0,2,98
Listas,2014EP,06-024-046,317,59,0,59,0,0,59
Listas,2014EP,06-024-047,303,66,0,66,0,0,66
Listas,2014EP,06-024-048,588,108,0,108,0,1,107
Listas,2014EP,06-024-049,128,31,0,31,0,0,31
Listas,2014EP,06-024-050,1035,356,0,356,0,1,355
Listas,2014EP,06-025-001,500,127,0,127,0,1,126
Listas,2014EP,06-025-002,39,12,0,12,0,0,12
Listas,2014EP,06-026-001,994,263,0,263,0,2,261
Listas,2014EP,06-026-002,623,146,0,146,0,3,143
Listas,2014EP,06-026-003,1040,262,0,262,0,1,261
Listas,2014EP,06-026-004,1020,204,0,201,-3,0,201
Listas,2014EP,06-026-005,643,115,0,115,0,0,115
Listas,2014EP,06-026-006,914,196,0,196,0,0,196
Listas,2014EP,06-026-007,833,179,0,179,0,1,178
Listas,2014EP,06-027-001,856,156,0,156,0,2,154
Listas,2014EP,06-027-002,803,133,0,133,0,0,133
Listas,2014EP,06-027-003,819,143,0,143,0,0,143
Listas,2014EP,06-027-004,802,160,0,160,0,1,159
Listas,2014EP,06-028-001,438,62,0,62,0,1,61
Listas,2014EP,06-029-001,344,79,0,79,0,0,79
Listas,2014EP,06-030-001,1234,253,0,253,0,4,249
Listas,2014EP,06-031-001,607,123,0,123,0,0,123
Listas,2014EP,06-031-002,557,129,0,129,0,1,128
Listas,2014EP,06-032-001,760,242,0,242,0,6,236
Listas,2014EP,06-032-002,808,187,0,187,0,0,187
Listas,2014EP,06-032-003,945,217,0,217,0,2,215
Listas,2014EP,06-032-004,894,193,0,193,0,0,193
Listas,2014EP,06-032-005,744,177,0,177,0,0,177
Listas,2014EP,06-032-006,680,134,0,134,0,2,132
Listas,2014EP,06-032-007,721,216,0,216,0,2,214
Listas,2014EP,06-032-008,807,229,0,229,0,5,224
Listas,2014EP,06-032-009,999,99,0,99,0,2,97
Listas,2014EP,06-032-010,1037,347,0,347,0,1,346
Listas,2014EP,06-032-011,1039,195,0,195,0,1,194
Listas,2014EP,06-032-012,818,289,0,289,0,2,287
Listas,2014EP,06-032-013,921,272,0,272,0,1,271
Listas,2014EP,06-032-014,841,240,0,240,0,3,237
Listas,2014EP,06-032-015,920,298,0,298,0,2,296
Listas,2014EP,06-032-016,709,222,0,222,0,1,221
Listas,2014EP,06-032-017,862,232,0,232,0,2,230
Listas,2014EP,06-032-018,1069,285,0,285,0,1,284
Listas,2014EP,06-032-019,697,213,0,213,0,0,213
Listas,2014EP,06-032-020,686,192,0,191,-1,1,190
Listas,2014EP,06-032-021,912,249,0,249,0,1,248
Listas,2014EP,06-032-022,722,198,0,198,0,0,198
Listas,2014EP,06-032-023,940,205,0,205,0,2,203
Listas,2014EP,06-033-001,532,119,0,119,0,0,119
Listas,2014EP,06-033-002,553,108,0,108,0,1,107
Listas,2014EP,06-033-003,613,86,0,86,0,1,85
Listas,2014EP,06-034-001,703,167,0,167,0,4,163
Listas,2014EP,06-034-002,358,114,0,114,0,0,114
Listas,2014EP,06-035-001,1202,267,0,267,0,0,267
Listas,2014EP,06-035-002,1198,256,0,256,0,1,255
Listas,2014EP,06-035-003,1169,243,0,243,0,1,242
Listas,2014EP,06-035-004,1034,248,0,247,-1,0,247
Listas,2014EP,06-035-005,1091,187,0,187,0,3,184
Listas,2014EP,06-036-001,584,162,0,162,0,0,162
Listas,2014EP,06-036-002,729,231,0,231,0,3,228
Listas,2014EP,06-036-003,944,304,0,304,0,2,302
Listas,2014EP,06-036-004,849,308,0,308,0,3,305
Listas,2014EP,06-036-005,851,224,0,224,0,3,221
Listas,2014EP,06-036-006,317,73,0,73,0,0,73
Listas,2014EP,06-036-007,261,49,0,49,0,0,49
Listas,2014EP,06-036-008,297,55,0,55,0,0,55
Listas,2014EP,06-036-009,155,54,0,54,0,0,54
Listas,2014EP,06-037-001,432,97,0,97,0,0,97
Listas,2014EP,06-038-001,454,102,0,102,0,1,101
Listas,2014EP,06-039-001,598,77,0,77,0,0,77
Listas,2014EP,06-039-002,682,111,0,111,0,4,107
Listas,2014EP,06-039-003,546,78,0,78,0,0,78
Listas,2014EP,06-039-004,534,122,0,122,0,3,119
Listas,2014EP,06-039-005,151,34,0,34,0,0,34
Listas,2014EP,06-040-001,377,83,0,83,0,0,83
Listas,2014EP,06-041-001,418,112,0,112,0,1,111
Listas,2014EP,06-042-001,627,102,0,102,0,2,100
Listas,2014EP,06-042-002,462,65,0,65,0,1,64
Listas,2014EP,06-042-003,369,60,0,60,0,0,60
Listas,2014EP,06-042-004,153,36,0,36,0,0,36
Listas,2014EP,06-043-001,427,144,0,144,0,0,144
Listas,2014EP,06-043-002,154,30,0,30,0,0,30
Listas,2014EP,06-044-001,634,151,0,151,0,0,151
Listas,2014EP,06-044-002,589,164,0,164,0,1,163
Listas,2014EP,06-045-001,955,181,0,181,0,3,178
Listas,2014EP,06-046-001,758,226,1,225,-1,1,224
Listas,2014EP,06-046-002,460,66,0,66,0,0,66
Listas,2014EP,06-047-001,985,207,0,207,0,1,206
Listas,2014EP,06-047-002,1245,244,0,244,0,0,244
Listas,2014EP,06-047-003,561,104,0,104,0,0,104
Listas,2014EP,06-048-001,1117,227,0,227,0,0,227
Listas,2014EP,06-048-002,996,185,0,185,0,1,184
Listas,2014EP,06-049-001,828,147,0,147,0,2,145
Listas,2014EP,06-049-002,824,132,0,132,0,0,132
Listas,2014EP,06-049-003,642,114,0,114,0,1,113
Listas,2014EP,06-049-004,715,142,2,140,-2,0,140
Listas,2014EP,06-049-005,806,192,0,192,0,0,192
Listas,2014EP,06-049-006,884,168,0,168,0,1,167
Listas,2014EP,06-049-007,809,184,0,184,0,4,180
Listas,2014EP,06-049-008,714,157,0,157,0,1,156
Listas,2014EP,06-049-009,463,71,0,71,0,0,71
Listas,2014EP,06-050-001,873,174,0,174,0,2,172
Listas,2014EP,06-050-002,966,236,0,236,0,1,235
Listas,2014EP,06-050-003,1010,191,0,191,0,2,189
Listas,2014EP,06-050-004,1096,203,0,203,0,1,202
Listas,2014EP,06-051-001,1176,454,0,453,-1,3,450
Listas,2014EP,06-051-002,1073,385,0,385,0,0,385
Listas,2014EP,06-051-003,1008,418,1,417,-1,1,416
Listas,2014EP,06-051-004,1176,351,0,351,0,2,349
Listas,2014EP,06-051-005,1347,395,0,394,-1,2,392
Listas,2014EP,06-051-006,1386,417,0,417,0,1,416
Listas,2014EP,06-051-007,1398,352,0,352,0,0,352
Listas,2014EP,06-051-008,1341,446,0,446,0,0,446
Listas,2014EP,06-051-009,1200,304,0,304,0,1,303
Listas,2014EP,06-051-010,1061,296,0,296,0,0,296
Listas,2014EP,06-051-011,1311,347,0,347,0,2,345
Listas,2014EP,06-051-012,794,299,0,299,0,1,298
Listas,2014EP,06-051-013,1386,538,0,538,0,1,537
Listas,2014EP,06-051-014,1067,338,0,338,0,0,338
Listas,2014EP,06-051-015,1364,492,0,492,0,4,488
Listas,2014EP,06-051-016,1072,351,0,350,-1,0,350
Listas,2014EP,06-051-017,1224,272,0,272,0,0,272
Listas,2014EP,06-051-018,1176,312,0,312,0,0,312
Listas,2014EP,06-051-019,1416,445,0,444,-1,1,443
Listas,2014EP,06-051-020,1278,411,0,411,0,1,410
Listas,2014EP,06-051-101,2473,1324,0,1324,0,4,1320
Listas,2014EP,06-051-102,968,384,0,382,-2,2,380
Listas,2014EP,06-051-103,1170,420,0,416,-4,1,415
Listas,2014EP,06-051-104,1208,321,0,321,0,2,319
Listas,2014EP,06-051-105,1319,279,0,279,0,0,279
Listas,2014EP,06-051-106,1385,372,0,372,0,1,371
Listas,2014EP,06-051-107,1394,321,0,321,0,1,320
Listas,2014EP,06-051-108,1320,399,0,399,0,2,397
Listas,2014EP,06-051-109,1186,366,0,366,0,1,365
Listas,2014EP,06-051-110,1063,272,0,272,0,3,269
Listas,2014EP,06-051-111,1242,363,0,363,0,1,362
Listas,2014EP,06-051-112,1293,433,0,433,0,1,432
Listas,2014EP,06-051-113,1319,535,0,535,0,0,535
Listas,2014EP,06-051-114,1269,458,0,458,0,0,458
Listas,2014EP,06-051-115,734,246,0,246,0,1,245
Listas,2014EP,06-051-116,1142,293,0,293,0,0,293
Listas,2014EP,06-051-117,1188,329,0,329,0,1,328
Listas,2014EP,06-051-118,1162,277,0,277,0,1,276
Listas,2014EP,06-051-119,1289,400,0,400,0,1,399
Listas,2014EP,06-051-120,1328,354,0,354,0,0,354
Listas,2014EP,06-051-201,1266,410,0,410,0,0,410
Listas,2014EP,06-051-202,978,424,0,424,0,1,423
Listas,2014EP,06-051-203,1098,378,0,378,0,1,377
Listas,2014EP,06-051-204,1328,332,0,332,0,0,332
Listas,2014EP,06-051-205,1307,374,0,374,0,2,372
Listas,2014EP,06-051-206,1333,298,0,298,0,1,297
Listas,2014EP,06-051-207,1335,250,0,250,0,2,248
Listas,2014EP,06-051-208,1347,445,0,445,0,0,445
Listas,2014EP,06-051-209,1292,344,0,344,0,1,343
Listas,2014EP,06-051-210,1130,261,0,261,0,1,260
Listas,2014EP,06-051-211,1243,391,0,391,0,3,388
Listas,2014EP,06-051-212,1239,435,0,435,0,3,432
Listas,2014EP,06-051-213,1306,534,0,534,0,0,534
Listas,2014EP,06-051-214,1161,439,0,439,0,2,437
Listas,2014EP,06-051-215,1323,521,0,520,-1,0,520
Listas,2014EP,06-051-216,1052,304,0,304,0,2,302
Listas,2014EP,06-051-217,1193,358,0,357,-1,2,355
Listas,2014EP,06-051-218,1245,300,0,300,0,0,300
Listas,2014EP,06-051-219,1398,398,0,397,-1,0,397
Listas,2014EP,06-051-220,1312,376,0,376,0,0,376
Listas,2014EP,06-051-301,1085,403,0,403,0,5,398
Listas,2014EP,06-051-302,1069,402,0,402,0,0,402
Listas,2014EP,06-051-303,1158,386,0,386,0,0,386
Listas,2014EP,06-051-304,1450,540,0,540,0,4,536
Listas,2014EP,06-051-305,1320,324,0,324,0,4,320
Listas,2014EP,06-051-306,1225,258,0,258,0,0,258
Listas,2014EP,06-051-307,1028,341,0,341,0,8,333
Listas,2014EP,06-051-308,1259,400,0,400,0,1,399
Listas,2014EP,06-051-309,1183,355,0,355,0,1,354
Listas,2014EP,06-051-310,1079,341,0,341,0,0,341
Listas,2014EP,06-051-311,1078,276,0,269,-7,0,269
Listas,2014EP,06-051-312,1327,365,0,365,0,1,364
Listas,2014EP,06-051-313,1368,561,0,561,0,1,560
Listas,2014EP,06-051-314,1107,384,0,383,-1,0,383
Listas,2014EP,06-051-315,1381,493,0,493,0,1,492
Listas,2014EP,06-051-316,1175,279,0,279,0,2,277
Listas,2014EP,06-051-317,1139,270,1,269,-1,0,269
Listas,2014EP,06-051-318,1233,305,0,305,0,1,304
Listas,2014EP,06-051-319,1236,382,0,382,0,3,379
Listas,2014EP,06-051-320,1322,410,0,410,0,0,410
Listas,2014EP,06-051-401,1255,442,0,441,-1,2,439
Listas,2014EP,06-051-402,1161,374,0,374,0,0,374
Listas,2014EP,06-051-403,994,369,0,369,0,7,362
Listas,2014EP,06-051-404,1037,290,0,290,0,1,289
Listas,2014EP,06-051-407,1093,283,0,283,0,2,281
Listas,2014EP,06-051-408,1382,436,0,436,0,0,436
Listas,2014EP,06-051-409,1208,363,0,363,0,1,362
Listas,2014EP,06-051-410,1429,318,0,318,0,3,315
Listas,2014EP,06-051-411,1199,301,0,301,0,2,299
Listas,2014EP,06-051-412,1302,477,0,477,0,1,476
Listas,2014EP,06-051-413,1373,572,0,572,0,2,570
Listas,2014EP,06-051-414,1076,370,0,369,-1,0,369
Listas,2014EP,06-051-415,1384,485,0,485,0,2,483
Listas,2014EP,06-051-416,1071,278,0,278,0,0,278
Listas,2014EP,06-051-417,1270,263,0,263,0,0,263
Listas,2014EP,06-051-418,1105,274,0,274,0,0,274
Listas,2014EP,06-051-419,1272,371,0,371,0,0,371
Listas,2014EP,06-051-502,1151,326,0,326,0,0,326
Listas,2014EP,06-051-503,1032,312,0,312,0,0,312
Listas,2014EP,06-051-504,1021,235,0,235,0,0,235
Listas,2014EP,06-051-507,1074,347,0,346,-1,3,343
Listas,2014EP,06-051-508,1465,386,0,386,0,0,386
Listas,2014EP,06-051-510,1365,387,0,387,0,1,386
Listas,2014EP,06-051-511,1437,362,0,362,0,3,359
Listas,2014EP,06-051-514,1094,320,0,320,0,0,320
Listas,2014EP,06-051-516,1275,316,0,316,0,1,315
Listas,2014EP,06-051-517,1248,263,0,263,0,0,263
Listas,2014EP,06-051-518,1182,300,0,300,0,1,299
Listas,2014EP,06-051-603,1146,292,0,292,0,1,291
Listas,2014EP,06-052-001,644,177,0,177,0,0,177
Listas,2014EP,06-052-002,667,186,0,186,0,0,186
Listas,2014EP,06-052-003,641,171,0,171,0,0,171
Listas,2014EP,06-052-004,606,122,0,122,0,1,121
Listas,2014EP,06-052-005,585,135,0,135,0,5,130
Listas,2014EP,06-052-006,594,114,0,114,0,0,114
Listas,2014EP,06-052-007,80,18,0,18,0,0,18
Listas,2014EP,06-053-001,781,261,0,261,0,8,253
Listas,2014EP,06-053-002,735,223,0,223,0,0,223
Listas,2014EP,06-053-003,767,235,0,235,0,0,235
Listas,2014EP,06-053-004,76,11,0,11,0,0,11
Listas,2014EP,06-053-005,193,57,0,57,0,0,57
Listas,2014EP,06-053-006,900,227,0,227,0,1,226
Listas,2014EP,06-053-007,1017,265,0,265,0,4,261
Listas,2014EP,06-053-008,685,126,0,126,0,0,126
Listas,2014EP,06-053-009,701,214,0,214,0,1,213
Listas,2014EP,06-053-010,767,141,0,141,0,1,140
Listas,2014EP,06-053-011,166,38,0,38,0,0,38
Listas,2014EP,06-053-012,190,47,0,47,0,0,47
Listas,2014EP,06-053-013,101,24,0,24,0,0,24
Listas,2014EP,06-053-014,937,300,0,300,0,2,298
Listas,2014EP,06-053-015,1001,309,0,309,0,0,309
Listas,2014EP,06-053-016,729,225,0,225,0,0,225
Listas,2014EP,06-053-017,942,247,0,247,0,1,246
Listas,2014EP,06-053-018,730,257,0,257,0,1,256
Listas,2014EP,06-053-019,746,254,0,254,0,3,251
Listas,2014EP,06-053-020,739,197,0,197,0,0,197
Listas,2014EP,06-053-021,855,284,0,284,0,1,283
Listas,2014EP,06-053-022,958,307,0,307,0,6,301
Listas,2014EP,06-053-023,816,265,0,265,0,1,264
Listas,2014EP,06-053-024,629,214,0,213,-1,0,213
Listas,2014EP,06-053-025,962,285,0,285,0,4,281
Listas,2014EP,06-053-026,896,238,0,238,0,3,235
Listas,2014EP,06-053-027,642,189,0,189,0,0,189
Listas,2014EP,06-053-028,934,228,0,228,0,0,228
Listas,2014EP,06-053-029,859,267,0,267,0,2,265
Listas,2014EP,06-053-030,679,214,0,214,0,0,214
Listas,2014EP,06-053-031,156,37,0,37,0,0,37
Listas,2014EP,06-053-032,1159,206,0,206,0,2,204
Listas,2014EP,06-053-033,707,144,0,144,0,2,142
Listas,2014EP,06-053-034,96,20,0,20,0,0,20
Listas,2014EP,06-053-035,203,45,0,45,0,0,45
Listas,2014EP,06-054-001,988,296,0,296,0,1,295
Listas,2014EP,06-054-002,928,232,0,232,0,1,231
Listas,2014EP,06-055-001,735,190,0,190,0,2,188
Listas,2014EP,06-055-002,763,169,0,169,0,0,169
Listas,2014EP,06-056-001,749,154,0,154,0,0,154
Listas,2014EP,06-056-002,749,136,0,136,0,2,134
Listas,2014EP,06-057-001,753,190,0,190,0,0,190
Listas,2014EP,06-057-002,777,188,0,188,0,0,188
Listas,2014EP,06-058-001,866,133,0,133,0,1,132
Listas,2014EP,06-058-002,872,227,0,226,-1,3,223
Listas,2014EP,06-058-003,836,155,0,155,0,1,154
Listas,2014EP,06-059-001,1147,284,0,284,0,2,282
Listas,2014EP,06-059-002,1138,277,0,276,-1,1,275
Listas,2014EP,06-060-001,857,182,0,182,0,0,182
Listas,2014EP,06-060-002,929,204,0,204,0,0,204
Listas,2014EP,06-060-003,1038,318,0,318,0,2,316
Listas,2014EP,07-001-001,1051,159,0,159,0,0,159
Listas,2014EP,07-001-002,998,157,0,157,0,0,157
Listas,2014EP,07-001-003,195,26,0,26,0,0,26
Listas,2014EP,07-001-004,198,30,0,30,0,1,29
Listas,2014EP,07-001-005,1154,220,0,220,0,0,220
Listas,2014EP,07-002-001,1019,211,0,211,0,0,211
Listas,2014EP,07-002-002,1058,242,0,242,0,2,240
Listas,2014EP,07-002-003,1029,231,0,231,0,0,231
Listas,2014EP,07-003-001,907,186,0,186,0,0,186
Listas,2014EP,07-003-002,644,119,0,119,0,0,119
Listas,2014EP,07-004-001,479,192,0,192,0,1,191
Listas,2014EP,07-004-002,683,232,0,232,0,2,230
Listas,2014EP,07-005-001,508,103,0,103,0,1,102
Listas,2014EP,07-006-001,791,219,0,219,0,0,219
Listas,2014EP,07-006-002,881,247,0,247,0,0,247
Listas,2014EP,07-006-003,875,238,0,238,0,1,237
Listas,2014EP,07-007-001,123,72,0,72,0,0,72
Listas,2014EP,07-008-001,381,80,0,80,0,0,80
Listas,2014EP,07-008-002,392,148,0,148,0,5,143
Listas,2014EP,07-009-001,730,163,0,163,0,1,162
Listas,2014EP,07-009-002,663,152,0,152,0,0,152
Listas,2014EP,07-009-003,792,220,0,220,0,2,218
Listas,2014EP,07-009-004,684,145,0,145,0,0,145
Listas,2014EP,07-010-001,1123,247,0,247,0,1,246
Listas,2014EP,07-010-002,926,225,0,225,0,1,224
Listas,2014EP,07-010-003,147,37,0,37,0,0,37
Listas,2014EP,07-011-001,910,197,0,196,-1,2,194
Listas,2014EP,07-012-001,711,166,0,166,0,2,164
Listas,2014EP,07-012-002,729,120,0,120,0,1,119
Listas,2014EP,07-013-001,1170,383,0,381,-2,0,381
Listas,2014EP,07-013-002,1116,243,0,243,0,0,243
Listas,2014EP,07-013-003,1150,361,0,361,0,4,357
Listas,2014EP,07-013-004,1068,382,0,382,0,0,382
Listas,2014EP,07-013-005,1130,398,0,398,0,4,394
Listas,2014EP,07-013-006,1128,413,0,413,0,3,410
Listas,2014EP,07-013-007,1159,359,0,359,0,0,359
Listas,2014EP,07-013-008,991,247,0,246,-1,0,246
Listas,2014EP,07-014-001,789,236,0,236,0,1,235
Listas,2014EP,07-014-002,780,261,0,261,0,1,260
Listas,2014EP,07-014-003,754,242,0,242,0,0,242
Listas,2014EP,07-014-004,999,301,0,301,0,2,299
Listas,2014EP,07-015-001,205,80,0,80,0,0,80
Listas,2014EP,07-016-001,759,162,0,162,0,0,162
Listas,2014EP,07-016-002,672,145,0,145,0,1,144
Listas,2014EP,07-016-003,702,138,0,138,0,0,138
Listas,2014EP,07-017-001,823,265,0,265,0,3,262
Listas,2014EP,07-017-002,162,43,1,42,-1,0,42
Listas,2014EP,07-018-001,986,315,0,315,0,0,315
Listas,2014EP,07-019-001,935,252,0,252,0,0,252
Listas,2014EP,07-019-002,769,254,0,254,0,0,254
Listas,2014EP,07-019-003,902,275,0,275,0,0,275
Listas,2014EP,07-019-004,880,195,0,195,0,0,195
Listas,2014EP,07-019-005,840,226,0,226,0,1,225
Listas,2014EP,07-020-001,1158,452,0,452,0,1,451
Listas,2014EP,07-021-001,830,209,0,209,0,0,209
Listas,2014EP,07-021-002,669,192,0,192,0,0,192
Listas,2014EP,07-022-001,816,145,0,145,0,1,144
Listas,2014EP,07-023-001,917,155,0,155,0,1,154
Listas,2014EP,07-023-002,902,142,0,142,0,0,142
Listas,2014EP,07-024-001,1210,391,0,391,0,1,390
Listas,2014EP,07-024-002,960,363,0,363,0,4,359
Listas,2014EP,07-024-003,536,209,0,209,0,3,206
Listas,2014EP,07-024-004,849,261,0,261,0,8,253
Listas,2014EP,07-024-005,1040,356,0,356,0,7,349
Listas,2014EP,07-024-006,600,195,0,195,0,0,195
Listas,2014EP,07-024-007,681,247,0,247,0,1,246
Listas,2014EP,07-024-008,602,182,0,182,0,3,179
Listas,2014EP,07-024-009,753,216,0,216,0,0,216
Listas,2014EP,07-024-010,960,267,0,267,0,2,265
Listas,2014EP,07-024-011,712,188,0,188,0,0,188
Listas,2014EP,07-024-012,869,211,0,211,0,1,210
Listas,2014EP,07-024-013,827,242,0,242,0,2,240
Listas,2014EP,07-024-014,878,209,0,209,0,1,208
Listas,2014EP,07-024-015,806,225,0,225,0,17,208
Listas,2014EP,07-024-016,790,190,0,190,0,0,190
Listas,2014EP,07-024-017,539,149,0,149,0,0,149
Listas,2014EP,07-024-018,881,215,0,215,0,2,213
Listas,2014EP,07-024-019,745,231,0,231,0,3,228
Listas,2014EP,07-024-020,748,258,0,258,0,3,255
Listas,2014EP,07-024-021,478,146,0,146,0,0,146
Listas,2014EP,07-024-022,910,307,0,307,0,3,304
Listas,2014EP,07-024-023,817,322,0,322,0,1,321
Listas,2014EP,07-024-024,888,286,0,286,0,3,283
Listas,2014EP,07-024-025,836,234,0,234,0,6,228
Listas,2014EP,07-024-026,785,223,0,223,0,0,223
Listas,2014EP,07-024-027,699,201,0,201,0,1,200
Listas,2014EP,07-024-028,688,198,0,198,0,1,197
Listas,2014EP,07-024-029,710,206,0,206,0,3,203
Listas,2014EP,07-024-030,881,249,0,249,0,1,248
Listas,2014EP,07-024-031,625,188,0,188,0,0,188
Listas,2014EP,07-024-032,821,232,0,232,0,1,231
Listas,2014EP,07-024-033,883,217,0,216,-1,0,216
Listas,2014EP,07-024-034,650,185,0,185,0,2,183
Listas,2014EP,07-024-035,895,201,0,201,0,2,199
Listas,2014EP,07-024-036,1011,256,0,256,0,0,256
Listas,2014EP,07-024-037,1067,257,0,256,-1,0,256
Listas,2014EP,07-024-038,1162,249,0,249,0,1,248
Listas,2014EP,07-024-039,1041,246,0,246,0,2,244
Listas,2014EP,07-024-040,1039,213,0,213,0,2,211
Listas,2014EP,07-024-041,1103,252,0,252,0,1,251
Listas,2014EP,07-024-042,1119,263,0,263,0,0,263
Listas,2014EP,07-024-043,1058,420,0,420,0,6,414
Listas,2014EP,07-024-044,1099,416,0,416,0,2,414
Listas,2014EP,07-024-045,1111,362,0,362,0,3,359
Listas,2014EP,07-024-046,1217,403,0,403,0,0,403
Listas,2014EP,07-024-047,490,75,0,75,0,0,75
Listas,2014EP,07-025-001,842,179,0,179,0,0,179
Listas,2014EP,07-025-002,523,98,0,98,0,2,96
Listas,2014EP,07-025-003,568,119,0,119,0,1,118
Listas,2014EP,07-026-001,889,197,0,197,0,1,196
Listas,2014EP,07-026-002,872,197,0,197,0,0,197
Listas,2014EP,07-026-003,927,197,0,197,0,0,197
Listas,2014EP,07-026-004,1019,205,0,205,0,1,204
Listas,2014EP,07-026-005,885,119,0,119,0,1,118
Listas,2014EP,07-026-006,598,131,0,131,0,2,129
Listas,2014EP,07-026-007,313,52,0,52,0,0,52
Listas,2014EP,07-026-008,161,29,0,29,0,1,28
Listas,2014EP,07-027-001,1107,267,0,267,0,0,267
Listas,2014EP,07-027-002,1060,297,0,297,0,3,294
Listas,2014EP,07-027-003,1133,287,0,287,0,1,286
Listas,2014EP,07-027-004,1082,213,0,213,0,0,213
Listas,2014EP,07-027-005,973,263,0,263,0,0,263
Listas,2014EP,07-027-006,1058,139,0,139,0,1,138
Listas,2014EP,07-027-007,239,74,0,74,0,0,74
Listas,2014EP,07-028-001,1070,331,0,331,0,0,331
Listas,2014EP,07-028-002,901,243,0,243,0,2,241
Listas,2014EP,07-028-003,1147,312,0,312,0,1,311
Listas,2014EP,07-028-004,123,40,0,40,0,0,40
Listas,2014EP,07-029-001,870,271,1,270,-1,0,270
Listas,2014EP,07-029-002,775,221,0,221,0,0,221
Listas,2014EP,07-030-001,712,267,0,267,0,1,266
Listas,2014EP,07-030-002,799,375,0,375,0,4,371
Listas,2014EP,07-031-001,733,206,0,206,0,0,206
Listas,2014EP,07-032-001,514,168,0,168,0,2,166
Listas,2014EP,07-033-001,1352,640,0,640,0,1,639
Listas,2014EP,07-033-002,1060,296,0,296,0,1,295
Listas,2014EP,07-033-003,1143,355,0,355,0,0,355
Listas,2014EP,07-033-004,1056,382,0,382,0,1,381
Listas,2014EP,07-033-005,1007,333,0,333,0,0,333
Listas,2014EP,07-033-006,1034,347,0,346,-1,0,346
Listas,2014EP,07-033-007,1120,396,0,396,0,3,393
Listas,2014EP,07-033-008,862,217,0,217,0,1,216
Listas,2014EP,07-034-001,1001,312,0,312,0,1,311
Listas,2014EP,07-035-001,799,133,2,131,-2,2,129
Listas,2014EP,07-036-001,335,71,0,71,0,0,71
Listas,2014EP,07-036-002,226,29,0,29,0,1,28
Listas,2014EP,07-036-003,247,38,0,38,0,0,38
Listas,2014EP,07-037-001,999,216,0,216,0,0,216
Listas,2014EP,07-037-002,646,204,0,204,0,0,204
Listas,2014EP,07-038-001,698,156,0,156,0,0,156
Listas,2014EP,07-038-002,78,36,0,36,0,0,36
Listas,2014EP,07-039-001,1200,210,0,210,0,0,210
Listas,2014EP,07-039-002,1076,134,0,134,0,0,134
Listas,2014EP,07-040-001,1056,213,0,213,0,0,213
Listas,2014EP,07-041-001,855,241,0,241,0,0,241
Listas,2014EP,07-042-001,1008,171,0,171,0,0,171
Listas,2014EP,07-042-002,959,128,0,128,0,0,128
Listas,2014EP,07-043-001,981,343,0,343,0,1,342
Listas,2014EP,07-043-002,813,247,0,247,0,1,246
Listas,2014EP,07-043-003,328,87,0,87,0,0,87
Listas,2014EP,07-043-004,874,233,0,233,0,1,232
Listas,2014EP,07-044-001,551,140,0,140,0,0,140
Listas,2014EP,07-044-002,735,197,0,197,0,0,197
Listas,2014EP,07-045-001,591,200,0,200,0,1,199
Listas,2014EP,07-045-002,621,170,0,170,0,0,170
Listas,2014EP,07-046-001,941,84,0,84,0,0,84
Listas,2014EP,07-046-002,1069,145,0,145,0,0,145
Listas,2014EP,07-047-001,629,184,0,184,0,0,184
Listas,2014EP,07-047-002,668,160,0,160,0,0,160
Listas,2014EP,07-048-001,1240,302,0,302,0,1,301
Listas,2014EP,07-048-002,1139,294,0,294,0,2,292
Listas,2014EP,07-049-001,415,45,0,45,0,0,45
Listas,2014EP,07-049-002,43,12,0,12,0,0,12
Listas,2014EP,07-049-003,707,207,0,207,0,0,207
Listas,2014EP,07-049-004,706,168,0,168,0,0,168
Listas,2014EP,07-050-001,869,170,0,170,0,0,170
Listas,2014EP,07-050-002,866,172,0,172,0,0,172
Listas,2014EP,07-050-003,806,188,0,188,0,0,188
Listas,2014EP,07-051-001,753,196,0,196,0,1,195
Listas,2014EP,07-051-002,740,229,1,228,-1,0,228
Listas,2014EP,07-051-003,742,202,0,202,0,1,201
Listas,2014EP,07-052-001,1306,453,0,453,0,2,451
Listas,2014EP,07-053-001,818,287,0,287,0,1,286
Listas,2014EP,07-053-002,863,287,0,287,0,3,284
Listas,2014EP,07-053-003,875,307,0,307,0,0,307
Listas,2014EP,07-053-004,868,308,0,308,0,0,308
Listas,2014EP,07-053-005,1067,303,0,303,0,1,302
Listas,2014EP,07-054-001,1094,321,0,321,0,0,321
Listas,2014EP,07-054-002,818,164,0,164,0,0,164
Listas,2014EP,07-055-001,592,93,0,93,0,1,92
Listas,2014EP,07-056-001,1045,250,0,250,0,0,250
Listas,2014EP,07-056-002,979,184,0,184,0,0,184
Listas,2014EP,07-056-003,978,192,0,192,0,1,191
Listas,2014EP,07-056-004,874,97,0,97,0,1,96
Listas,2014EP,07-057-001,791,175,0,175,0,0,175
Listas,2014EP,07-058-001,447,87,0,87,0,2,85
Listas,2014EP,07-058-002,571,58,0,58,0,0,58
Listas,2014EP,07-059-001,732,125,0,125,0,0,125
Listas,2014EP,07-059-002,1023,168,0,168,0,0,168
Listas,2014EP,07-060-001,450,175,0,175,0,1,174
Listas,2014EP,07-061-001,754,233,0,233,0,2,231
Listas,2014EP,07-061-002,850,249,0,249,0,1,248
Listas,2014EP,07-061-003,792,202,0,202,0,0,202
Listas,2014EP,07-061-004,784,250,0,250,0,2,248
Listas,2014EP,07-061-005,785,191,0,191,0,1,190
Listas,2014EP,07-061-006,705,251,0,251,0,1,250
Listas,2014EP,07-061-007,1037,287,0,287,0,1,286
Listas,2014EP,07-061-008,611,162,0,162,0,2,160
Listas,2014EP,07-061-009,832,318,0,318,0,2,316
Listas,2014EP,07-061-010,620,239,0,239,0,0,239
Listas,2014EP,07-061-011,1236,419,0,419,0,0,419
Listas,2014EP,07-061-012,1267,372,0,372,0,4,368
Listas,2014EP,07-061-013,752,239,0,239,0,0,239
Listas,2014EP,07-061-014,721,316,0,316,0,3,313
Listas,2014EP,07-061-015,184,41,0,41,0,1,40
Listas,2014EP,07-062-001,418,156,0,156,0,0,156
Listas,2014EP,07-063-001,496,138,0,138,0,1,137
Listas,2014EP,07-063-002,521,106,0,106,0,0,106
Listas,2014EP,07-063-003,150,34,0,34,0,0,34
Listas,2014EP,07-064-001,891,128,0,128,0,0,128
Listas,2014EP,07-065-001,530,156,0,156,0,1,155
Listas,2014EP,07-066-001,788,169,0,169,0,0,169
Listas,2014EP,07-066-002,857,222,0,222,0,0,222
Listas,2014EP,07-066-003,857,232,0,232,0,1,231
Listas,2014EP,07-066-004,791,202,0,202,0,1,201
Listas,2014EP,07-066-005,114,12,0,12,0,0,12
Listas,2014EP,07-067-001,449,73,0,73,0,1,72
Listas,2014EP,07-067-002,550,118,0,118,0,0,118
Listas,2014EP,07-067-003,475,65,0,65,0,0,65
Listas,2014EP,07-068-001,430,121,0,121,0,0,121
Listas,2014EP,07-068-002,228,53,0,53,0,0,53
Listas,2014EP,07-069-001,874,258,0,258,0,0,258
Listas,2014EP,07-069-002,895,237,0,237,0,0,237
Listas,2014EP,07-069-003,786,189,0,189,0,0,189
Listas,2014EP,07-070-001,698,185,0,185,0,3,182
Listas,2014EP,07-070-002,679,145,0,145,0,1,144
Listas,2014EP,07-071-001,899,254,0,254,0,0,254
Listas,2014EP,07-071-002,793,235,0,235,0,0,235
Listas,2014EP,07-072-001,768,153,0,153,0,0,153
Listas,2014EP,07-072-002,765,151,0,151,0,0,151
Listas,2014EP,07-072-003,795,154,0,154,0,3,151
Listas,2014EP,07-072-004,865,118,0,118,0,1,117
Listas,2014EP,07-073-001,302,59,0,59,0,0,59
Listas,2014EP,07-073-002,951,190,1,189,-1,2,187
Listas,2014EP,07-073-003,979,252,0,252,0,0,252
Listas,2014EP,07-073-004,977,197,0,197,0,1,196
Listas,2014EP,07-073-005,780,109,0,109,0,0,109
Listas,2014EP,07-073-006,1100,207,0,207,0,1,206
Listas,2014EP,07-073-007,217,47,0,46,-1,0,46
Listas,2014EP,07-074-001,1017,163,0,163,0,0,163
Listas,2014EP,07-074-002,763,161,0,161,0,0,161
Listas,2014EP,07-074-003,1027,160,0,160,0,1,159
Listas,2014EP,07-074-004,981,186,0,186,0,0,186
Listas,2014EP,07-074-005,1138,251,0,251,0,0,251
Listas,2014EP,07-075-001,747,244,0,244,0,0,244
Listas,2014EP,07-075-002,605,168,0,168,0,0,168
Listas,2014EP,07-075-003,596,199,0,199,0,1,198
Listas,2014EP,07-076-001,961,276,0,276,0,2,274
Listas,2014EP,07-076-002,936,241,0,241,0,5,236
Listas,2014EP,07-076-003,923,284,0,284,0,0,284
Listas,2014EP,07-076-004,961,298,0,298,0,3,295
Listas,2014EP,07-077-001,842,164,0,164,0,0,164
Listas,2014EP,07-077-002,846,167,0,167,0,0,167
Listas,2014EP,07-077-003,929,195,0,195,0,0,195
Listas,2014EP,07-078-001,739,165,0,165,0,2,163
Listas,2014EP,07-078-002,668,158,0,158,0,1,157
Listas,2014EP,07-078-003,554,163,0,163,0,0,163
Listas,2014EP,07-078-004,684,173,0,173,0,1,172
Listas,2014EP,07-078-005,638,149,0,149,0,1,148
Listas,2014EP,07-078-006,589,148,0,148,0,0,148
Listas,2014EP,07-078-007,578,131,0,131,0,1,130
Listas,2014EP,07-078-008,604,156,0,156,0,0,156
Listas,2014EP,07-078-009,605,184,0,184,0,0,184
Listas,2014EP,07-078-010,679,225,0,225,0,0,225
Listas,2014EP,07-078-011,728,146,0,146,0,0,146
Listas,2014EP,07-078-012,714,159,0,159,0,1,158
Listas,2014EP,07-078-013,487,121,0,121,0,0,121
Listas,2014EP,07-078-014,664,142,0,142,0,0,142
Listas,2014EP,07-078-015,231,78,0,78,0,0,78
Listas,2014EP,07-078-016,182,57,0,57,0,0,57
Listas,2014EP,07-078-017,535,94,0,94,0,0,94
Listas,2014EP,07-078-018,208,42,0,42,0,0,42
Listas,2014EP,07-078-019,88,22,0,22,0,0,22
Listas,2014EP,07-079-001,589,143,0,143,0,0,143
Listas,2014EP,07-080-001,1310,434,0,434,0,3,431
Listas,2014EP,07-081-001,675,91,0,91,0,3,88
Listas,2014EP,07-081-002,1063,99,0,99,0,0,99
Listas,2014EP,07-082-001,477,101,0,101,0,1,100
Listas,2014EP,07-083-001,1048,144,0,144,0,2,142
Listas,2014EP,07-083-002,853,145,0,145,0,0,145
Listas,2014EP,07-083-003,730,107,0,107,0,0,107
Listas,2014EP,07-084-001,973,188,0,188,0,0,188
Listas,2014EP,07-084-002,176,57,0,57,0,0,57
Listas,2014EP,07-085-001,874,201,0,201,0,0,201
Listas,2014EP,07-085-002,913,224,0,224,0,0,224
Listas,2014EP,07-085-003,794,121,0,121,0,0,121
Listas,2014EP,07-086-001,1001,238,0,238,0,0,238
Listas,2014EP,07-086-002,1098,173,0,173,0,1,172
Listas,2014EP,07-086-003,906,162,0,162,0,0,162
Listas,2014EP,07-086-004,691,96,0,96,0,1,95
Listas,2014EP,07-087-001,765,125,0,125,0,0,125
Listas,2014EP,07-087-002,788,164,0,164,0,0,164
Listas,2014EP,07-088-001,405,171,0,171,0,0,171
Listas,2014EP,07-089-001,1155,549,0,549,0,0,549
Listas,2014EP,07-090-001,956,233,0,233,0,1,232
Listas,2014EP,07-090-002,933,277,0,277,0,1,276
Listas,2014EP,07-090-003,933,204,0,204,0,1,203
Listas,2014EP,07-090-004,1012,257,0,257,0,0,257
Listas,2014EP,07-091-001,1285,194,0,194,0,4,190
Listas,2014EP,07-091-002,507,94,0,94,0,2,92
Listas,2014EP,07-092-001,592,130,0,130,0,0,130
Listas,2014EP,07-092-002,80,10,0,10,0,0,10
Listas,2014EP,07-093-001,617,193,0,193,0,1,192
Listas,2014EP,07-093-002,687,196,0,196,0,2,194
Listas,2014EP,07-094-001,810,251,0,250,-1,1,249
Listas,2014EP,07-094-002,831,265,0,265,0,1,264
Listas,2014EP,07-094-003,1078,334,0,334,0,0,334
Listas,2014EP,07-094-004,1245,603,0,603,0,6,597
Listas,2014EP,07-094-005,775,250,1,249,-1,1,248
Listas,2014EP,07-094-006,802,308,0,307,-1,0,307
Listas,2014EP,07-094-007,809,347,0,347,0,0,347
Listas,2014EP,07-094-008,787,320,0,320,0,2,318
Listas,2014EP,07-094-009,898,299,0,299,0,5,294
Listas,2014EP,07-094-010,873,298,0,298,0,1,297
Listas,2014EP,07-094-011,809,267,0,267,0,1,266
Listas,2014EP,07-094-012,860,319,0,319,0,1,318
Listas,2014EP,07-094-013,990,322,0,322,0,1,321
Listas,2014EP,07-094-014,822,286,0,286,0,2,284
Listas,2014EP,07-094-015,691,235,0,235,0,0,235
Listas,2014EP,07-094-016,740,260,0,260,0,2,258
Listas,2014EP,07-094-017,779,230,0,230,0,1,229
Listas,2014EP,07-094-018,911,271,0,271,0,0,271
Listas,2014EP,07-094-019,856,256,0,256,0,5,251
Listas,2014EP,07-094-020,858,219,0,219,0,0,219
Listas,2014EP,07-094-021,983,328,0,328,0,1,327
Listas,2014EP,07-094-022,886,266,0,266,0,2,264
Listas,2014EP,07-094-023,1020,335,0,335,0,0,335
Listas,2014EP,07-094-024,640,268,0,268,0,2,266
Listas,2014EP,07-094-025,594,195,0,195,0,1,194
Listas,2014EP,07-094-026,727,236,0,235,-1,1,234
Listas,2014EP,07-094-027,895,320,0,320,0,2,318
Listas,2014EP,07-094-028,746,309,0,308,-1,0,308
Listas,2014EP,07-094-029,897,254,0,254,0,0,254
Listas,2014EP,07-094-030,1137,352,0,352,0,1,351
Listas,2014EP,07-094-031,830,260,0,260,0,0,260
Listas,2014EP,07-094-032,954,276,0,276,0,1,275
Listas,2014EP,07-094-033,707,257,0,257,0,2,255
Listas,2014EP,07-094-034,1112,318,0,318,0,6,312
Listas,2014EP,07-094-035,997,245,0,245,0,1,244
Listas,2014EP,07-094-036,842,230,0,230,0,0,230
Listas,2014EP,07-094-037,872,261,0,261,0,0,261
Listas,2014EP,07-094-038,998,299,0,299,0,2,297
Listas,2014EP,07-094-039,1006,288,0,288,0,1,287
Listas,2014EP,07-094-040,1154,286,0,286,0,0,286
Listas,2014EP,07-094-041,1143,307,0,307,0,0,307
Listas,2014EP,07-094-042,1164,227,0,227,0,0,227
Listas,2014EP,07-094-043,963,328,0,328,0,2,326
Listas,2014EP,07-094-044,1091,275,0,275,0,1,274
Listas,2014EP,07-094-045,773,213,0,213,0,0,213
Listas,2014EP,07-094-046,1007,300,0,300,0,5,295
Listas,2014EP,07-094-047,842,277,0,277,0,1,276
Listas,2014EP,07-094-048,1155,376,0,376,0,1,375
Listas,2014EP,07-094-049,1201,376,0,376,0,0,376
Listas,2014EP,07-094-050,857,277,0,277,0,0,277
Listas,2014EP,07-094-051,1286,390,0,390,0,1,389
Listas,2014EP,07-094-052,721,267,0,267,0,0,267
Listas,2014EP,07-094-053,929,344,0,343,-1,0,343
Listas,2014EP,07-094-054,1048,346,0,346,0,1,345
Listas,2014EP,07-094-055,744,261,0,261,0,1,260
Listas,2014EP,07-094-056,545,254,0,254,0,1,253
Listas,2014EP,07-094-057,554,221,0,221,0,0,221
Listas,2014EP,07-094-058,1027,397,1,396,-1,0,396
Listas,2014EP,07-094-059,662,257,0,257,0,0,257
Listas,2014EP,07-094-060,569,254,0,254,0,0,254
Listas,2014EP,07-094-061,644,244,0,244,0,1,243
Listas,2014EP,07-094-062,783,316,0,316,0,1,315
Listas,2014EP,07-094-063,913,345,0,345,0,6,339
Listas,2014EP,07-094-064,1016,380,0,380,0,0,380
Listas,2014EP,07-094-065,755,309,0,309,0,0,309
Listas,2014EP,07-094-066,1239,520,0,519,-1,0,519
Listas,2014EP,07-094-067,1186,425,0,425,0,0,425
Listas,2014EP,07-094-068,942,347,0,347,0,1,346
Listas,2014EP,07-094-069,916,451,0,451,0,2,449
Listas,2014EP,07-094-070,992,413,0,413,0,1,412
Listas,2014EP,07-094-071,703,289,0,289,0,0,289
Listas,2014EP,07-094-072,950,460,0,460,0,0,460
Listas,2014EP,07-094-073,1149,413,0,413,0,0,413
Listas,2014EP,07-094-074,664,198,0,198,0,3,195
Listas,2014EP,07-094-075,386,123,0,123,0,0,123
Listas,2014EP,07-094-076,1253,337,0,336,-1,3,333
Listas,2014EP,07-094-077,1047,438,0,438,0,2,436
Listas,2014EP,07-094-078,1066,359,0,359,0,0,359
Listas,2014EP,07-094-079,908,330,0,329,-1,0,329
Listas,2014EP,07-094-080,1048,415,0,415,0,2,413
Listas,2014EP,07-094-081,917,241,1,240,-1,0,240
Listas,2014EP,07-094-082,594,199,0,199,0,0,199
Listas,2014EP,07-094-083,825,266,0,266,0,2,264
Listas,2014EP,07-094-084,679,223,0,223,0,1,222
Listas,2014EP,07-094-085,966,358,0,359,1,8,351
Listas,2014EP,07-094-086,748,179,0,179,0,1,178
Listas,2014EP,07-094-087,1115,335,0,335,0,1,334
Listas,2014EP,07-094-088,788,292,0,292,0,3,289
Listas,2014EP,07-094-089,1211,321,0,321,0,0,321
Listas,2014EP,07-094-090,1281,374,0,374,0,0,374
Listas,2014EP,07-094-091,479,102,0,102,0,0,102
Listas,2014EP,07-094-092,210,76,0,76,0,0,76
Listas,2014EP,07-095-001,750,227,0,227,0,3,224
Listas,2014EP,07-096-001,708,159,0,159,0,0,159
Listas,2014EP,07-096-002,658,142,0,142,0,2,140
Listas,2014EP,07-097-001,1415,450,0,450,0,2,448
Listas,2014EP,07-098-001,334,118,0,118,0,1,117
Listas,2014EP,07-099-001,906,255,0,255,0,2,253
Listas,2014EP,07-099-002,965,209,0,209,0,1,208
Listas,2014EP,07-100-001,714,160,0,160,0,1,159
Listas,2014EP,07-101-001,714,206,0,206,0,2,204
Listas,2014EP,07-101-002,699,187,0,187,0,3,184
Listas,2014EP,07-101-003,557,205,0,205,0,1,204
Listas,2014EP,07-102-001,1053,300,0,300,0,2,298
Listas,2014EP,07-102-002,754,257,0,257,0,3,254
Listas,2014EP,07-102-003,1072,468,0,468,0,2,466
Listas,2014EP,07-102-004,988,396,0,396,0,2,394
Listas,2014EP,07-102-005,876,345,0,345,0,1,344
Listas,2014EP,07-103-001,656,155,0,155,0,0,155
Listas,2014EP,07-104-001,722,149,0,149,0,0,149
Listas,2014EP,07-104-002,717,181,0,181,0,0,181
Listas,2014EP,07-105-001,739,232,0,232,0,0,232
Listas,2014EP,07-106-001,911,179,0,179,0,1,178
Listas,2014EP,07-106-002,946,227,0,226,-1,0,226
Listas,2014EP,07-107-001,780,146,0,146,0,1,145
Listas,2014EP,07-108-001,451,118,0,118,0,0,118
Listas,2014EP,07-108-002,197,39,0,39,0,0,39
Listas,2014EP,07-108-003,353,75,0,75,0,0,75
Listas,2014EP,08-001-001,639,165,0,165,0,3,162
Listas,2014EP,08-001-002,642,167,0,167,0,0,167
Listas,2014EP,08-001-003,706,177,0,177,0,1,176
Listas,2014EP,08-001-004,609,199,0,199,0,0,199
Listas,2014EP,08-002-001,397,197,0,197,0,2,195
Listas,2014EP,08-003-001,731,300,0,300,0,2,298
Listas,2014EP,08-004-001,694,187,0,187,0,0,187
Listas,2014EP,08-004-002,921,267,0,267,0,3,264
Listas,2014EP,08-005-001,232,86,0,86,0,0,86
Listas,2014EP,08-006-001,904,199,0,199,0,1,198
Listas,2014EP,08-006-002,695,218,0,218,0,1,217
Listas,2014EP,08-007-001,951,284,0,284,0,2,282
Listas,2014EP,08-008-001,122,57,0,57,0,0,57
Listas,2014EP,08-009-001,224,76,0,76,0,3,73
Listas,2014EP,08-010-001,862,218,0,218,0,1,217
Listas,2014EP,08-010-002,648,147,0,147,0,0,147
Listas,2014EP,08-011-001,584,120,0,120,0,1,119
Listas,2014EP,08-012-001,550,160,0,160,0,1,159
Listas,2014EP,08-012-002,544,127,0,127,0,0,127
Listas,2014EP,08-013-001,1001,262,0,262,0,2,260
Listas,2014EP,08-013-002,997,240,0,240,0,1,239
Listas,2014EP,08-013-003,283,74,0,74,0,0,74
Listas,2014EP,08-014-001,454,135,0,135,0,1,134
Listas,2014EP,08-014-002,410,139,0,139,0,0,139
Listas,2014EP,08-014-003,183,42,0,42,0,1,41
Listas,2014EP,08-015-001,420,86,0,86,0,0,86
Listas,2014EP,08-016-001,266,74,0,74,0,2,72
Listas,2014EP,08-017-001,547,152,0,152,0,0,152
Listas,2014EP,08-018-001,987,205,0,205,0,0,205
Listas,2014EP,08-019-001,780,122,0,122,0,0,122
Listas,2014EP,08-019-002,830,133,0,133,0,0,133
Listas,2014EP,08-019-003,178,37,0,37,0,0,37
Listas,2014EP,08-020-001,880,203,0,203,0,0,203
Listas,2014EP,08-020-002,874,212,0,212,0,0,212
Listas,2014EP,08-021-001,42,21,0,21,0,1,20
Listas,2014EP,08-022-001,468,133,0,133,0,2,131
Listas,2014EP,08-023-001,447,160,0,160,0,1,159
Listas,2014EP,08-024-001,172,72,0,72,0,0,72
Listas,2014EP,08-025-001,28,15,0,15,0,1,14
Listas,2014EP,08-026-001,409,176,0,176,0,0,176
Listas,2014EP,08-027-001,1109,346,0,346,0,2,344
Listas,2014EP,08-027-002,1143,433,0,433,0,0,433
Listas,2014EP,08-027-003,1065,311,0,311,0,1,310
Listas,2014EP,08-027-004,1042,410,0,410,0,1,409
Listas,2014EP,08-027-005,1065,367,0,367,0,0,367
Listas,2014EP,08-027-006,1061,378,0,378,0,3,375
Listas,2014EP,08-027-007,1061,400,0,399,-1,3,396
Listas,2014EP,08-027-008,1102,340,0,340,0,2,338
Listas,2014EP,08-028-001,630,133,0,133,0,1,132
Listas,2014EP,08-028-002,624,180,0,180,0,0,180
Listas,2014EP,08-029-001,323,103,0,103,0,0,103
Listas,2014EP,08-030-001,505,157,0,157,0,1,156
Listas,2014EP,08-031-001,698,152,0,152,0,0,152
Listas,2014EP,08-031-002,746,154,0,154,0,0,154
Listas,2014EP,08-032-001,196,59,0,59,0,2,57
Listas,2014EP,08-033-001,806,210,0,210,0,0,210
Listas,2014EP,08-033-002,798,184,0,184,0,0,184
Listas,2014EP,08-034-001,581,139,0,139,0,0,139
Listas,2014EP,08-035-001,134,45,0,45,0,0,45
Listas,2014EP,08-035-002,449,111,0,111,0,3,108
Listas,2014EP,08-035-003,587,153,0,153,0,1,152
Listas,2014EP,08-036-001,124,63,0,63,0,0,63
Listas,2014EP,08-037-001,107,67,0,67,0,1,66
Listas,2014EP,08-038-001,447,130,0,130,0,2,128
Listas,2014EP,08-039-001,705,234,0,234,0,1,233
Listas,2014EP,08-040-001,1435,309,0,309,0,3,306
Listas,2014EP,08-041-001,823,257,0,257,0,1,256
Listas,2014EP,08-041-002,711,231,0,231,0,0,231
Listas,2014EP,08-042-001,784,267,0,267,0,2,265
Listas,2014EP,08-042-002,830,233,0,233,0,1,232
Listas,2014EP,08-043-001,392,125,0,125,0,0,125
Listas,2014EP,08-044-001,414,124,0,124,0,0,124
Listas,2014EP,08-045-001,726,181,0,181,0,0,181
Listas,2014EP,08-046-001,108,50,0,50,0,3,47
Listas,2014EP,08-047-001,231,58,0,58,0,0,58
Listas,2014EP,08-048-001,1127,382,0,382,0,2,380
Listas,2014EP,08-048-002,671,264,0,264,0,0,264
Listas,2014EP,08-048-003,859,219,0,219,0,0,219
Listas,2014EP,08-048-004,104,26,0,26,0,0,26
Listas,2014EP,08-049-001,504,151,0,151,0,1,150
Listas,2014EP,08-050-001,510,174,0,174,0,0,174
Listas,2014EP,08-051-001,916,188,0,188,0,1,187
Listas,2014EP,08-051-002,906,279,0,279,0,2,277
Listas,2014EP,08-052-001,921,294,0,294,0,2,292
Listas,2014EP,08-052-002,844,294,0,294,0,1,293
Listas,2014EP,08-052-003,626,231,0,231,0,1,230
Listas,2014EP,08-052-004,695,231,0,231,0,1,230
Listas,2014EP,08-053-001,1011,356,0,356,0,0,356
Listas,2014EP,08-054-001,848,184,0,184,0,1,183
Listas,2014EP,08-054-002,864,220,0,220,0,2,218
Listas,2014EP,08-054-003,824,158,0,158,0,2,156
Listas,2014EP,08-055-001,59,35,0,35,0,0,35
Listas,2014EP,08-056-001,1118,327,0,327,0,2,325
Listas,2014EP,08-057-001,337,114,0,114,0,0,114
Listas,2014EP,08-058-001,989,237,0,237,0,1,236
Listas,2014EP,08-059-001,986,298,0,298,0,0,298
Listas,2014EP,08-059-002,1133,257,0,257,0,0,257
Listas,2014EP,08-059-003,1091,320,0,317,-3,0,317
Listas,2014EP,08-059-004,1140,280,0,280,0,0,280
Listas,2014EP,08-059-005,1134,270,0,270,0,1,269
Listas,2014EP,08-059-006,797,284,0,284,0,0,284
Listas,2014EP,08-059-007,974,363,0,363,0,1,362
Listas,2014EP,08-059-008,1413,897,1,896,-1,2,894
Listas,2014EP,08-059-009,863,288,0,288,0,0,288
Listas,2014EP,08-059-010,867,313,0,313,0,0,313
Listas,2014EP,08-059-011,990,237,0,237,0,0,237
Listas,2014EP,08-059-012,1065,181,0,181,0,0,181
Listas,2014EP,08-059-013,851,427,0,427,0,1,426
Listas,2014EP,08-059-014,953,334,0,334,0,0,334
Listas,2014EP,08-059-015,926,395,0,395,0,1,394
Listas,2014EP,08-059-016,925,367,0,367,0,0,367
Listas,2014EP,08-059-017,1026,372,0,372,0,3,369
Listas,2014EP,08-059-018,841,351,0,351,0,18,333
Listas,2014EP,08-059-019,783,321,0,321,0,0,321
Listas,2014EP,08-059-020,766,323,0,323,0,2,321
Listas,2014EP,08-059-021,1218,348,0,348,0,1,347
Listas,2014EP,08-059-022,1204,399,0,399,0,1,398
Listas,2014EP,08-059-023,1163,383,0,383,0,1,382
Listas,2014EP,08-059-024,1133,364,0,364,0,0,364
Listas,2014EP,08-059-025,1010,383,0,383,0,0,383
Listas,2014EP,08-059-026,946,356,0,356,0,1,355
Listas,2014EP,08-059-027,1185,399,0,399,0,1,398
Listas,2014EP,08-059-028,1241,512,0,511,-1,1,510
Listas,2014EP,08-059-029,1151,446,0,446,0,0,446
Listas,2014EP,08-059-030,968,412,0,411,-1,3,408
Listas,2014EP,08-059-031,938,344,0,343,-1,1,342
Listas,2014EP,08-059-032,967,336,0,336,0,0,336
Listas,2014EP,08-059-033,1035,367,0,365,-2,1,364
Listas,2014EP,08-059-034,1090,369,0,369,0,4,365
Listas,2014EP,08-059-035,1113,312,0,312,0,2,310
Listas,2014EP,08-059-036,1118,285,0,285,0,1,284
Listas,2014EP,08-059-037,1164,284,0,284,0,3,281
Listas,2014EP,08-059-038,1079,290,0,290,0,0,290
Listas,2014EP,08-059-039,1184,343,0,343,0,0,343
Listas,2014EP,08-059-040,1246,320,0,320,0,1,319
Listas,2014EP,08-059-041,996,301,0,301,0,0,301
Listas,2014EP,08-059-042,1089,301,0,301,0,0,301
Listas,2014EP,08-059-043,1069,258,0,258,0,0,258
Listas,2014EP,08-059-044,1032,264,0,264,0,2,262
Listas,2014EP,08-059-045,1050,355,0,354,-1,1,353
Listas,2014EP,08-059-046,1004,270,0,270,0,5,265
Listas,2014EP,08-059-047,1038,299,0,299,0,0,299
Listas,2014EP,08-059-048,972,252,0,252,0,2,250
Listas,2014EP,08-059-049,1000,248,0,248,0,2,246
Listas,2014EP,08-059-050,946,246,0,246,0,0,246
Listas,2014EP,08-059-051,942,266,0,266,0,1,265
Listas,2014EP,08-059-052,1173,500,0,500,0,0,500
Listas,2014EP,08-059-053,912,287,0,287,0,2,285
Listas,2014EP,08-059-054,1149,436,0,436,0,3,433
Listas,2014EP,08-059-055,1161,187,0,187,0,0,187
Listas,2014EP,08-059-056,1145,270,0,270,0,0,270
Listas,2014EP,08-059-057,1110,248,0,248,0,0,248
Listas,2014EP,08-059-058,1243,403,0,403,0,0,403
Listas,2014EP,08-059-059,1166,375,0,375,0,1,374
Listas,2014EP,08-059-060,1110,336,0,336,0,1,335
Listas,2014EP,08-059-061,1080,395,0,395,0,0,395
Listas,2014EP,08-059-062,1204,336,0,335,-1,2,333
Listas,2014EP,08-059-063,1166,304,0,304,0,0,304
Listas,2014EP,08-059-064,1246,322,0,322,0,1,321
Listas,2014EP,08-059-065,1139,297,0,297,0,0,297
Listas,2014EP,08-059-066,1114,263,0,263,0,0,263
Listas,2014EP,08-059-067,1159,230,0,230,0,2,228
Listas,2014EP,08-059-068,975,258,0,257,-1,2,255
Listas,2014EP,08-059-069,899,420,0,420,0,4,416
Listas,2014EP,08-059-070,909,369,0,369,0,3,366
Listas,2014EP,08-059-071,847,219,0,219,0,0,219
Listas,2014EP,08-059-072,1172,250,0,250,0,0,250
Listas,2014EP,08-059-073,1115,257,0,257,0,1,256
Listas,2014EP,08-059-074,1118,264,0,264,0,0,264
Listas,2014EP,08-059-075,934,401,0,401,0,3,398
Listas,2014EP,08-059-076,1012,362,0,362,0,0,362
Listas,2014EP,08-059-077,1148,457,0,457,0,1,456
Listas,2014EP,08-059-078,892,329,0,329,0,3,326
Listas,2014EP,08-059-079,1012,374,0,374,0,0,374
Listas,2014EP,08-059-080,1131,414,0,414,0,0,414
Listas,2014EP,08-059-081,932,351,0,351,0,4,347
Listas,2014EP,08-059-082,1081,168,0,168,0,0,168
Listas,2014EP,08-059-083,1116,244,0,244,0,1,243
Listas,2014EP,08-059-084,1146,255,0,254,-1,0,254
Listas,2014EP,08-059-085,1107,272,0,272,0,5,267
Listas,2014EP,08-059-086,1072,358,0,358,0,0,358
Listas,2014EP,08-059-087,1063,278,0,278,0,0,278
Listas,2014EP,08-059-088,1223,340,0,339,-1,2,337
Listas,2014EP,08-059-089,1061,265,0,265,0,0,265
Listas,2014EP,08-059-090,1210,347,0,347,0,0,347
Listas,2014EP,08-059-091,1157,386,0,386,0,2,384
Listas,2014EP,08-059-092,998,341,0,341,0,3,338
Listas,2014EP,08-059-093,939,263,0,263,0,1,262
Listas,2014EP,08-059-094,1197,322,0,322,0,1,321
Listas,2014EP,08-059-095,1223,434,0,434,0,0,434
Listas,2014EP,08-059-096,1136,339,0,339,0,2,337
Listas,2014EP,08-060-001,430,120,0,120,0,1,119
Listas,2014EP,08-061-001,1307,336,0,336,0,0,336
Listas,2014EP,08-062-001,1179,343,0,343,0,2,341
Listas,2014EP,08-063-001,660,131,0,131,0,0,131
Listas,2014EP,08-064-001,811,90,0,90,0,0,90
Listas,2014EP,08-064-002,823,118,0,118,0,2,116
Listas,2014EP,08-064-003,920,219,0,219,0,0,219
Listas,2014EP,08-065-001,1164,376,0,376,0,2,374
Listas,2014EP,08-065-002,1282,371,0,371,0,0,371
Listas,2014EP,08-065-003,1161,378,0,378,0,0,378
Listas,2014EP,08-065-004,1150,393,0,393,0,1,392
Listas,2014EP,08-066-001,1219,480,0,480,0,1,479
Listas,2014EP,08-067-001,1077,285,0,285,0,0,285
Listas,2014EP,08-067-002,875,237,0,237,0,1,236
Listas,2014EP,08-068-001,1169,288,0,288,0,0,288
Listas,2014EP,08-068-002,1199,294,0,294,0,1,293
Listas,2014EP,08-068-003,122,37,0,37,0,1,36
Listas,2014EP,08-069-001,665,154,0,154,0,1,153
Listas,2014EP,08-069-002,809,225,0,225,0,0,225
Listas,2014EP,08-070-001,948,244,1,243,-1,0,243
Listas,2014EP,08-070-002,995,197,0,197,0,0,197
Listas,2014EP,08-070-003,813,205,0,205,0,0,205
Listas,2014EP,08-071-001,1164,442,0,442,0,2,440
Listas,2014EP,08-072-001,954,216,0,216,0,0,216
Listas,2014EP,08-073-001,303,118,0,118,0,0,118
Listas,2014EP,08-074-001,551,187,0,187,0,1,186
Listas,2014EP,08-075-001,253,118,0,118,0,0,118
Listas,2014EP,08-076-001,772,155,0,155,0,1,154
Listas,2014EP,08-076-002,666,161,0,161,0,0,161
Listas,2014EP,08-077-001,1027,268,0,268,0,0,268
Listas,2014EP,08-078-001,825,174,0,174,0,1,173
Listas,2014EP,08-078-002,852,159,0,159,0,1,158
Listas,2014EP,08-078-003,752,155,0,155,0,0,155
Listas,2014EP,08-078-004,864,179,0,179,0,0,179
Listas,2014EP,08-078-005,800,167,0,167,0,0,167
Listas,2014EP,08-078-006,642,109,0,109,0,0,109
Listas,2014EP,08-078-007,204,20,0,20,0,0,20
Listas,2014EP,08-079-001,457,115,0,115,0,2,113
Listas,2014EP,08-080-001,697,190,0,190,0,0,190
Listas,2014EP,08-080-002,390,114,0,114,0,1,113
Listas,2014EP,08-081-001,158,55,0,55,0,0,55
Listas,2014EP,08-081-002,1157,415,0,415,0,2,413
Listas,2014EP,08-081-003,1094,342,0,342,0,3,339
Listas,2014EP,08-081-004,995,371,0,371,0,0,371
Listas,2014EP,08-081-005,1057,318,0,318,0,1,317
Listas,2014EP,08-081-006,1089,323,0,323,0,0,323
Listas,2014EP,08-081-007,1009,312,0,312,0,0,312
Listas,2014EP,08-081-008,1089,386,0,386,0,1,385
Listas,2014EP,08-081-009,904,239,0,239,0,0,239
Listas,2014EP,08-082-001,682,159,0,159,0,0,159
Listas,2014EP,08-082-002,934,165,0,165,0,1,164
Listas,2014EP,08-082-003,202,35,0,35,0,1,34
Listas,2014EP,08-083-001,174,78,0,78,0,0,78
Listas,2014EP,08-084-001,703,216,0,216,0,1,215
Listas,2014EP,08-085-001,295,93,0,93,0,0,93
Listas,2014EP,08-086-001,623,217,0,217,0,1,216
Listas,2014EP,08-087-001,795,174,0,174,0,0,174
Listas,2014EP,08-087-002,851,166,0,166,0,2,164
Listas,2014EP,08-088-001,1100,311,0,311,0,0,311
Listas,2014EP,08-088-002,1091,310,0,310,0,2,308
Listas,2014EP,08-089-001,889,295,0,295,0,8,287
Listas,2014EP,08-089-002,812,278,0,278,0,1,277
Listas,2014EP,08-090-001,979,278,0,278,0,0,278
Listas,2014EP,08-091-001,454,105,0,105,0,0,105
Listas,2014EP,08-092-001,678,156,0,156,0,2,154
Listas,2014EP,08-092-002,712,124,0,124,0,0,124
Listas,2014EP,08-093-001,1046,253,0,253,0,0,253
Listas,2014EP,08-093-002,683,190,0,190,0,2,188
Listas,2014EP,08-093-003,810,211,0,212,1,8,204
Listas,2014EP,08-094-001,581,213,0,213,0,2,211
Listas,2014EP,08-095-001,1159,344,0,344,0,1,343
Listas,2014EP,08-096-001,83,35,0,35,0,0,35
Listas,2014EP,08-097-001,405,79,0,79,0,0,79
Listas,2014EP,08-098-001,395,101,0,101,0,1,100
Listas,2014EP,08-099-001,683,160,0,160,0,1,159
Listas,2014EP,08-099-002,704,140,0,140,0,0,140
Listas,2014EP,08-100-001,491,158,0,158,0,0,158
Listas,2014EP,08-101-001,783,169,0,169,0,2,167
Listas,2014EP,08-102-001,71,33,0,33,0,0,33
Listas,2014EP,08-103-001,936,331,0,331,0,2,329
Listas,2014EP,08-104-001,798,215,0,215,0,0,215
Listas,2014EP,08-104-002,822,201,0,201,0,0,201
Listas,2014EP,08-104-003,991,397,0,397,0,1,396
Listas,2014EP,08-104-004,995,277,0,277,0,1,276
Listas,2014EP,08-104-005,968,226,0,226,0,2,224
Listas,2014EP,08-104-006,821,232,0,232,0,0,232
Listas,2014EP,08-104-007,868,188,0,188,0,0,188
Listas,2014EP,08-104-008,814,187,1,186,-1,0,186
Listas,2014EP,08-104-009,818,232,0,232,0,0,232
Listas,2014EP,08-104-010,922,242,0,242,0,3,239
Listas,2014EP,08-104-011,900,190,0,190,0,1,189
Listas,2014EP,08-104-012,759,262,0,262,0,1,261
Listas,2014EP,08-104-013,928,273,0,273,0,1,272
Listas,2014EP,08-104-014,868,226,0,226,0,2,224
Listas,2014EP,08-104-015,744,254,0,254,0,0,254
Listas,2014EP,08-104-016,779,251,0,251,0,1,250
Listas,2014EP,08-104-017,943,231,0,231,0,0,231
Listas,2014EP,08-104-018,862,264,0,264,0,1,263
Listas,2014EP,08-104-019,952,258,0,258,0,4,254
Listas,2014EP,08-104-020,838,208,0,208,0,1,207
Listas,2014EP,08-104-021,830,165,0,165,0,1,164
Listas,2014EP,08-104-022,912,227,0,227,0,1,226
Listas,2014EP,08-104-023,797,173,0,173,0,0,173
Listas,2014EP,08-104-024,746,198,0,198,0,1,197
Listas,2014EP,08-104-025,797,160,0,160,0,1,159
Listas,2014EP,08-104-026,887,196,0,196,0,0,196
Listas,2014EP,08-104-027,861,248,1,247,-1,2,245
Listas,2014EP,08-104-028,918,206,0,206,0,0,206
Listas,2014EP,08-104-029,799,199,0,199,0,1,198
Listas,2014EP,08-104-030,864,263,0,263,0,2,261
Listas,2014EP,08-105-001,957,241,0,241,0,1,240
Listas,2014EP,08-105-002,1045,212,0,212,0,0,212
Listas,2014EP,08-106-001,683,146,0,146,0,0,146
Listas,2014EP,08-106-002,687,126,0,126,0,1,125
Listas,2014EP,08-107-001,683,204,0,204,0,0,204
Listas,2014EP,08-108-001,771,213,1,212,-1,3,209
Listas,2014EP,08-109-001,769,218,0,218,0,0,218
Listas,2014EP,08-109-002,793,214,0,214,0,0,214
Listas,2014EP,08-110-001,809,236,0,236,0,0,236
Listas,2014EP,08-111-001,644,98,0,98,0,0,98
Listas,2014EP,08-111-002,865,149,0,149,0,0,149
Listas,2014EP,08-112-001,181,63,0,63,0,0,63
Listas,2014EP,08-113-001,380,125,0,125,0,0,125
Listas,2014EP,08-114-001,920,278,0,278,0,0,278
Listas,2014EP,08-114-002,923,238,0,238,0,2,236
Listas,2014EP,08-114-003,1104,284,0,284,0,1,283
Listas,2014EP,08-114-004,435,121,0,121,0,0,121
Listas,2014EP,08-115-001,733,200,0,200,0,0,200
Listas,2014EP,08-116-001,835,198,0,198,0,2,196
Listas,2014EP,08-116-002,782,229,0,229,0,0,229
Listas,2014EP,08-116-003,785,181,0,181,0,0,181
Listas,2014EP,08-117-001,1066,258,0,258,0,3,255
Listas,2014EP,08-117-002,709,166,0,166,0,2,164
Listas,2014EP,08-117-003,868,239,0,239,0,0,239
Listas,2014EP,08-117-004,175,87,0,87,0,1,86
Listas,2014EP,08-118-001,340,114,0,114,0,1,113
Listas,2014EP,08-119-001,234,78,0,78,0,0,78
Listas,2014EP,08-120-001,796,193,0,193,0,0,193
Listas,2014EP,08-121-001,1170,297,0,297,0,0,297
Listas,2014EP,08-122-001,838,279,0,279,0,1,278
Listas,2014EP,08-123-001,815,191,0,191,0,1,190
Listas,2014EP,08-123-002,892,206,0,206,0,0,206
Listas,2014EP,08-123-003,278,44,0,44,0,0,44
Listas,2014EP,08-124-001,279,129,0,129,0,0,129
Listas,2014EP,08-125-001,89,34,0,34,0,0,34
Listas,2014EP,08-126-001,214,96,0,96,0,2,94
Listas,2014EP,08-127-001,524,156,0,156,0,0,156
Listas,2014EP,08-128-001,503,139,0,139,0,2,137
Listas,2014EP,08-128-002,681,218,0,218,0,0,218
Listas,2014EP,08-128-003,463,108,0,108,0,1,107
Listas,2014EP,08-129-001,998,214,0,214,0,0,214
Listas,2014EP,08-130-001,418,107,0,107,0,1,106
Listas,2014EP,08-131-001,510,148,0,148,0,0,148
Listas,2014EP,08-132-001,623,186,0,186,0,1,185
Listas,2014EP,08-133-001,1027,192,0,192,0,1,191
Listas,2014EP,08-133-002,1014,238,0,238,0,0,238
Listas,2014EP,08-134-001,858,211,0,211,0,3,208
Listas,2014EP,08-135-001,74,41,0,41,0,1,40
Listas,2014EP,08-136-001,376,156,0,156,0,0,156
Listas,2014EP,08-137-001,445,129,0,129,0,0,129
Listas,2014EP,08-138-001,120,65,0,65,0,0,65
Listas,2014EP,08-139-001,825,278,0,278,0,2,276
Listas,2014EP,08-140-001,149,59,0,59,0,0,59
Listas,2014EP,08-141-001,247,78,0,78,0,0,78
Listas,2014EP,08-142-001,305,140,0,140,0,0,140
Listas,2014EP,08-143-001,446,103,0,103,0,0,103
Listas,2014EP,08-144-001,268,95,0,95,0,0,95
Listas,2014EP,08-145-001,360,127,0,127,0,0,127
Listas,2014EP,08-146-001,508,197,0,197,0,1,196
Listas,2014EP,08-146-002,193,68,0,68,0,1,67
Listas,2014EP,08-146-003,91,33,0,33,0,0,33
Listas,2014EP,08-147-001,260,88,0,88,0,0,88
Listas,2014EP,08-148-001,249,70,0,70,0,0,70
Listas,2014EP,08-149-001,928,261,0,261,0,0,261
Listas,2014EP,08-150-001,1602,872,0,872,0,4,868
Listas,2014EP,08-150-002,1068,315,0,315,0,2,313
Listas,2014EP,08-150-003,1082,348,0,347,-1,0,347
Listas,2014EP,08-150-004,1043,422,0,422,0,5,417
Listas,2014EP,08-150-005,838,325,0,325,0,3,322
Listas,2014EP,08-150-006,968,361,0,361,0,0,361
Listas,2014EP,08-150-007,1093,430,0,429,-1,2,427
Listas,2014EP,08-150-008,865,261,0,261,0,1,260
Listas,2014EP,08-150-009,1103,373,0,373,0,0,373
Listas,2014EP,08-150-010,848,250,0,250,0,0,250
Listas,2014EP,08-150-011,929,237,0,237,0,1,236
Listas,2014EP,08-150-012,948,268,0,268,0,0,268
Listas,2014EP,08-150-013,894,228,0,228,0,1,227
Listas,2014EP,08-150-014,871,226,0,226,0,1,225
Listas,2014EP,08-150-015,891,266,0,266,0,0,266
Listas,2014EP,08-150-016,1072,333,0,333,0,0,333
Listas,2014EP,08-150-017,688,265,0,265,0,2,263
Listas,2014EP,08-150-018,726,243,0,243,0,0,243
Listas,2014EP,08-150-019,1035,349,0,349,0,0,349
Listas,2014EP,08-150-020,1382,379,0,379,0,0,379
Listas,2014EP,08-150-021,898,253,0,253,0,0,253
Listas,2014EP,08-150-022,1153,338,0,338,0,0,338
Listas,2014EP,08-150-023,784,171,0,171,0,0,171
Listas,2014EP,08-150-024,639,149,0,149,0,1,148
Listas,2014EP,08-150-025,549,175,1,175,0,2,173
Listas,2014EP,08-150-026,720,181,0,181,0,0,181
Listas,2014EP,08-150-027,1005,265,0,265,0,1,264
Listas,2014EP,08-150-028,1198,310,0,310,0,0,310
Listas,2014EP,08-150-029,832,237,0,237,0,1,236
Listas,2014EP,08-150-030,1090,350,0,350,0,0,350
Listas,2014EP,08-150-031,1003,315,0,315,0,1,314
Listas,2014EP,08-150-032,1086,389,0,388,-1,2,386
Listas,2014EP,08-150-033,992,329,0,329,0,1,328
Listas,2014EP,08-150-034,902,310,0,310,0,2,308
Listas,2014EP,08-150-035,1184,401,0,401,0,8,393
Listas,2014EP,08-150-036,1087,377,0,377,0,1,376
Listas,2014EP,08-150-037,976,367,0,367,0,0,367
Listas,2014EP,08-150-038,986,473,0,471,-2,0,471
Listas,2014EP,08-150-039,1139,383,0,383,0,1,382
Listas,2014EP,08-150-040,1060,509,0,509,0,1,508
Listas,2014EP,08-150-041,833,411,0,411,0,1,410
Listas,2014EP,08-150-042,1028,375,0,375,0,1,374
Listas,2014EP,08-150-043,983,331,0,331,0,0,331
Listas,2014EP,08-150-044,714,296,0,296,0,3,293
Listas,2014EP,08-150-045,750,196,0,196,0,1,195
Listas,2014EP,08-150-046,1036,352,0,352,0,0,352
Listas,2014EP,08-150-047,1356,366,0,365,-1,0,365
Listas,2014EP,08-150-048,1033,357,0,357,0,0,357
Listas,2014EP,08-150-049,761,176,0,176,0,2,174
Listas,2014EP,08-151-001,657,257,0,257,0,2,255
Listas,2014EP,08-152-001,996,327,0,326,-1,0,326
Listas,2014EP,08-153-001,235,98,0,98,0,3,95
Listas,2014EP,08-154-001,362,102,0,102,0,0,102
Listas,2014EP,08-155-001,1081,289,0,289,0,1,288
Listas,2014EP,08-155-002,704,235,0,235,0,0,235
Listas,2014EP,08-156-001,747,246,0,246,0,3,243
Listas,2014EP,08-157-001,669,190,0,190,0,1,189
Listas,2014EP,08-158-001,1108,263,0,263,0,3,260
Listas,2014EP,08-159-001,573,162,0,162,0,0,162
Listas,2014EP,08-160-001,327,71,0,71,0,0,71
Listas,2014EP,08-161-001,579,178,0,178,0,0,178
Listas,2014EP,08-162-001,748,144,0,144,0,0,144
Listas,2014EP,08-163-001,172,69,0,69,0,0,69
Listas,2014EP,08-164-001,1243,272,0,272,0,0,272
Listas,2014EP,08-165-001,1107,154,0,154,0,1,153
Listas,2014EP,08-165-002,1045,229,0,229,0,1,228
Listas,2014EP,08-165-003,1120,266,0,266,0,0,266
Listas,2014EP,08-166-001,772,189,0,189,0,1,188
Listas,2014EP,08-166-002,712,166,0,166,0,0,166
Listas,2014EP,08-167-001,290,96,0,96,0,2,94
Listas,2014EP,08-168-001,811,217,0,217,0,0,217
Listas,2014EP,08-169-001,668,197,0,197,0,4,193
Listas,2014EP,08-170-001,59,36,0,36,0,0,36
Listas,2014EP,08-171-001,428,152,0,152,0,3,149
Listas,2014EP,08-172-001,1208,300,0,300,0,3,297
Listas,2014EP,08-173-001,325,99,0,99,0,1,98
Listas,2014EP,08-174-001,138,61,0,61,0,1,60
Listas,2014EP,08-175-001,747,291,0,291,0,2,289
Listas,2014EP,08-176-001,818,215,0,215,0,0,215
Listas,2014EP,08-177-001,160,72,0,72,0,0,72
Listas,2014EP,08-178-001,1080,272,0,272,0,0,272
Listas,2014EP,08-179-001,315,104,0,104,0,0,104
Listas,2014EP,08-180-001,119,50,0,50,0,0,50
Listas,2014EP,08-181-001,536,175,0,175,0,1,174
Listas,2014EP,08-182-001,442,67,0,67,0,0,67
Listas,2014EP,08-183-001,370,68,0,68,0,0,68
Listas,2014EP,09-001-001,729,167,0,168,1,12,156
Listas,2014EP,09-001-002,663,148,0,148,0,3,145
Listas,2014EP,09-002-001,438,140,0,140,0,0,140
Listas,2014EP,09-003-001,952,176,0,176,0,1,175
Listas,2014EP,09-003-002,935,105,0,105,0,0,105
Listas,2014EP,09-004-001,1033,221,0,221,0,0,221
Listas,2014EP,09-005-001,1007,304,0,304,0,0,304
Listas,2014EP,09-005-002,806,243,0,243,0,0,243
Listas,2014EP,09-005-003,920,287,0,287,0,1,286
Listas,2014EP,09-005-004,856,220,0,220,0,1,219
Listas,2014EP,09-005-005,750,212,0,212,0,2,210
Listas,2014EP,09-005-006,824,206,0,206,0,3,203
Listas,2014EP,09-005-007,859,276,0,274,-2,3,271
Listas,2014EP,09-005-008,957,243,0,243,0,0,243
Listas,2014EP,09-005-009,1037,176,0,176,0,1,175
Listas,2014EP,09-005-010,767,136,0,136,0,0,136
Listas,2014EP,09-005-011,1003,205,0,205,0,0,205
Listas,2014EP,09-005-012,892,141,0,141,0,2,139
Listas,2014EP,09-005-013,945,185,0,185,0,2,183
Listas,2014EP,09-005-014,850,229,0,229,0,0,229
Listas,2014EP,09-005-015,828,226,0,226,0,0,226
Listas,2014EP,09-005-016,872,197,0,197,0,1,196
Listas,2014EP,09-005-017,79,28,0,28,0,0,28
Listas,2014EP,09-006-001,661,138,0,138,0,0,138
Listas,2014EP,09-006-002,731,143,0,143,0,2,141
Listas,2014EP,09-006-003,738,119,0,119,0,1,118
Listas,2014EP,09-007-001,263,94,0,94,0,1,93
Listas,2014EP,09-008-001,755,129,0,129,0,2,127
Listas,2014EP,09-008-002,767,155,0,155,0,0,155
Listas,2014EP,09-009-001,866,240,0,240,0,1,239
Listas,2014EP,09-009-002,682,208,0,208,0,1,207
Listas,2014EP,09-009-003,702,178,0,178,0,0,178
Listas,2014EP,09-009-004,990,253,0,253,0,0,253
Listas,2014EP,09-009-005,715,103,0,103,0,1,102
Listas,2014EP,09-009-006,841,110,0,110,0,0,110
Listas,2014EP,09-009-007,785,218,0,218,0,0,218
Listas,2014EP,09-009-008,710,123,0,123,0,0,123
Listas,2014EP,09-009-009,824,287,0,287,0,0,287
Listas,2014EP,09-009-010,704,137,0,137,0,0,137
Listas,2014EP,09-009-011,836,233,0,233,0,0,233
Listas,2014EP,09-009-012,678,209,0,209,0,1,208
Listas,2014EP,09-009-013,994,215,0,215,0,2,213
Listas,2014EP,09-009-014,627,185,0,185,0,0,185
Listas,2014EP,09-009-015,755,142,0,142,0,1,141
Listas,2014EP,09-009-016,774,161,0,161,0,0,161
Listas,2014EP,09-010-001,169,50,0,50,0,0,50
Listas,2014EP,09-011-001,695,180,0,180,0,0,180
Listas,2014EP,09-011-002,666,187,0,187,0,2,185
Listas,2014EP,09-011-003,627,118,0,118,0,2,116
Listas,2014EP,09-011-004,776,135,0,135,0,1,134
Listas,2014EP,09-011-005,699,132,0,132,0,1,131
Listas,2014EP,09-012-001,660,155,0,155,0,1,154
Listas,2014EP,09-012-002,695,116,0,116,0,0,116
Listas,2014EP,09-012-003,746,110,0,110,0,2,108
Listas,2014EP,09-013-001,784,151,0,151,0,0,151
Listas,2014EP,09-014-001,1295,360,0,360,0,2,358
Listas,2014EP,09-014-002,1172,277,0,277,0,1,276
Listas,2014EP,09-015-001,408,92,0,92,0,0,92
Listas,2014EP,09-016-001,747,134,0,134,0,0,134
Listas,2014EP,09-016-002,769,109,0,109,0,0,109
Listas,2014EP,09-016-003,40,19,0,19,0,0,19
Listas,2014EP,09-017-001,511,96,0,96,0,0,96
Listas,2014EP,09-018-001,467,141,0,141,0,0,141
Listas,2014EP,09-018-002,730,90,0,90,0,0,90
Listas,2014EP,09-018-003,1472,396,0,396,0,3,393
Listas,2014EP,09-018-004,1182,291,0,291,0,0,291
Listas,2014EP,09-018-005,1125,179,0,179,0,0,179
Listas,2014EP,09-018-006,972,107,0,107,0,0,107
Listas,2014EP,09-018-007,1472,407,0,407,0,14,393
Listas,2014EP,09-018-008,1466,342,0,343,1,8,335
Listas,2014EP,09-018-009,1457,426,0,426,0,2,424
Listas,2014EP,09-018-010,1381,378,0,378,0,1,377
Listas,2014EP,09-018-011,1218,404,0,404,0,0,404
Listas,2014EP,09-018-012,1449,427,0,427,0,3,424
Listas,2014EP,09-018-013,1357,435,0,435,0,0,435
Listas,2014EP,09-018-014,1396,475,0,475,0,0,475
Listas,2014EP,09-018-015,1405,481,0,481,0,0,481
Listas,2014EP,09-018-016,1417,427,0,427,0,0,427
Listas,2014EP,09-018-017,1361,406,0,406,0,0,406
Listas,2014EP,09-018-018,751,193,0,193,0,1,192
Listas,2014EP,09-018-019,1137,314,0,314,0,0,314
Listas,2014EP,09-018-020,1208,375,1,374,-1,0,374
Listas,2014EP,09-018-021,1141,354,0,354,0,1,353
Listas,2014EP,09-018-022,1433,534,0,531,-3,2,529
Listas,2014EP,09-018-023,1371,434,0,434,0,2,432
Listas,2014EP,09-018-024,1431,547,0,547,0,3,544
Listas,2014EP,09-018-025,1386,403,0,403,0,1,402
Listas,2014EP,09-018-026,882,118,0,118,0,1,117
Listas,2014EP,09-018-027,847,86,0,86,0,0,86
Listas,2014EP,09-018-028,1465,220,0,220,0,1,219
Listas,2014EP,09-018-029,978,279,0,279,0,0,279
Listas,2014EP,09-018-030,1059,222,0,222,0,1,221
Listas,2014EP,09-018-031,1440,393,0,393,0,1,392
Listas,2014EP,09-018-032,1354,388,0,388,0,2,386
Listas,2014EP,09-018-033,1440,418,0,418,0,2,416
Listas,2014EP,09-018-034,1393,485,0,485,0,0,485
Listas,2014EP,09-018-035,1468,458,0,458,0,0,458
Listas,2014EP,09-018-036,1091,174,0,174,0,0,174
Listas,2014EP,09-018-037,1381,228,0,228,0,2,226
Listas,2014EP,09-018-038,1438,224,0,224,0,0,224
Listas,2014EP,09-018-039,922,320,0,320,0,0,320
Listas,2014EP,09-018-040,1196,301,0,301,0,1,300
Listas,2014EP,09-018-041,1458,328,0,328,0,1,327
Listas,2014EP,09-018-042,1484,404,0,404,0,1,403
Listas,2014EP,09-018-043,1356,384,0,384,0,4,380
Listas,2014EP,09-018-044,1475,439,0,439,0,3,436
Listas,2014EP,09-018-045,1427,420,0,418,-2,0,418
Listas,2014EP,09-018-046,1345,380,0,380,0,0,380
Listas,2014EP,09-018-047,1101,260,0,260,0,0,260
Listas,2014EP,09-018-048,1134,230,0,230,0,0,230
Listas,2014EP,09-018-049,1399,242,0,242,0,0,242
Listas,2014EP,09-018-050,1022,119,0,119,0,0,119
Listas,2014EP,09-018-051,1043,239,0,239,0,0,239
Listas,2014EP,09-018-052,869,237,0,237,0,0,237
Listas,2014EP,09-018-053,1077,342,0,342,0,1,341
Listas,2014EP,09-018-054,1338,446,0,446,0,5,441
Listas,2014EP,09-018-055,1193,426,0,426,0,2,424
Listas,2014EP,09-018-056,859,222,0,222,0,0,222
Listas,2014EP,09-018-057,938,93,0,93,0,0,93
Listas,2014EP,09-018-058,1412,387,0,387,0,1,386
Listas,2014EP,09-018-059,1177,427,0,427,0,0,427
Listas,2014EP,09-018-060,1439,346,0,346,0,0,346
Listas,2014EP,09-018-061,1435,293,0,293,0,2,291
Listas,2014EP,09-018-062,1279,327,0,327,0,1,326
Listas,2014EP,09-018-063,1368,303,0,303,0,1,302
Listas,2014EP,09-018-064,1323,241,0,241,0,1,240
Listas,2014EP,09-018-065,472,95,0,95,0,0,95
Listas,2014EP,09-018-066,1361,221,0,221,0,1,220
Listas,2014EP,09-018-067,1427,311,0,311,0,0,311
Listas,2014EP,09-018-068,1229,276,0,276,0,0,276
Listas,2014EP,09-018-069,1463,336,0,336,0,1,335
Listas,2014EP,09-018-070,1186,284,0,284,0,0,284
Listas,2014EP,09-018-071,1441,337,0,337,0,0,337
Listas,2014EP,09-018-072,530,142,0,142,0,0,142
Listas,2014EP,09-018-073,1092,197,0,197,0,0,197
Listas,2014EP,09-018-074,1450,250,0,250,0,1,249
Listas,2014EP,09-018-075,1459,317,0,317,0,0,317
Listas,2014EP,09-018-076,630,215,0,214,-1,0,214
Listas,2014EP,09-018-077,831,306,0,306,0,0,306
Listas,2014EP,09-018-078,1409,434,0,433,-1,1,432
Listas,2014EP,09-018-079,1203,264,0,264,0,0,264
Listas,2014EP,09-018-080,1052,255,0,255,0,2,253
Listas,2014EP,09-018-081,592,125,0,125,0,0,125
Listas,2014EP,09-018-082,1351,368,0,368,0,0,368
Listas,2014EP,09-018-083,817,245,0,245,0,0,245
Listas,2014EP,09-018-084,2286,1098,0,1098,0,2,1096
Listas,2014EP,09-018-085,1405,365,0,365,0,2,363
Listas,2014EP,09-018-086,1420,532,0,532,0,5,527
Listas,2014EP,09-018-087,827,289,1,289,0,1,288
Listas,2014EP,09-018-088,1306,365,0,365,0,0,365
Listas,2014EP,09-018-089,1397,422,0,422,0,0,422
Listas,2014EP,09-018-090,1450,519,0,519,0,2,517
Listas,2014EP,09-018-091,1438,430,0,430,0,2,428
Listas,2014EP,09-018-092,1318,392,0,390,-2,1,389
Listas,2014EP,09-018-093,756,242,0,242,0,0,242
Listas,2014EP,09-018-094,1307,528,0,528,0,0,528
Listas,2014EP,09-018-095,1096,438,0,437,-1,1,436
Listas,2014EP,09-018-096,1408,683,0,683,0,1,682
Listas,2014EP,09-018-097,799,316,0,316,0,0,316
Listas,2014EP,09-018-098,1194,374,0,374,0,1,373
Listas,2014EP,09-018-099,1458,561,0,561,0,0,561
Listas,2014EP,09-018-100,1445,390,0,390,0,1,389
Listas,2014EP,09-018-101,1466,405,0,405,0,1,404
Listas,2014EP,09-018-102,1482,406,0,406,0,3,403
Listas,2014EP,09-018-103,813,171,0,171,0,0,171
Listas,2014EP,09-018-104,414,126,0,126,0,0,126
Listas,2014EP,09-018-105,1052,345,0,345,0,1,344
Listas,2014EP,09-018-106,893,444,0,444,0,3,441
Listas,2014EP,09-018-107,1354,327,0,327,0,4,323
Listas,2014EP,09-018-108,210,28,0,28,0,0,28
Listas,2014EP,09-018-109,1420,365,0,364,-1,0,364
Listas,2014EP,09-018-110,1076,336,0,336,0,0,336
Listas,2014EP,09-018-111,1428,531,0,529,-2,5,524
Listas,2014EP,09-018-112,1274,358,0,358,0,4,354
Listas,2014EP,09-018-113,1145,435,0,435,0,1,434
Listas,2014EP,09-018-114,1405,401,0,401,0,0,401
Listas,2014EP,09-018-115,1075,159,0,159,0,3,156
Listas,2014EP,09-018-116,1048,356,0,356,0,0,356
Listas,2014EP,09-018-117,834,388,0,387,-1,1,386
Listas,2014EP,09-018-118,1389,499,0,499,0,2,497
Listas,2014EP,09-018-119,941,390,0,390,0,3,387
Listas,2014EP,09-018-120,1341,300,0,300,0,0,300
Listas,2014EP,09-018-121,1334,340,0,340,0,0,340
Listas,2014EP,09-018-122,1420,339,0,339,0,0,339
Listas,2014EP,09-018-123,1439,356,0,356,0,0,356
Listas,2014EP,09-018-124,890,184,0,184,0,0,184
Listas,2014EP,09-018-125,790,237,0,237,0,1,236
Listas,2014EP,09-018-126,1182,331,0,331,0,0,331
Listas,2014EP,09-018-127,962,292,0,292,0,3,289
Listas,2014EP,09-018-128,1242,401,0,401,0,1,400
Listas,2014EP,09-018-129,892,246,0,246,0,1,245
Listas,2014EP,09-018-130,394,64,0,64,0,0,64
Listas,2014EP,09-018-131,709,257,0,257,0,0,257
Listas,2014EP,09-018-132,469,136,0,136,0,0,136
Listas,2014EP,09-018-133,1152,420,0,418,-2,1,417
Listas,2014EP,09-018-134,898,233,0,232,-1,1,231
Listas,2014EP,09-018-135,1210,373,0,373,0,1,372
Listas,2014EP,09-018-136,908,243,0,243,0,0,243
Listas,2014EP,09-018-137,825,220,0,220,0,2,218
Listas,2014EP,09-018-138,1177,337,0,337,0,1,336
Listas,2014EP,09-018-139,1336,246,0,246,0,1,245
Listas,2014EP,09-018-140,1133,189,0,188,-1,0,188
Listas,2014EP,09-019-001,983,183,0,183,0,2,181
Listas,2014EP,09-019-002,979,117,0,117,0,1,116
Listas,2014EP,09-019-003,888,242,0,242,0,1,241
Listas,2014EP,09-019-004,953,199,0,199,0,0,199
Listas,2014EP,09-019-005,906,217,0,217,0,2,215
Listas,2014EP,09-019-006,1036,189,0,189,0,0,189
Listas,2014EP,09-019-007,934,221,0,221,0,0,221
Listas,2014EP,09-019-008,374,46,0,46,0,2,44
Listas,2014EP,09-020-001,993,197,0,197,0,1,196
Listas,2014EP,09-020-002,908,145,0,145,0,0,145
Listas,2014EP,09-020-003,1022,192,0,192,0,0,192
Listas,2014EP,09-020-004,844,162,0,162,0,0,162
Listas,2014EP,09-021-001,671,92,0,92,0,1,91
Listas,2014EP,09-021-002,648,143,0,143,0,0,143
Listas,2014EP,09-021-003,735,138,0,138,0,0,138
Listas,2014EP,09-021-004,737,134,0,134,0,0,134
Listas,2014EP,09-021-005,770,145,0,145,0,1,144
Listas,2014EP,09-021-006,507,66,0,66,0,0,66
Listas,2014EP,09-021-007,138,39,0,39,0,0,39
Listas,2014EP,09-022-001,1109,191,0,191,0,0,191
Listas,2014EP,09-023-001,266,71,0,71,0,0,71
Listas,2014EP,09-024-001,869,159,0,159,0,1,158
Listas,2014EP,09-024-002,862,202,0,202,0,0,202
Listas,2014EP,09-024-003,835,158,0,158,0,0,158
Listas,2014EP,09-024-004,849,188,0,188,0,0,188
Listas,2014EP,09-025-001,956,194,0,194,0,2,192
Listas,2014EP,09-026-001,428,90,0,90,0,0,90
Listas,2014EP,09-026-002,394,84,0,84,0,0,84
Listas,2014EP,09-026-003,424,70,0,70,0,1,69
Listas,2014EP,09-026-004,178,53,0,53,0,1,52
Listas,2014EP,09-027-001,659,112,0,112,0,1,111
Listas,2014EP,09-028-001,945,160,0,160,0,0,160
Listas,2014EP,09-028-002,1028,213,0,213,0,1,212
Listas,2014EP,09-028-003,59,20,0,20,0,0,20
Listas,2014EP,09-029-001,854,149,0,149,0,1,148
Listas,2014EP,09-029-002,767,140,0,140,0,0,140
Listas,2014EP,09-030-001,1112,289,0,289,0,0,289
Listas,2014EP,09-030-002,1001,293,0,292,-1,0,292
Listas,2014EP,09-030-003,657,115,0,115,0,1,114
Listas,2014EP,09-030-004,1199,296,0,296,0,1,295
Listas,2014EP,09-030-005,1075,331,0,331,0,0,331
Listas,2014EP,09-030-006,1202,204,0,204,0,0,204
Listas,2014EP,09-030-007,746,84,0,84,0,0,84
Listas,2014EP,09-030-008,216,66,0,66,0,0,66
Listas,2014EP,09-030-009,1167,152,0,152,0,0,152
Listas,2014EP,09-030-010,1171,224,0,224,0,1,223
Listas,2014EP,09-030-011,804,162,1,161,-1,1,160
Listas,2014EP,09-030-012,1147,368,0,368,0,4,364
Listas,2014EP,09-030-013,712,123,0,123,0,0,123
Listas,2014EP,09-030-014,936,291,0,291,0,1,290
Listas,2014EP,09-030-015,648,206,0,206,0,1,205
Listas,2014EP,09-030-016,786,190,0,190,0,0,190
Listas,2014EP,09-030-017,852,203,0,203,0,2,201
Listas,2014EP,09-030-018,770,197,0,197,0,1,196
Listas,2014EP,09-030-019,1241,239,0,239,0,3,236
Listas,2014EP,09-030-020,705,158,0,158,0,0,158
Listas,2014EP,09-030-021,1314,319,0,319,0,0,319
Listas,2014EP,09-030-022,949,284,0,284,0,1,283
Listas,2014EP,09-030-023,1011,137,0,137,0,4,133
Listas,2014EP,09-030-024,980,117,0,117,0,0,117
Listas,2014EP,09-030-025,1151,211,0,211,0,1,210
Listas,2014EP,09-030-026,707,102,0,102,0,0,102
Listas,2014EP,09-030-027,687,101,0,101,0,2,99
Listas,2014EP,09-031-001,862,248,0,248,0,0,248
Listas,2014EP,09-031-002,1041,259,0,259,0,0,259
Listas,2014EP,09-031-003,996,298,0,298,0,0,298
Listas,2014EP,09-031-004,1006,227,0,227,0,2,225
Listas,2014EP,09-031-005,901,168,0,168,0,0,168
Listas,2014EP,09-031-006,834,211,0,211,0,0,211
Listas,2014EP,09-031-007,817,134,0,134,0,2,132
Listas,2014EP,09-031-008,703,176,0,176,0,1,175
Listas,2014EP,09-032-001,1049,157,0,157,0,0,157
Listas,2014EP,09-032-002,939,139,0,139,0,0,139
Listas,2014EP,09-032-003,1217,168,0,168,0,1,167
Listas,2014EP,09-032-004,1222,230,0,230,0,1,229
Listas,2014EP,09-032-005,1009,127,0,127,0,0,127
Listas,2014EP,09-032-006,1243,211,1,211,0,0,211
Listas,2014EP,09-032-007,1332,327,0,327,0,1,326
Listas,2014EP,09-032-008,1308,267,0,267,0,1,266
Listas,2014EP,09-032-009,120,24,0,24,0,0,24
Listas,2014EP,09-033-001,947,211,0,211,0,1,210
Listas,2014EP,09-033-002,853,174,0,174,0,2,172
Listas,2014EP,09-033-003,906,179,0,179,0,1,178
Listas,2014EP,09-033-004,944,171,0,171,0,0,171
Listas,2014EP,09-033-005,916,151,0,151,0,0,151
Listas,2014EP,09-033-006,936,241,0,241,0,0,241
Listas,2014EP,09-033-007,607,125,0,125,0,2,123
Listas,2014EP,09-033-008,625,109,0,109,0,1,108
Listas,2014EP,09-033-009,601,136,0,136,0,0,136
Listas,2014EP,09-033-010,810,152,0,152,0,0,152
Listas,2014EP,09-033-011,876,180,0,180,0,1,179
Listas,2014EP,09-033-012,872,181,0,181,0,0,181
Listas,2014EP,09-033-013,889,145,0,145,0,1,144
Listas,2014EP,09-033-014,830,228,0,228,0,2,226
Listas,2014EP,09-033-015,828,159,0,159,0,0,159
Listas,2014EP,09-033-016,820,134,0,134,0,2,132
Listas,2014EP,09-033-017,597,115,0,115,0,0,115
Listas,2014EP,09-033-018,345,104,0,104,0,2,102
Listas,2014EP,09-034-001,1270,220,0,220,0,0,220
Listas,2014EP,09-034-002,1182,246,0,246,0,0,246
Listas,2014EP,09-034-003,1134,165,0,165,0,2,163
Listas,2014EP,09-034-004,1095,158,0,158,0,1,157
Listas,2014EP,09-034-005,1288,274,0,274,0,2,272
Listas,2014EP,09-034-006,1091,163,0,163,0,1,162
Listas,2014EP,09-034-007,835,142,0,142,0,0,142
Listas,2014EP,09-034-008,773,98,0,98,0,0,98
Listas,2014EP,09-034-009,629,100,0,100,0,0,100
Listas,2014EP,09-034-010,896,101,0,101,0,0,101
Listas,2014EP,09-035-001,1316,493,0,493,0,2,491
Listas,2014EP,09-035-002,1097,354,0,353,-1,0,353
Listas,2014EP,09-035-003,991,276,0,276,0,4,272
Listas,2014EP,09-035-004,899,251,0,251,0,0,251
Listas,2014EP,09-035-005,831,194,0,194,0,1,193
Listas,2014EP,09-035-006,926,233,0,233,0,0,233
Listas,2014EP,09-035-007,791,182,0,182,0,1,181
Listas,2014EP,09-035-008,1108,250,0,250,0,2,248
Listas,2014EP,09-035-009,757,140,0,140,0,2,138
Listas,2014EP,09-035-010,908,214,0,214,0,0,214
Listas,2014EP,09-035-011,872,251,0,251,0,0,251
Listas,2014EP,09-035-012,713,116,0,116,0,0,116
Listas,2014EP,09-035-013,950,156,0,156,0,0,156
Listas,2014EP,09-035-014,881,170,0,170,0,0,170
Listas,2014EP,09-035-015,1015,336,0,336,0,3,333
Listas,2014EP,09-035-016,1180,289,0,289,0,0,289
Listas,2014EP,09-035-017,1082,187,1,187,0,1,186
Listas,2014EP,09-035-018,1186,149,0,149,0,0,149
Listas,2014EP,09-035-019,1165,374,0,374,0,0,374
Listas,2014EP,09-035-020,1015,331,0,331,0,1,330
Listas,2014EP,09-036-001,808,142,0,142,0,0,142
Listas,2014EP,09-036-002,823,212,0,212,0,2,210
Listas,2014EP,09-036-003,812,112,0,112,0,0,112
Listas,2014EP,09-037-001,858,183,0,183,0,1,182
Listas,2014EP,09-038-001,1103,258,0,258,0,0,258
Listas,2014EP,09-038-002,192,27,0,27,0,0,27
Listas,2014EP,09-039-001,1214,256,0,256,0,1,255
Listas,2014EP,09-039-002,1159,146,0,146,0,2,144
Listas,2014EP,09-039-003,1063,132,0,132,0,1,131
Listas,2014EP,09-039-004,1095,192,0,192,0,1,191
Listas,2014EP,09-040-001,961,191,0,191,0,0,191
Listas,2014EP,09-040-002,1019,260,0,260,0,1,259
Listas,2014EP,09-040-003,965,192,0,192,0,0,192
Listas,2014EP,09-040-004,1020,230,0,230,0,2,228
Listas,2014EP,09-040-005,1007,262,0,262,0,3,259
Listas,2014EP,09-041-001,998,200,0,200,0,0,200
Listas,2014EP,09-042-001,503,88,0,88,0,0,88
Listas,2014EP,09-043-001,664,129,0,129,0,0,129
Listas,2014EP,09-043-002,647,152,0,152,0,1,151
Listas,2014EP,09-043-003,641,121,0,121,0,0,121
Listas,2014EP,09-043-004,619,92,0,92,0,0,92
Listas,2014EP,09-043-005,644,123,0,123,0,0,123
Listas,2014EP,09-043-006,621,66,0,66,0,0,66
Listas,2014EP,09-043-007,505,92,0,92,0,0,92
Listas,2014EP,09-043-008,101,20,0,20,0,0,20
Listas,2014EP,09-044-001,720,98,0,98,0,0,98
Listas,2014EP,09-044-002,916,186,0,186,0,1,185
Listas,2014EP,09-045-001,681,143,0,143,0,0,143
Listas,2014EP,09-046-001,778,221,0,221,0,0,221
Listas,2014EP,09-046-002,77,43,0,43,0,1,42
Listas,2014EP,09-047-001,990,210,3,207,-3,1,206
Listas,2014EP,09-047-002,845,106,0,106,0,1,105
Listas,2014EP,09-047-003,1174,189,0,189,0,2,187
Listas,2014EP,09-047-004,977,99,0,99,0,0,99
Listas,2014EP,09-047-005,764,80,0,80,0,0,80
Listas,2014EP,09-047-006,880,127,0,127,0,0,127
Listas,2014EP,09-048-001,777,180,0,180,0,1,179
Listas,2014EP,09-049-001,526,103,0,103,0,2,101
Listas,2014EP,09-050-001,527,100,0,100,0,0,100
Listas,2014EP,09-051-001,814,196,0,196,0,1,195
Listas,2014EP,09-051-002,1083,182,0,182,0,0,182
Listas,2014EP,09-051-003,917,277,0,277,0,1,276
Listas,2014EP,09-051-004,787,169,0,169,0,0,169
Listas,2014EP,09-052-001,844,137,0,137,0,0,137
Listas,2014EP,09-052-002,919,165,0,165,0,0,165
Listas,2014EP,09-053-001,1179,251,0,251,0,3,248
Listas,2014EP,09-053-002,1117,253,0,253,0,0,253
Listas,2014EP,09-054-001,988,170,0,170,0,1,169
Listas,2014EP,09-054-002,37,5,0,5,0,0,5
Listas,2014EP,09-055-001,910,122,0,122,0,0,122
Listas,2014EP,09-055-002,918,140,0,139,-1,1,138
Listas,2014EP,09-056-001,1064,163,0,163,0,0,163
Listas,2014EP,09-056-002,994,172,0,172,0,0,172
Listas,2014EP,09-056-003,1109,224,0,224,0,1,223
Listas,2014EP,09-056-004,1050,112,0,112,0,0,112
Listas,2014EP,09-056-005,1058,235,0,235,0,2,233
Listas,2014EP,09-056-006,950,130,0,130,0,0,130
Listas,2014EP,09-056-007,957,153,0,153,0,0,153
Listas,2014EP,09-057-001,452,91,0,91,0,0,91
Listas,2014EP,09-057-002,803,172,0,172,0,2,170
Listas,2014EP,09-057-003,623,126,0,126,0,1,125
Listas,2014EP,09-057-004,934,231,0,231,0,2,229
Listas,2014EP,09-057-005,95,12,0,12,0,0,12
Listas,2014EP,09-057-006,174,42,0,42,0,0,42
Listas,2014EP,09-058-001,833,296,0,296,0,3,293
Listas,2014EP,09-058-002,756,186,0,184,-2,0,184
Listas,2014EP,09-058-003,720,216,0,216,0,1,215
Listas,2014EP,09-058-004,618,250,0,248,-2,0,248
Listas,2014EP,09-058-005,914,311,0,311,0,4,307
Listas,2014EP,09-058-006,1074,263,0,263,0,3,260
Listas,2014EP,09-058-007,761,189,0,189,0,1,188
Listas,2014EP,09-058-008,390,185,0,185,0,0,185
Listas,2014EP,09-059-001,791,147,0,147,0,0,147
Listas,2014EP,09-059-002,842,212,0,212,0,3,209
Listas,2014EP,09-059-003,577,135,0,135,0,2,133
Listas,2014EP,09-059-004,740,142,0,142,0,0,142
Listas,2014EP,09-059-005,86,29,0,29,0,1,28
Listas,2014EP,09-060-001,842,125,0,125,0,2,123
Listas,2014EP,09-060-002,828,147,0,147,0,0,147
Listas,2014EP,09-061-001,897,231,0,231,0,1,230
Listas,2014EP,09-061-002,1059,306,1,305,-1,5,300
Listas,2014EP,09-062-001,782,189,0,189,0,0,189
Listas,2014EP,09-062-002,931,217,0,217,0,0,217
Listas,2014EP,09-062-003,896,264,0,264,0,0,264
Listas,2014EP,09-062-004,720,162,0,162,0,1,161
Listas,2014EP,09-062-005,1064,258,0,258,0,0,258
Listas,2014EP,09-062-006,1149,209,0,209,0,0,209
Listas,2014EP,09-062-007,988,150,0,150,0,1,149
Listas,2014EP,09-063-001,853,220,0,220,0,1,219
Listas,2014EP,09-063-002,670,236,0,236,0,0,236
Listas,2014EP,09-063-003,740,241,0,241,0,1,240
Listas,2014EP,09-063-004,810,268,0,268,0,2,266
Listas,2014EP,09-063-005,849,199,0,199,0,1,198
Listas,2014EP,09-063-006,740,179,0,179,0,1,178
Listas,2014EP,09-063-007,801,199,0,199,0,0,199
Listas,2014EP,09-063-008,788,225,0,225,0,2,223
Listas,2014EP,09-063-009,858,268,0,268,0,1,267
Listas,2014EP,09-063-010,687,187,0,187,0,0,187
Listas,2014EP,09-063-011,704,174,0,174,0,0,174
Listas,2014EP,09-063-012,802,175,1,174,-1,1,173
Listas,2014EP,09-063-013,845,244,0,244,0,2,242
Listas,2014EP,09-063-014,606,153,0,153,0,1,152
Listas,2014EP,09-063-015,769,156,0,156,0,0,156
Listas,2014EP,09-063-016,818,195,1,194,-1,1,193
Listas,2014EP,09-064-001,727,134,0,134,0,0,134
Listas,2014EP,09-065-001,887,215,0,215,0,3,212
Listas,2014EP,09-065-002,945,179,0,179,0,1,178
Listas,2014EP,09-066-001,822,148,0,148,0,1,147
Listas,2014EP,09-066-002,782,154,0,154,0,0,154
Listas,2014EP,09-066-003,776,163,0,163,0,0,163
Listas,2014EP,09-067-001,923,210,0,210,0,1,209
Listas,2014EP,09-068-001,999,179,0,179,0,1,178
Listas,2014EP,09-068-002,73,35,0,35,0,0,35
Listas,2014EP,09-069-001,510,87,0,87,0,0,87
Listas,2014EP,09-069-002,568,114,0,114,0,2,112
Listas,2014EP,09-070-001,1109,186,0,186,0,0,186
Listas,2014EP,09-070-002,1036,142,0,142,0,1,141
Listas,2014EP,09-070-003,988,197,2,195,-2,4,191
Listas,2014EP,09-070-004,1037,197,0,197,0,1,196
Listas,2014EP,09-070-005,938,167,0,167,0,0,167
Listas,2014EP,09-071-001,835,163,0,163,0,0,163
Listas,2014EP,09-072-001,695,121,0,121,0,0,121
Listas,2014EP,09-072-002,732,128,0,128,0,1,127
Listas,2014EP,09-072-003,895,112,0,112,0,0,112
Listas,2014EP,09-072-004,791,102,0,102,0,0,102
Listas,2014EP,09-072-005,620,120,0,120,0,0,120
Listas,2014EP,09-072-006,75,18,0,18,0,0,18
Listas,2014EP,09-073-001,622,135,0,135,0,0,135
Listas,2014EP,09-074-001,263,48,0,48,0,0,48
Listas,2014EP,09-075-001,496,114,0,114,0,0,114
Listas,2014EP,09-076-001,811,172,0,172,0,0,172
Listas,2014EP,09-077-001,1219,209,0,209,0,0,209
Listas,2014EP,09-078-001,756,172,0,172,0,0,172
Listas,2014EP,09-079-001,1050,255,0,255,0,1,254
Listas,2014EP,09-079-002,890,226,0,226,0,3,223
Listas,2014EP,09-079-003,822,248,0,248,0,1,247
Listas,2014EP,09-079-004,748,266,0,266,0,2,264
Listas,2014EP,09-079-005,804,272,0,272,0,3,269
Listas,2014EP,09-080-001,975,236,0,236,0,2,234
Listas,2014EP,09-081-001,125,42,0,42,0,0,42
Listas,2014EP,09-082-001,1298,267,0,267,0,2,265
Listas,2014EP,10-001-001,1079,337,0,337,0,3,334
Listas,2014EP,10-001-002,1023,261,0,261,0,1,260
Listas,2014EP,10-002-001,675,157,0,157,0,2,155
Listas,2014EP,10-002-002,743,203,0,203,0,0,203
Listas,2014EP,10-002-003,726,185,0,185,0,0,185
Listas,2014EP,10-003-001,605,201,0,201,0,0,201
Listas,2014EP,10-004-001,1146,404,0,404,0,2,402
Listas,2014EP,10-004-002,1126,306,0,306,0,1,305
Listas,2014EP,10-005-001,761,169,0,169,0,1,168
Listas,2014EP,10-005-002,644,161,0,161,0,0,161
Listas,2014EP,10-005-003,621,165,0,165,0,1,164
Listas,2014EP,10-006-001,728,178,0,178,0,0,178
Listas,2014EP,10-006-002,740,160,0,160,0,1,159
Listas,2014EP,10-007-001,1061,200,0,200,0,1,199
Listas,2014EP,10-008-001,531,146,0,146,0,0,146
Listas,2014EP,10-008-002,396,108,0,108,0,1,107
Listas,2014EP,10-009-001,314,100,0,100,0,1,99
Listas,2014EP,10-010-001,546,152,0,152,0,0,152
Listas,2014EP,10-011-001,703,131,0,131,0,3,128
Listas,2014EP,10-011-002,635,135,0,135,0,1,134
Listas,2014EP,10-011-003,820,140,0,140,0,1,139
Listas,2014EP,10-012-001,826,209,0,209,0,1,208
Listas,2014EP,10-012-002,891,222,0,222,0,1,221
Listas,2014EP,10-012-003,698,192,0,192,0,2,190
Listas,2014EP,10-013-001,1111,223,0,223,0,0,223
Listas,2014EP,10-014-001,632,182,0,182,0,4,178
Listas,2014EP,10-015-001,815,235,0,235,0,0,235
Listas,2014EP,10-015-002,799,195,0,195,0,3,192
Listas,2014EP,10-015-003,793,179,0,179,0,3,176
Listas,2014EP,10-016-001,851,231,0,231,0,3,228
Listas,2014EP,10-017-001,255,82,0,82,0,0,82
Listas,2014EP,10-018-001,622,197,0,197,0,1,196
Listas,2014EP,10-019-001,616,88,0,88,0,0,88
Listas,2014EP,10-019-002,578,69,0,69,0,0,69
Listas,2014EP,10-019-003,608,127,0,127,0,2,125
Listas,2014EP,10-020-001,526,159,0,159,0,0,159
Listas,2014EP,10-021-001,939,226,0,226,0,2,224
Listas,2014EP,10-022-001,757,210,0,210,0,0,210
Listas,2014EP,10-022-002,885,294,0,294,0,0,294
Listas,2014EP,10-023-001,771,118,0,118,0,0,118
Listas,2014EP,10-024-001,916,190,0,190,0,2,188
Listas,2014EP,10-024-002,871,179,0,179,0,1,178
Listas,2014EP,10-024-003,852,178,0,178,0,1,177
Listas,2014EP,10-025-001,778,348,0,348,0,1,347
Listas,2014EP,10-025-002,665,270,0,270,0,0,270
Listas,2014EP,10-025-003,1100,394,0,394,0,3,391
Listas,2014EP,10-025-004,1068,434,0,434,0,2,432
Listas,2014EP,10-025-005,1055,355,0,355,0,2,353
Listas,2014EP,10-025-006,1073,415,0,414,-1,1,413
Listas,2014EP,10-025-007,1067,409,0,409,0,2,407
Listas,2014EP,10-025-008,858,358,0,358,0,1,357
Listas,2014EP,10-025-009,853,294,0,294,0,0,294
Listas,2014EP,10-025-010,990,345,0,345,0,1,344
Listas,2014EP,10-025-011,1119,415,0,415,0,1,414
Listas,2014EP,10-025-012,1100,437,0,437,0,1,436
Listas,2014EP,10-025-013,1070,333,0,333,0,0,333
Listas,2014EP,10-025-014,1055,406,0,405,-1,2,403
Listas,2014EP,10-025-015,1112,370,0,370,0,3,367
Listas,2014EP,10-025-016,794,329,0,329,0,0,329
Listas,2014EP,10-025-017,653,239,0,239,0,3,236
Listas,2014EP,10-025-018,730,291,0,291,0,0,291
Listas,2014EP,10-025-019,923,245,0,245,0,0,245
Listas,2014EP,10-025-020,554,169,0,169,0,0,169
Listas,2014EP,10-025-021,1099,409,2,407,-2,0,407
Listas,2014EP,10-025-022,1148,403,0,403,0,1,402
Listas,2014EP,10-025-023,1248,577,0,576,-1,5,571
Listas,2014EP,10-025-024,957,379,0,379,0,0,379
Listas,2014EP,10-025-025,978,369,0,369,0,2,367
Listas,2014EP,10-025-026,856,315,0,315,0,1,314
Listas,2014EP,10-025-027,858,339,0,339,0,0,339
Listas,2014EP,10-025-028,1085,237,0,237,0,0,237
Listas,2014EP,10-025-029,890,330,0,329,-1,0,329
Listas,2014EP,10-025-030,1016,369,0,369,0,3,366
Listas,2014EP,10-025-031,754,338,0,338,0,2,336
Listas,2014EP,10-025-032,857,214,0,213,-1,1,212
Listas,2014EP,10-025-033,924,262,0,262,0,0,262
Listas,2014EP,10-025-034,949,271,0,271,0,0,271
Listas,2014EP,10-025-035,759,227,0,227,0,1,226
Listas,2014EP,10-025-036,917,258,0,259,1,9,250
Listas,2014EP,10-025-037,1023,281,0,281,0,1,280
Listas,2014EP,10-025-038,982,331,0,331,0,1,330
Listas,2014EP,10-025-039,931,264,0,264,0,1,263
Listas,2014EP,10-025-040,1023,212,1,211,-1,0,211
Listas,2014EP,10-025-041,1003,288,0,288,0,1,287
Listas,2014EP,10-025-042,1068,288,0,288,0,0,288
Listas,2014EP,10-025-043,776,184,0,184,0,0,184
Listas,2014EP,10-025-044,1139,287,0,287,0,1,286
Listas,2014EP,10-025-045,1200,379,0,379,0,1,378
Listas,2014EP,10-025-046,795,243,0,243,0,2,241
Listas,2014EP,10-025-047,819,241,0,241,0,1,240
Listas,2014EP,10-026-001,1178,329,0,329,0,5,324
Listas,2014EP,10-027-001,470,153,0,153,0,1,152
Listas,2014EP,10-028-001,219,59,0,59,0,0,59
Listas,2014EP,10-028-002,467,111,1,110,-1,0,110
Listas,2014EP,10-028-003,424,96,0,96,0,1,95
Listas,2014EP,10-029-001,531,158,0,158,0,1,157
Listas,2014EP,10-030-001,821,266,0,266,0,0,266
Listas,2014EP,10-030-002,726,206,0,206,0,0,206
Listas,2014EP,10-031-001,893,256,0,256,0,1,255
Listas,2014EP,10-032-001,497,219,0,219,0,2,217
Listas,2014EP,10-033-001,711,129,0,129,0,0,129
Listas,2014EP,10-033-002,598,86,0,86,0,0,86
Listas,2014EP,10-033-003,619,110,0,110,0,2,108
Listas,2014EP,10-033-004,706,122,0,122,0,0,122
Listas,2014EP,10-034-001,644,97,0,97,0,0,97
Listas,2014EP,10-035-001,290,134,0,134,0,0,134
Listas,2014EP,10-036-001,843,232,0,232,0,1,231
Listas,2014EP,10-037-001,982,264,0,264,0,1,263
Listas,2014EP,10-037-002,941,198,0,198,0,1,197
Listas,2014EP,10-037-003,933,317,0,317,0,2,315
Listas,2014EP,10-038-001,676,157,0,157,0,0,157
Listas,2014EP,10-038-002,661,168,0,167,-1,1,166
Listas,2014EP,10-038-003,831,276,0,276,0,0,276
Listas,2014EP,10-038-004,979,265,0,265,0,0,265
Listas,2014EP,10-038-005,629,135,0,135,0,0,135
Listas,2014EP,10-038-006,626,157,0,157,0,1,156
Listas,2014EP,10-038-007,816,177,0,177,0,2,175
Listas,2014EP,10-038-008,982,239,0,239,0,1,238
Listas,2014EP,10-039-001,668,304,0,304,0,0,304
Listas,2014EP,10-039-002,1102,486,0,486,0,3,483
Listas,2014EP,10-039-003,688,242,0,242,0,1,241
Listas,2014EP,10-039-004,833,300,1,299,-1,0,299
Listas,2014EP,10-039-005,1056,274,0,274,0,2,272
Listas,2014EP,10-039-006,914,382,0,382,0,2,380
Listas,2014EP,10-039-007,930,368,0,368,0,0,368
Listas,2014EP,10-039-008,779,307,0,307,0,0,307
Listas,2014EP,10-039-009,923,381,0,381,0,1,380
Listas,2014EP,10-039-010,802,340,0,340,0,1,339
Listas,2014EP,10-039-011,1124,431,0,431,0,2,429
Listas,2014EP,10-039-012,762,289,0,289,0,2,287
Listas,2014EP,10-039-013,874,283,0,283,0,1,282
Listas,2014EP,10-039-014,815,343,0,343,0,1,342
Listas,2014EP,10-039-015,777,236,0,236,0,0,236
Listas,2014EP,10-039-016,932,275,0,275,0,0,275
Listas,2014EP,10-039-017,756,240,0,240,0,0,240
Listas,2014EP,10-039-018,765,287,0,288,1,9,279
Listas,2014EP,10-039-019,804,244,0,244,0,1,243
Listas,2014EP,10-039-020,965,231,0,231,0,0,231
Listas,2014EP,10-039-021,834,200,0,200,0,0,200
Listas,2014EP,10-039-022,926,303,0,303,0,0,303
Listas,2014EP,10-039-023,1076,313,0,313,0,0,313
Listas,2014EP,10-039-024,564,238,0,238,0,0,238
Listas,2014EP,10-039-025,870,284,0,284,0,0,284
Listas,2014EP,10-039-026,664,222,1,222,0,1,221
Listas,2014EP,10-039-027,530,176,0,176,0,0,176
Listas,2014EP,10-039-028,921,308,0,308,0,0,308
Listas,2014EP,10-039-029,803,276,0,276,0,0,276
Listas,2014EP,10-039-030,763,168,0,168,0,3,165
Listas,2014EP,10-040-001,1117,363,0,363,0,0,363
Listas,2014EP,10-040-002,1037,323,0,323,0,1,322
Listas,2014EP,10-041-001,1093,205,0,205,0,0,205
Listas,2014EP,10-042-001,763,212,0,212,0,3,209
Listas,2014EP,10-042-002,606,160,0,160,0,3,157
Listas,2014EP,10-042-003,698,195,0,195,0,0,195
Listas,2014EP,10-043-001,745,242,0,242,0,1,241
Listas,2014EP,10-043-002,901,280,0,280,0,1,279
Listas,2014EP,10-043-003,853,309,0,309,0,0,309
Listas,2014EP,10-044-001,931,288,0,288,0,1,287
Listas,2014EP,10-044-002,1028,260,0,260,0,0,260
Listas,2014EP,10-045-001,286,107,0,107,0,1,106
Listas,2014EP,10-045-002,617,237,0,237,0,7,230
Listas,2014EP,10-046-001,969,379,0,379,0,0,379
Listas,2014EP,10-046-002,1205,437,0,435,-2,3,432
Listas,2014EP,10-046-003,1143,294,0,294,0,3,291
Listas,2014EP,10-046-004,891,248,0,248,0,0,248
Listas,2014EP,10-046-005,1012,273,0,273,0,0,273
Listas,2014EP,10-046-006,1031,312,0,312,0,1,311
Listas,2014EP,10-046-007,1130,308,0,308,0,2,306
Listas,2014EP,10-046-008,933,273,1,273,0,0,273
Listas,2014EP,10-046-009,894,294,0,294,0,2,292
Listas,2014EP,10-046-010,925,329,0,329,0,2,327
Listas,2014EP,10-046-011,1165,410,0,410,0,0,410
Listas,2014EP,10-046-012,1158,374,0,374,0,0,374
Listas,2014EP,10-046-013,777,221,0,221,0,0,221
Listas,2014EP,10-046-014,1152,380,0,380,0,0,380
Listas,2014EP,10-046-015,1210,291,0,291,0,0,291
Listas,2014EP,10-046-016,678,200,0,200,0,0,200
Listas,2014EP,10-046-017,1157,285,0,285,0,0,285
Listas,2014EP,10-047-001,840,256,0,256,0,0,256
Listas,2014EP,10-047-002,787,176,0,176,0,0,176
Listas,2014EP,10-048-001,1132,292,0,292,0,0,292
Listas,2014EP,10-048-002,1063,352,2,350,-2,0,350
Listas,2014EP,10-048-003,1200,263,0,263,0,1,262
Listas,2014EP,10-048-004,233,43,0,43,0,0,43
Listas,2014EP,10-048-005,1137,277,0,277,0,1,276
Listas,2014EP,10-048-006,1065,213,0,213,0,0,213
Listas,2014EP,10-048-007,1138,243,0,243,0,1,242
Listas,2014EP,10-048-008,1130,240,0,240,0,0,240
Listas,2014EP,10-048-009,703,142,0,142,0,4,138
Listas,2014EP,10-049-001,503,143,0,143,0,2,141
Listas,2014EP,10-050-001,577,143,1,142,-1,1,141
Listas,2014EP,10-051-001,747,126,0,126,0,3,123
Listas,2014EP,10-051-002,752,216,0,216,0,0,216
Listas,2014EP,10-051-003,790,192,0,192,0,3,189
Listas,2014EP,10-051-004,788,171,0,171,0,2,169
Listas,2014EP,10-052-001,650,177,0,177,0,0,177
Listas,2014EP,10-052-002,586,119,0,119,0,0,119
Listas,2014EP,10-052-003,155,65,0,65,0,0,65
Listas,2014EP,10-053-001,322,139,0,139,0,1,138
Listas,2014EP,10-054-001,832,165,0,165,0,0,165
Listas,2014EP,10-054-002,820,150,0,150,0,1,149
Listas,2014EP,10-054-003,777,185,0,185,0,1,184
Listas,2014EP,10-055-001,763,156,0,156,0,0,156
Listas,2014EP,10-055-002,877,119,0,119,0,0,119
Listas,2014EP,10-055-003,692,158,0,158,0,3,155
Listas,2014EP,10-055-004,448,117,0,117,0,0,117
Listas,2014EP,10-056-001,688,117,0,117,0,2,115
Listas,2014EP,10-056-002,515,100,0,100,0,0,100
Listas,2014EP,10-057-001,865,198,0,198,0,0,198
Listas,2014EP,10-057-002,820,138,0,138,0,2,136
Listas,2014EP,10-058-001,132,71,0,71,0,0,71
Listas,2014EP,10-059-001,851,203,0,203,0,0,203
Listas,2014EP,10-059-002,588,106,0,106,0,0,106
Listas,2014EP,10-059-003,814,126,0,126,0,3,123
Listas,2014EP,10-060-001,858,207,0,207,0,0,207
Listas,2014EP,10-061-001,766,135,0,135,0,0,135
Listas,2014EP,10-061-002,827,252,0,252,0,0,252
Listas,2014EP,10-062-001,683,110,0,110,0,1,109
Listas,2014EP,10-062-002,646,95,0,95,0,1,94
Listas,2014EP,10-063-001,684,191,0,191,0,1,190
Listas,2014EP,10-063-002,807,155,0,155,0,0,155
Listas,2014EP,10-063-003,866,201,0,201,0,2,199
Listas,2014EP,10-063-004,807,167,0,167,0,0,167
Listas,2014EP,10-063-005,809,203,0,203,0,1,202
Listas,2014EP,10-063-006,636,176,0,176,0,1,175
Listas,2014EP,10-064-001,647,196,0,196,0,0,196
Listas,2014EP,10-065-001,669,183,0,183,0,0,183
Listas,2014EP,10-065-002,668,205,0,205,0,1,204
Listas,2014EP,10-065-003,666,155,0,155,0,0,155
Listas,2014EP,10-066-001,642,252,0,252,0,1,251
Listas,2014EP,10-066-002,829,294,0,294,0,1,293
Listas,2014EP,10-067-001,653,212,0,212,0,0,212
Listas,2014EP,10-068-001,851,309,0,309,0,1,308
Listas,2014EP,10-068-002,795,239,0,239,0,2,237
Listas,2014EP,10-069-001,471,207,0,207,0,0,207
Listas,2014EP,10-070-001,960,245,0,245,0,2,243
Listas,2014EP,10-071-001,1249,320,0,320,0,2,318
Listas,2014EP,10-072-001,607,185,0,185,0,0,185
Listas,2014EP,10-073-001,290,73,0,73,0,0,73
Listas,2014EP,10-074-001,1287,227,0,227,0,2,225
Listas,2014EP,10-075-001,498,167,0,167,0,0,167
Listas,2014EP,10-076-001,996,265,0,265,0,0,265
Listas,2014EP,10-076-002,943,255,0,255,0,1,254
Listas,2014EP,10-076-003,771,182,0,182,0,1,181
Listas,2014EP,10-077-001,699,225,0,225,0,1,224
Listas,2014EP,10-078-001,599,145,0,145,0,1,144
Listas,2014EP,10-079-001,815,212,0,212,0,0,212
Listas,2014EP,10-080-001,781,256,0,256,0,0,256
Listas,2014EP,10-080-002,711,256,0,256,0,0,256
Listas,2014EP,10-081-001,506,139,0,139,0,0,139
Listas,2014EP,10-081-002,620,163,0,163,0,0,163
Listas,2014EP,10-082-001,613,184,0,184,0,1,183
Listas,2014EP,10-082-002,782,180,0,180,0,1,179
Listas,2014EP,10-082-003,748,218,0,218,0,1,217
Listas,2014EP,10-083-001,648,260,0,260,0,1,259
Listas,2014EP,10-083-002,603,202,0,202,0,1,201
Listas,2014EP,10-083-003,310,155,0,155,0,0,155
Listas,2014EP,10-083-004,181,70,0,70,0,0,70
Listas,2014EP,10-084-001,430,198,0,198,0,1,197
Listas,2014EP,10-085-001,1119,311,0,311,0,1,310
Listas,2014EP,10-085-002,1147,265,0,265,0,1,264
Listas,2014EP,10-086-001,454,101,0,101,0,1,100
Listas,2014EP,10-086-002,677,134,0,134,0,0,134
Listas,2014EP,10-087-001,630,170,0,170,0,2,168
Listas,2014EP,10-087-002,623,189,0,189,0,0,189
Listas,2014EP,10-087-003,581,179,0,179,0,0,179
Listas,2014EP,10-088-001,791,196,0,196,0,1,195
Listas,2014EP,10-088-002,812,179,0,179,0,1,178
Listas,2014EP,10-088-003,780,111,0,111,0,2,109
Listas,2014EP,10-089-001,826,212,0,212,0,2,210
Listas,2014EP,10-089-002,853,203,0,203,0,0,203
Listas,2014EP,10-089-003,665,231,0,231,0,0,231
Listas,2014EP,10-090-001,846,175,0,175,0,0,175
Listas,2014EP,10-090-002,792,228,0,228,0,1,227
Listas,2014EP,10-091-001,915,212,0,212,0,3,209
Listas,2014EP,10-092-001,716,216,0,216,0,1,215
Listas,2014EP,10-092-002,684,238,0,238,0,0,238
Listas,2014EP,10-092-003,190,61,0,61,0,1,60
Listas,2014EP,10-093-001,170,53,0,53,0,0,53
Listas,2014EP,10-093-002,290,123,0,123,0,1,122
Listas,2014EP,10-094-001,393,105,0,105,0,1,104
Listas,2014EP,10-095-001,802,267,0,267,0,2,265
Listas,2014EP,10-095-002,831,235,0,234,-1,1,233
Listas,2014EP,10-096-001,689,231,0,231,0,0,231
Listas,2014EP,10-096-002,730,265,0,265,0,2,263
Listas,2014EP,10-097-001,206,50,0,50,0,0,50
Listas,2014EP,10-097-002,121,45,0,45,0,0,45
Listas,2014EP,10-098-001,790,150,0,150,0,1,149
Listas,2014EP,10-098-002,532,127,0,127,0,0,127
Listas,2014EP,10-099-001,425,69,0,69,0,2,67
Listas,2014EP,10-100-001,705,307,0,307,0,2,305
Listas,2014EP,10-100-002,675,296,0,296,0,1,295
Listas,2014EP,10-101-001,666,154,0,154,0,0,154
Listas,2014EP,10-101-002,766,138,0,138,0,1,137
Listas,2014EP,10-102-001,1340,171,0,171,0,0,171
Listas,2014EP,10-103-001,213,83,0,83,0,0,83
Listas,2014EP,10-104-001,648,117,0,117,0,5,112
Listas,2014EP,10-105-001,390,66,0,66,0,0,66
Listas,2014EP,10-105-002,529,82,0,82,0,2,80
Listas,2014EP,10-106-001,994,199,0,199,0,0,199
Listas,2014EP,10-107-001,149,71,0,71,0,0,71
Listas,2014EP,10-108-001,949,174,0,174,0,0,174
Listas,2014EP,10-108-002,902,231,0,231,0,1,230
Listas,2014EP,10-109-001,476,136,0,136,0,1,135
Listas,2014EP,10-110-001,195,60,0,60,0,0,60
Listas,2014EP,10-111-001,835,230,0,230,0,2,228
Listas,2014EP,10-111-002,816,297,0,297,0,2,295
Listas,2014EP,10-112-001,417,170,0,170,0,2,168
Listas,2014EP,10-113-001,608,197,0,197,0,0,197
Listas,2014EP,10-113-002,867,174,0,174,0,4,170
Listas,2014EP,10-113-003,690,195,1,194,-1,0,194
Listas,2014EP,10-113-004,875,280,0,280,0,3,277
Listas,2014EP,10-114-001,532,151,0,151,0,0,151
Listas,2014EP,10-115-001,963,274,0,274,0,3,271
Listas,2014EP,10-116-001,916,206,0,206,0,1,205
Listas,2014EP,10-117-001,959,279,0,279,0,9,270
Listas,2014EP,10-117-002,624,190,0,190,0,0,190
Listas,2014EP,10-118-001,379,133,0,133,0,2,131
Listas,2014EP,10-119-001,320,148,0,148,0,1,147
Listas,2014EP,10-120-001,572,223,0,223,0,1,222
Listas,2014EP,10-121-001,824,209,0,209,0,0,209
Listas,2014EP,11-001-001,652,109,0,109,0,0,109
Listas,2014EP,11-001-002,749,104,0,104,0,0,104
Listas,2014EP,11-001-003,729,119,0,119,0,4,115
Listas,2014EP,11-001-004,749,79,0,79,0,0,79
Listas,2014EP,11-001-005,668,142,0,142,0,0,142
Listas,2014EP,11-002-001,624,183,0,183,0,1,182
Listas,2014EP,11-002-002,959,168,0,168,0,3,165
Listas,2014EP,11-003-001,1018,341,0,341,0,0,341
Listas,2014EP,11-004-001,1052,260,0,260,0,0,260
Listas,2014EP,11-004-002,851,231,0,231,0,1,230
Listas,2014EP,11-004-003,884,158,0,158,0,0,158
Listas,2014EP,11-005-001,1063,227,0,227,0,3,224
Listas,2014EP,11-005-002,1099,146,0,146,0,1,145
Listas,2014EP,11-005-003,877,194,0,194,0,0,194
Listas,2014EP,11-005-004,268,20,0,20,0,1,19
Listas,2014EP,11-006-001,236,78,0,78,0,2,76
Listas,2014EP,11-007-001,1011,288,0,288,0,2,286
Listas,2014EP,11-007-002,567,95,0,95,0,0,95
Listas,2014EP,11-007-003,329,44,0,44,0,0,44
Listas,2014EP,11-008-001,611,94,0,94,0,3,91
Listas,2014EP,11-008-002,736,149,0,149,0,1,148
Listas,2014EP,11-009-001,1201,275,0,275,0,0,275
Listas,2014EP,11-009-002,1188,216,0,216,0,1,215
Listas,2014EP,11-009-003,1077,153,0,153,0,2,151
Listas,2014EP,11-009-004,1124,174,0,174,0,0,174
Listas,2014EP,11-009-005,820,134,0,134,0,0,134
Listas,2014EP,11-010-001,151,60,0,60,0,0,60
Listas,2014EP,11-011-001,626,120,0,120,0,1,119
Listas,2014EP,11-011-002,847,179,0,179,0,0,179
Listas,2014EP,11-011-003,612,117,0,117,0,1,116
Listas,2014EP,11-012-001,735,190,0,190,0,0,190
Listas,2014EP,11-012-002,709,157,0,157,0,4,153
Listas,2014EP,11-012-003,796,207,0,207,0,2,205
Listas,2014EP,11-012-004,731,203,0,203,0,1,202
Listas,2014EP,11-013-001,954,249,0,249,0,2,247
Listas,2014EP,11-013-002,1003,270,0,270,0,1,269
Listas,2014EP,11-013-003,990,278,0,278,0,2,276
Listas,2014EP,11-013-004,1047,294,0,294,0,1,293
Listas,2014EP,11-013-005,912,261,0,261,0,1,260
Listas,2014EP,11-013-006,1065,274,0,274,0,0,274
Listas,2014EP,11-013-007,1045,288,0,288,0,1,287
Listas,2014EP,11-014-001,591,119,0,119,0,0,119
Listas,2014EP,11-015-001,1099,271,0,271,0,1,270
Listas,2014EP,11-015-002,1359,271,0,271,0,2,269
Listas,2014EP,11-015-003,1388,315,0,315,0,4,311
Listas,2014EP,11-015-004,1261,281,0,281,0,1,280
Listas,2014EP,11-015-005,1359,232,0,232,0,2,230
Listas,2014EP,11-016-001,1229,440,0,438,-2,2,436
Listas,2014EP,11-016-002,1090,432,0,432,0,1,431
Listas,2014EP,11-016-003,1160,337,0,337,0,2,335
Listas,2014EP,11-016-004,1198,351,0,351,0,3,348
Listas,2014EP,11-016-005,1000,370,0,369,-1,1,368
Listas,2014EP,11-016-006,1033,251,0,251,0,1,250
Listas,2014EP,11-016-007,1044,322,0,321,-1,4,317
Listas,2014EP,11-016-008,1064,337,0,337,0,0,337
Listas,2014EP,11-016-009,1063,330,0,330,0,1,329
Listas,2014EP,11-016-010,1170,351,0,351,0,3,348
Listas,2014EP,11-016-011,1147,310,0,310,0,2,308
Listas,2014EP,11-016-012,1155,338,0,338,0,2,336
Listas,2014EP,11-016-013,1105,368,0,368,0,1,367
Listas,2014EP,11-016-014,1121,270,0,270,0,0,270
Listas,2014EP,11-016-015,1169,302,0,302,0,0,302
Listas,2014EP,11-016-016,1072,256,0,256,0,2,254
Listas,2014EP,11-016-017,1011,304,0,304,0,0,304
Listas,2014EP,11-016-018,1034,259,0,259,0,2,257
Listas,2014EP,11-016-019,836,233,0,232,-1,0,232
Listas,2014EP,11-016-020,755,122,0,122,0,1,121
Listas,2014EP,11-016-021,670,100,0,100,0,0,100
Listas,2014EP,11-017-001,755,214,0,214,0,2,212
Listas,2014EP,11-017-002,671,233,0,233,0,2,231
Listas,2014EP,11-018-001,585,147,0,147,0,1,146
Listas,2014EP,11-018-002,591,124,0,124,0,2,122
Listas,2014EP,11-018-003,598,128,0,128,0,1,127
Listas,2014EP,11-019-001,731,142,0,142,0,1,141
Listas,2014EP,11-019-002,712,140,0,140,0,1,139
Listas,2014EP,11-020-001,853,155,0,155,0,1,154
Listas,2014EP,11-020-002,956,172,0,172,0,1,171
Listas,2014EP,11-020-003,953,185,0,185,0,2,183
Listas,2014EP,11-020-004,952,155,0,155,0,1,154
Listas,2014EP,11-020-005,902,191,0,191,0,0,191
Listas,2014EP,11-021-001,350,112,0,112,0,1,111
Listas,2014EP,11-022-001,820,200,0,200,0,0,200
Listas,2014EP,11-022-002,829,144,0,144,0,1,143
Listas,2014EP,11-022-003,769,168,0,168,0,0,168
Listas,2014EP,11-023-001,846,201,0,201,0,0,201
Listas,2014EP,11-023-002,910,198,0,197,-1,0,197
Listas,2014EP,11-023-003,904,155,0,155,0,0,155
Listas,2014EP,11-023-004,825,197,0,197,0,0,197
Listas,2014EP,11-023-005,867,243,0,243,0,0,243
Listas,2014EP,11-024-001,774,105,0,105,0,1,104
Listas,2014EP,11-024-002,874,96,0,96,0,1,95
Listas,2014EP,11-024-003,659,140,0,140,0,0,140
Listas,2014EP,11-024-004,667,149,0,149,0,2,147
Listas,2014EP,11-024-005,711,137,0,137,0,0,137
Listas,2014EP,11-024-006,733,177,0,177,0,5,172
Listas,2014EP,11-025-001,1037,321,0,321,0,0,321
Listas,2014EP,11-025-002,1091,323,0,323,0,0,323
Listas,2014EP,11-026-001,651,141,0,141,0,1,140
Listas,2014EP,11-026-002,617,152,0,152,0,1,151
Listas,2014EP,11-027-001,1030,376,0,376,0,0,376
Listas,2014EP,11-027-002,813,214,0,214,0,0,214
Listas,2014EP,11-027-003,1042,399,0,399,0,6,393
Listas,2014EP,11-027-004,993,289,0,289,0,0,289
Listas,2014EP,11-027-005,930,276,0,276,0,2,274
Listas,2014EP,11-027-006,1014,90,0,90,0,0,90
Listas,2014EP,11-027-007,995,349,0,349,0,6,343
Listas,2014EP,11-027-008,913,243,0,243,0,2,241
Listas,2014EP,11-027-009,1020,417,0,417,0,1,416
Listas,2014EP,11-027-010,1091,321,0,321,0,4,317
Listas,2014EP,11-027-011,1113,338,0,338,0,0,338
Listas,2014EP,11-027-012,1091,236,0,236,0,1,235
Listas,2014EP,11-027-013,1125,275,0,275,0,4,271
Listas,2014EP,11-027-014,1073,244,0,244,0,0,244
Listas,2014EP,11-027-015,1091,276,0,276,0,4,272
Listas,2014EP,11-027-016,1067,357,0,357,0,1,356
Listas,2014EP,11-028-001,905,265,0,265,0,2,263
Listas,2014EP,11-028-002,810,166,0,166,0,2,164
Listas,2014EP,11-028-003,779,163,0,162,-1,1,161
Listas,2014EP,11-028-004,812,135,0,135,0,1,134
Listas,2014EP,11-028-005,460,119,0,119,0,2,117
Listas,2014EP,11-029-001,756,163,0,162,-1,0,162
Listas,2014EP,11-029-002,633,130,0,130,0,0,130
Listas,2014EP,11-029-003,662,100,0,100,0,0,100
Listas,2014EP,11-029-004,679,85,0,85,0,0,85
Listas,2014EP,11-029-005,243,78,0,78,0,0,78
Listas,2014EP,11-030-001,572,158,0,158,0,3,155
Listas,2014EP,11-031-001,1284,394,0,394,0,1,393
Listas,2014EP,11-031-002,1211,226,0,226,0,1,225
Listas,2014EP,11-031-003,1291,302,0,302,0,6,296
Listas,2014EP,11-031-004,1141,200,0,200,0,3,197
Listas,2014EP,11-031-005,1388,335,0,334,-1,1,333
Listas,2014EP,11-031-006,1083,349,0,348,-1,3,345
Listas,2014EP,11-031-007,1038,297,0,297,0,4,293
Listas,2014EP,11-031-008,990,221,0,221,0,1,220
Listas,2014EP,11-032-001,680,137,0,137,0,0,137
Listas,2014EP,11-032-002,619,141,0,141,0,0,141
Listas,2014EP,11-033-001,546,121,0,121,0,0,121
Listas,2014EP,11-034-001,918,177,0,177,0,1,176
Listas,2014EP,11-034-002,779,221,0,221,0,2,219
Listas,2014EP,11-034-003,742,150,0,150,0,1,149
Listas,2014EP,11-034-004,1145,299,0,299,0,1,298
Listas,2014EP,11-034-005,943,134,0,134,0,0,134
Listas,2014EP,11-034-006,901,175,0,175,0,0,175
Listas,2014EP,11-034-007,1166,173,0,173,0,2,171
Listas,2014EP,11-035-001,585,86,0,86,0,1,85
Listas,2014EP,11-035-002,608,98,0,98,0,0,98
Listas,2014EP,11-035-003,594,145,0,145,0,0,145
Listas,2014EP,11-035-004,617,132,0,131,-1,1,130
Listas,2014EP,11-035-005,624,116,0,116,0,1,115
Listas,2014EP,11-035-006,597,96,0,96,0,1,95
Listas,2014EP,11-035-007,617,87,0,87,0,0,87
Listas,2014EP,11-036-001,674,163,0,163,0,1,162
Listas,2014EP,11-036-002,820,120,0,120,0,1,119
Listas,2014EP,11-036-003,705,140,0,140,0,0,140
Listas,2014EP,11-036-004,736,156,0,156,0,0,156
Listas,2014EP,11-036-005,729,168,0,168,0,0,168
Listas,2014EP,11-036-006,843,232,0,232,0,0,232
Listas,2014EP,11-036-007,854,170,0,170,0,0,170
Listas,2014EP,11-036-008,1052,185,0,185,0,0,185
Listas,2014EP,11-036-009,267,47,0,47,0,1,46
Listas,2014EP,11-036-010,590,117,0,117,0,0,117
Listas,2014EP,11-037-001,716,170,0,170,0,0,170
Listas,2014EP,11-037-002,961,226,0,226,0,0,226
Listas,2014EP,11-037-003,1119,323,0,323,0,4,319
Listas,2014EP,11-037-004,923,240,0,240,0,0,240
Listas,2014EP,11-037-005,931,236,0,236,0,1,235
Listas,2014EP,11-037-006,1079,268,0,268,0,1,267
Listas,2014EP,11-038-001,637,217,0,217,0,2,215
Listas,2014EP,11-039-001,299,62,0,62,0,1,61
Listas,2014EP,11-040-001,834,206,0,206,0,2,204
Listas,2014EP,11-040-002,914,228,0,228,0,0,228
Listas,2014EP,11-040-003,986,272,0,272,0,0,272
Listas,2014EP,11-040-004,914,232,0,232,0,1,231
Listas,2014EP,11-040-005,898,245,0,245,0,0,245
Listas,2014EP,11-040-006,942,184,0,184,0,1,183
Listas,2014EP,11-040-007,871,236,0,236,0,0,236
Listas,2014EP,11-040-008,915,278,0,278,0,2,276
Listas,2014EP,11-040-009,900,247,0,247,0,1,246
Listas,2014EP,11-040-010,923,187,0,187,0,2,185
Listas,2014EP,11-040-011,975,245,0,245,0,2,243
Listas,2014EP,11-040-012,848,244,0,244,0,0,244
Listas,2014EP,11-040-013,862,222,0,222,0,2,220
Listas,2014EP,11-040-014,927,268,0,268,0,1,267
Listas,2014EP,11-040-015,886,239,0,239,0,0,239
Listas,2014EP,11-040-016,862,286,0,286,0,2,284
Listas,2014EP,11-041-001,944,294,0,294,0,3,291
Listas,2014EP,11-042-001,668,111,0,111,0,2,109
Listas,2014EP,11-042-002,713,172,0,172,0,1,171
Listas,2014EP,11-043-001,560,122,0,122,0,0,122
Listas,2014EP,11-044-001,683,99,0,99,0,1,98
Listas,2014EP,11-044-002,693,100,0,100,0,0,100
Listas,2014EP,11-044-003,728,127,0,126,-1,1,125
Listas,2014EP,11-044-004,694,104,0,104,0,0,104
Listas,2014EP,11-045-001,423,68,0,68,0,0,68
Listas,2014EP,11-045-002,461,102,0,102,0,0,102
Listas,2014EP,11-046-001,1318,291,0,291,0,1,290
Listas,2014EP,11-047-001,961,219,0,219,0,0,219
Listas,2014EP,11-047-002,959,216,0,216,0,1,215
Listas,2014EP,11-047-003,856,240,0,240,0,0,240
Listas,2014EP,11-047-004,898,240,0,240,0,1,239
Listas,2014EP,11-047-005,905,175,0,175,0,0,175
Listas,2014EP,11-048-001,839,113,0,113,0,1,112
Listas,2014EP,11-048-002,794,134,0,134,0,0,134
Listas,2014EP,11-049-001,849,231,0,231,0,0,231
Listas,2014EP,11-049-002,578,133,0,133,0,0,133
Listas,2014EP,11-049-003,757,176,0,176,0,0,176
Listas,2014EP,11-049-004,1004,280,0,280,0,0,280
Listas,2014EP,11-050-001,822,179,0,179,0,4,175
Listas,2014EP,11-051-001,665,155,0,155,0,1,154
Listas,2014EP,11-051-002,195,34,0,34,0,0,34
Listas,2014EP,11-052-001,917,404,0,404,0,0,404
Listas,2014EP,11-052-002,894,397,0,396,-1,0,396
Listas,2014EP,11-052-003,1031,349,0,349,0,20,329
Listas,2014EP,11-052-004,887,332,0,332,0,0,332
Listas,2014EP,11-052-005,900,343,0,343,0,0,343
Listas,2014EP,11-052-006,984,296,0,296,0,0,296
Listas,2014EP,11-052-007,885,322,0,322,0,0,322
Listas,2014EP,11-052-008,829,255,0,255,0,0,255
Listas,2014EP,11-052-009,800,226,0,226,0,0,226
Listas,2014EP,11-052-010,855,316,0,316,0,0,316
Listas,2014EP,11-052-011,700,304,0,304,0,2,302
Listas,2014EP,11-052-012,910,352,0,351,-1,1,350
Listas,2014EP,11-052-013,800,253,0,253,0,0,253
Listas,2014EP,11-052-014,778,243,0,243,0,0,243
Listas,2014EP,11-052-015,988,242,0,242,0,0,242
Listas,2014EP,11-052-016,952,298,0,298,0,0,298
Listas,2014EP,11-052-017,791,241,0,241,0,1,240
Listas,2014EP,11-052-018,769,288,0,288,0,1,287
Listas,2014EP,11-052-019,877,322,0,322,0,0,322
Listas,2014EP,11-052-020,1205,499,0,499,0,0,499
Listas,2014EP,11-052-021,833,286,0,286,0,1,285
Listas,2014EP,11-052-022,716,246,0,246,0,1,245
Listas,2014EP,11-052-023,667,311,0,311,0,0,311
Listas,2014EP,11-052-024,888,325,0,325,0,2,323
Listas,2014EP,11-052-025,600,239,0,239,0,2,237
Listas,2014EP,11-052-026,765,261,0,261,0,1,260
Listas,2014EP,11-052-027,698,209,0,209,0,1,208
Listas,2014EP,11-052-028,847,270,0,270,0,1,269
Listas,2014EP,11-052-029,762,246,0,246,0,0,246
Listas,2014EP,11-052-030,596,153,0,153,0,2,151
Listas,2014EP,11-052-031,748,251,0,251,0,0,251
Listas,2014EP,11-052-032,638,166,0,166,0,0,166
Listas,2014EP,11-052-033,913,249,0,249,0,2,247
Listas,2014EP,11-052-034,772,183,0,183,0,1,182
Listas,2014EP,11-052-035,804,173,0,173,0,1,172
Listas,2014EP,11-052-036,856,195,0,195,0,2,193
Listas,2014EP,11-052-037,811,194,0,194,0,1,193
Listas,2014EP,11-052-038,684,136,0,136,0,3,133
Listas,2014EP,11-052-039,848,217,0,217,0,2,215
Listas,2014EP,11-052-040,912,220,0,220,0,1,219
Listas,2014EP,11-052-041,892,224,0,224,0,2,222
Listas,2014EP,11-052-042,769,162,0,162,0,1,161
Listas,2014EP,11-052-043,866,211,0,211,0,2,209
Listas,2014EP,11-052-044,1038,373,0,373,0,2,371
Listas,2014EP,11-052-045,544,139,0,139,0,1,138
Listas,2014EP,11-052-046,798,238,0,238,0,0,238
Listas,2014EP,11-052-047,886,227,0,227,0,0,227
Listas,2014EP,11-052-048,885,234,0,234,0,0,234
Listas,2014EP,11-052-049,790,139,0,139,0,2,137
Listas,2014EP,11-052-050,637,115,0,115,0,0,115
Listas,2014EP,11-052-051,872,241,0,241,0,0,241
Listas,2014EP,11-052-052,971,197,0,197,0,0,197
Listas,2014EP,11-052-053,943,173,0,173,0,2,171
Listas,2014EP,11-052-054,831,241,0,241,0,0,241
Listas,2014EP,11-052-055,1115,314,0,314,0,1,313
Listas,2014EP,11-052-056,852,287,0,287,0,0,287
Listas,2014EP,11-052-057,1003,351,0,351,0,0,351
Listas,2014EP,11-052-058,922,177,0,177,0,1,176
Listas,2014EP,11-052-059,874,288,0,286,-2,0,286
Listas,2014EP,11-052-060,961,377,1,377,0,1,376
Listas,2014EP,11-052-061,952,294,0,293,-1,1,292
Listas,2014EP,11-052-062,874,323,0,323,0,1,322
Listas,2014EP,11-052-063,918,296,0,296,0,0,296
Listas,2014EP,11-052-064,846,256,0,256,0,0,256
Listas,2014EP,11-052-065,955,298,0,298,0,5,293
Listas,2014EP,11-052-066,860,265,0,265,0,0,265
Listas,2014EP,11-052-067,882,243,0,243,0,0,243
Listas,2014EP,11-052-068,950,284,0,284,0,0,284
Listas,2014EP,11-052-069,850,228,0,228,0,0,228
Listas,2014EP,11-052-070,1195,391,0,391,0,1,390
Listas,2014EP,11-053-001,561,322,0,322,0,1,321
Listas,2014EP,11-053-002,629,332,1,330,-2,0,330
Listas,2014EP,11-054-001,828,207,0,207,0,1,206
Listas,2014EP,11-054-002,904,300,0,300,0,0,300
Listas,2014EP,11-054-003,192,59,0,59,0,0,59
Listas,2014EP,11-055-001,912,212,0,212,0,2,210
Listas,2014EP,11-056-001,1133,241,0,241,0,2,239
Listas,2014EP,11-056-002,1164,177,0,177,0,0,177
Listas,2014EP,11-056-003,1183,304,0,304,0,1,303
Listas,2014EP,11-056-004,1119,239,0,239,0,2,237
Listas,2014EP,11-056-005,1168,201,0,201,0,0,201
Listas,2014EP,11-056-006,1138,191,0,191,0,1,190
Listas,2014EP,11-056-007,1045,191,0,191,0,2,189
Listas,2014EP,11-056-008,1142,170,0,170,0,1,169
Listas,2014EP,11-057-001,591,145,0,145,0,0,145
Listas,2014EP,11-057-002,150,52,0,52,0,0,52
Listas,2014EP,11-057-003,831,139,0,139,0,0,139
Listas,2014EP,11-057-004,752,192,0,192,0,0,192
Listas,2014EP,11-057-005,670,154,0,154,0,0,154
Listas,2014EP,11-057-006,1104,243,0,243,0,0,243
Listas,2014EP,11-057-007,1146,218,0,218,0,0,218
Listas,2014EP,11-057-008,376,78,0,78,0,1,77
Listas,2014EP,11-057-009,976,144,0,144,0,1,143
Listas,2014EP,11-057-010,436,108,0,108,0,0,108
Listas,2014EP,11-057-011,1067,289,0,289,0,0,289
Listas,2014EP,11-057-012,653,174,0,174,0,1,173
Listas,2014EP,11-057-013,552,152,0,152,0,0,152
Listas,2014EP,11-057-014,386,97,0,97,0,0,97
Listas,2014EP,11-058-001,850,179,0,179,0,0,179
Listas,2014EP,11-059-001,654,168,2,166,-2,0,166
Listas,2014EP,11-060-001,321,90,0,90,0,2,88
Listas,2014EP,11-061-001,910,206,0,206,0,0,206
Listas,2014EP,11-061-002,412,86,0,86,0,0,86
Listas,2014EP,11-062-001,990,195,0,195,0,2,193
Listas,2014EP,11-062-002,169,41,0,41,0,0,41
Listas,2014EP,11-063-001,1111,263,0,263,0,1,262
Listas,2014EP,11-064-001,826,127,0,127,0,2,125
Listas,2014EP,11-064-002,838,135,0,135,0,1,134
Listas,2014EP,11-065-001,664,158,0,158,0,2,156
Listas,2014EP,11-065-002,709,154,0,154,0,1,153
Listas,2014EP,11-066-001,904,190,0,190,0,2,188
Listas,2014EP,11-067-001,689,170,0,170,0,0,170
Listas,2014EP,11-067-002,643,158,0,158,0,2,156
Listas,2014EP,11-068-001,805,155,0,155,0,1,154
Listas,2014EP,11-068-002,770,140,0,140,0,0,140
Listas,2014EP,11-068-003,254,35,0,35,0,0,35
Listas,2014EP,11-069-001,748,134,0,134,0,1,133
Listas,2014EP,11-069-002,661,119,0,119,0,0,119
Listas,2014EP,11-070-001,1034,228,1,227,-1,0,227
Listas,2014EP,11-070-002,226,56,0,56,0,0,56
Listas,2014EP,11-071-001,592,155,0,155,0,0,155
Listas,2014EP,11-072-001,953,200,0,200,0,1,199
Listas,2014EP,11-072-002,1072,223,0,223,0,0,223
Listas,2014EP,11-072-003,810,180,0,180,0,1,179
Listas,2014EP,11-072-004,910,208,0,208,0,0,208
Listas,2014EP,11-073-001,1102,279,0,279,0,1,278
Listas,2014EP,11-073-002,1075,306,0,306,0,0,306
Listas,2014EP,11-073-003,1229,399,0,399,0,2,397
Listas,2014EP,11-073-004,1027,242,0,242,0,1,241
Listas,2014EP,11-073-005,1161,205,0,205,0,0,205
Listas,2014EP,11-073-006,1132,268,0,268,0,1,267
Listas,2014EP,11-073-007,718,247,0,247,0,1,246
Listas,2014EP,11-073-008,758,232,0,232,0,0,232
Listas,2014EP,11-073-009,765,269,0,269,0,1,268
Listas,2014EP,11-073-010,828,237,0,237,0,0,237
Listas,2014EP,11-073-011,1101,296,0,296,0,3,293
Listas,2014EP,11-073-012,714,130,0,130,0,0,130
Listas,2014EP,11-073-013,619,120,0,120,0,1,119
Listas,2014EP,11-073-014,809,62,0,62,0,3,59
Listas,2014EP,11-073-015,1065,178,0,178,0,1,177
Listas,2014EP,11-073-016,1084,220,0,220,0,0,220
Listas,2014EP,11-073-017,1091,301,0,301,0,0,301
Listas,2014EP,11-073-018,1136,198,0,198,0,1,197
Listas,2014EP,11-074-001,799,106,0,106,0,1,105
Listas,2014EP,11-074-002,819,151,0,151,0,3,148
Listas,2014EP,11-074-003,705,120,0,120,0,0,120
Listas,2014EP,11-074-004,722,164,0,164,0,0,164
Listas,2014EP,11-074-005,734,187,0,187,0,1,186
Listas,2014EP,11-074-006,729,223,0,223,0,1,222
Listas,2014EP,11-074-007,696,141,0,141,0,0,141
Listas,2014EP,11-074-008,766,98,0,98,0,0,98
Listas,2014EP,11-074-009,751,156,0,156,0,1,155
Listas,2014EP,11-074-010,804,115,0,115,0,1,114
Listas,2014EP,11-075-001,889,224,0,224,0,2,222
Listas,2014EP,11-075-002,864,228,0,228,0,0,228
Listas,2014EP,11-075-003,727,221,0,221,0,3,218
Listas,2014EP,11-075-004,804,282,0,282,0,10,272
Listas,2014EP,11-075-005,840,185,0,185,0,1,184
Listas,2014EP,11-075-006,889,216,0,216,0,0,216
Listas,2014EP,11-076-001,524,134,0,134,0,0,134
Listas,2014EP,11-077-001,588,116,0,116,0,1,115
Listas,2014EP,11-077-002,631,107,0,107,0,2,105
Listas,2014EP,11-077-003,630,142,0,142,0,2,140
Listas,2014EP,11-077-004,582,144,0,144,0,0,144
Listas,2014EP,11-077-005,409,74,0,74,0,0,74
Listas,2014EP,11-078-001,722,152,0,152,0,1,151
Listas,2014EP,11-078-002,528,124,0,124,0,0,124
Listas,2014EP,12-001-001,207,55,0,55,0,0,55
Listas,2014EP,12-002-001,585,223,0,223,0,0,223
Listas,2014EP,12-002-002,587,185,0,185,0,0,185
Listas,2014EP,12-002-003,563,161,0,161,0,0,161
Listas,2014EP,12-003-001,753,182,0,182,0,1,181
Listas,2014EP,12-004-001,779,113,0,113,0,0,113
Listas,2014EP,12-004-002,736,178,0,178,0,1,177
Listas,2014EP,12-004-003,735,157,0,157,0,0,157
Listas,2014EP,12-004-004,635,83,0,83,0,1,82
Listas,2014EP,12-004-005,642,107,0,107,0,1,106
Listas,2014EP,12-004-006,670,141,0,141,0,0,141
Listas,2014EP,12-004-007,735,152,0,152,0,0,152
Listas,2014EP,12-004-008,728,135,1,134,-1,1,133
Listas,2014EP,12-005-001,564,101,0,101,0,0,101
Listas,2014EP,12-006-001,785,206,0,206,0,0,206
Listas,2014EP,12-006-002,692,218,0,218,0,0,218
Listas,2014EP,12-006-003,784,213,0,213,0,0,213
Listas,2014EP,12-007-001,854,238,0,238,0,1,237
Listas,2014EP,12-007-002,783,228,0,228,0,0,228
Listas,2014EP,12-008-001,1263,324,0,324,0,1,323
Listas,2014EP,12-009-001,374,71,0,71,0,1,70
Listas,2014EP,12-010-001,754,175,0,175,0,1,174
Listas,2014EP,12-011-001,559,102,0,102,0,1,101
Listas,2014EP,12-011-002,611,125,0,125,0,0,125
Listas,2014EP,12-012-001,673,132,0,132,0,1,131
Listas,2014EP,12-012-002,644,143,0,143,0,0,143
Listas,2014EP,12-013-001,833,214,0,214,0,0,214
Listas,2014EP,12-013-002,644,153,0,153,0,1,152
Listas,2014EP,12-013-003,758,141,0,141,0,0,141
Listas,2014EP,12-013-004,756,218,0,218,0,0,218
Listas,2014EP,12-014-001,653,128,0,128,0,1,127
Listas,2014EP,12-015-001,744,176,0,176,0,0,176
Listas,2014EP,12-015-002,1012,240,0,240,0,0,240
Listas,2014EP,12-016-001,232,73,0,73,0,0,73
Listas,2014EP,12-017-001,675,159,0,159,0,1,158
Listas,2014EP,12-017-002,836,179,0,179,0,1,178
Listas,2014EP,12-018-001,351,84,0,84,0,0,84
Listas,2014EP,12-019-001,289,61,0,61,0,0,61
Listas,2014EP,12-020-001,1014,252,0,252,0,0,252
Listas,2014EP,12-020-002,800,192,0,192,0,0,192
Listas,2014EP,12-020-003,913,194,0,194,0,0,194
Listas,2014EP,12-021-001,838,218,0,218,0,1,217
Listas,2014EP,12-022-001,774,293,0,293,0,1,292
Listas,2014EP,12-023-001,1095,265,0,265,0,0,265
Listas,2014EP,12-023-002,1153,381,0,381,0,1,380
Listas,2014EP,12-023-003,1043,347,0,347,0,3,344
Listas,2014EP,12-023-004,749,164,0,164,0,0,164
Listas,2014EP,12-023-005,722,203,0,203,0,1,202
Listas,2014EP,12-023-006,827,173,0,173,0,1,172
Listas,2014EP,12-023-007,820,152,0,152,0,0,152
Listas,2014EP,12-023-008,1402,304,0,304,0,0,304
Listas,2014EP,12-023-009,1283,282,0,282,0,1,281
Listas,2014EP,12-023-010,970,234,0,234,0,5,229
Listas,2014EP,12-024-001,962,272,0,272,0,0,272
Listas,2014EP,12-025-001,774,232,0,232,0,3,229
Listas,2014EP,12-025-002,448,143,0,143,0,1,142
Listas,2014EP,12-026-001,356,119,0,119,0,0,119
Listas,2014EP,12-027-001,516,203,0,203,0,1,202
Listas,2014EP,12-028-001,821,322,0,322,0,0,322
Listas,2014EP,12-028-002,820,323,0,323,0,2,321
Listas,2014EP,12-028-003,763,279,0,279,0,1,278
Listas,2014EP,12-028-004,1025,271,0,271,0,3,268
Listas,2014EP,12-028-005,1007,434,0,434,0,0,434
Listas,2014EP,12-028-006,993,280,0,280,0,5,275
Listas,2014EP,12-028-007,1003,396,0,396,0,0,396
Listas,2014EP,12-028-008,631,212,0,212,0,1,211
Listas,2014EP,12-028-009,517,265,0,265,0,2,263
Listas,2014EP,12-028-010,927,374,0,373,-1,2,371
Listas,2014EP,12-028-011,700,301,0,301,0,0,301
Listas,2014EP,12-028-012,1102,390,0,390,0,1,389
Listas,2014EP,12-028-013,805,255,0,255,0,0,255
Listas,2014EP,12-028-014,925,253,0,253,0,0,253
Listas,2014EP,12-028-015,1031,308,0,308,0,1,307
Listas,2014EP,12-028-016,577,209,0,209,0,2,207
Listas,2014EP,12-028-017,1288,328,0,328,0,2,326
Listas,2014EP,12-028-018,1252,454,0,454,0,2,452
Listas,2014EP,12-028-019,818,353,0,353,0,2,351
Listas,2014EP,12-028-020,974,364,0,364,0,1,363
Listas,2014EP,12-028-021,253,75,0,75,0,2,73
Listas,2014EP,12-028-022,692,121,0,121,0,0,121
Listas,2014EP,12-028-023,955,263,0,263,0,0,263
Listas,2014EP,12-028-024,934,257,0,257,0,1,256
Listas,2014EP,12-028-025,895,214,0,214,0,1,213
Listas,2014EP,12-028-026,804,136,0,136,0,0,136
Listas,2014EP,12-028-027,815,125,0,125,0,0,125
Listas,2014EP,12-029-001,497,147,0,147,0,0,147
Listas,2014EP,12-030-001,1161,425,0,425,0,1,424
Listas,2014EP,12-031-001,814,212,0,212,0,0,212
Listas,2014EP,12-032-001,870,173,0,173,0,1,172
Listas,2014EP,12-032-002,793,209,0,209,0,1,208
Listas,2014EP,12-033-001,561,91,0,91,0,1,90
Listas,2014EP,12-034-001,717,195,0,195,0,2,193
Listas,2014EP,12-034-002,769,219,0,219,0,0,219
Listas,2014EP,12-034-003,691,150,0,150,0,2,148
Listas,2014EP,12-035-001,853,232,0,232,0,2,230
Listas,2014EP,12-035-002,869,249,0,249,0,0,249
Listas,2014EP,12-035-003,781,203,0,203,0,2,201
Listas,2014EP,12-035-004,836,188,0,188,0,0,188
Listas,2014EP,12-035-005,822,174,0,174,0,1,173
Listas,2014EP,12-035-006,399,81,0,81,0,0,81
Listas,2014EP,12-036-001,415,83,0,83,0,0,83
Listas,2014EP,12-037-001,1050,289,0,289,0,2,287
Listas,2014EP,12-037-002,1062,275,0,275,0,1,274
Listas,2014EP,12-038-001,434,159,0,159,0,1,158
Listas,2014EP,12-038-002,977,314,0,314,0,2,312
Listas,2014EP,12-038-003,630,199,0,199,0,2,197
Listas,2014EP,12-038-004,894,297,0,297,0,0,297
Listas,2014EP,12-038-005,1015,295,0,295,0,1,294
Listas,2014EP,12-038-006,951,267,0,267,0,0,267
Listas,2014EP,12-038-007,1007,339,0,339,0,1,338
Listas,2014EP,12-038-008,780,301,0,301,0,0,301
Listas,2014EP,12-038-009,401,168,0,168,0,1,167
Listas,2014EP,12-038-010,677,229,0,229,0,0,229
Listas,2014EP,12-038-011,785,232,0,232,0,1,231
Listas,2014EP,12-038-012,669,222,0,222,0,2,220
Listas,2014EP,12-038-013,762,237,0,237,0,0,237
Listas,2014EP,12-038-014,975,337,1,337,0,2,335
Listas,2014EP,12-038-015,814,221,0,221,0,2,219
Listas,2014EP,12-038-016,851,239,1,238,-1,0,238
Listas,2014EP,12-038-017,1087,268,0,267,-1,2,265
Listas,2014EP,12-038-018,1124,310,0,310,0,0,310
Listas,2014EP,12-038-019,832,265,0,265,0,1,264
Listas,2014EP,12-039-001,858,166,0,166,0,1,165
Listas,2014EP,12-040-001,977,297,0,297,0,0,297
Listas,2014EP,12-040-002,893,268,0,268,0,0,268
Listas,2014EP,12-040-003,943,180,0,180,0,0,180
Listas,2014EP,12-040-004,948,153,0,153,0,0,153
Listas,2014EP,12-041-001,693,168,0,168,0,0,168
Listas,2014EP,12-041-002,799,172,0,172,0,0,172
Listas,2014EP,12-041-003,798,166,0,166,0,0,166
Listas,2014EP,12-041-004,987,240,0,240,0,2,238
Listas,2014EP,12-041-005,874,261,0,261,0,1,260
Listas,2014EP,12-042-001,1404,397,0,397,0,3,394
Listas,2014EP,12-043-001,548,140,0,140,0,1,139
Listas,2014EP,12-044-001,856,230,0,230,0,0,230
Listas,2014EP,12-044-002,942,233,0,233,0,0,233
Listas,2014EP,12-045-001,692,232,0,232,0,0,232
Listas,2014EP,12-046-001,809,206,0,206,0,0,206
Listas,2014EP,12-046-002,692,163,0,162,-1,1,161
Listas,2014EP,12-046-003,763,149,0,149,0,1,148
Listas,2014EP,12-046-004,133,15,0,15,0,0,15
Listas,2014EP,12-047-001,635,131,0,131,0,0,131
Listas,2014EP,12-047-002,586,112,0,112,0,1,111
Listas,2014EP,12-048-001,1101,235,0,235,0,2,233
Listas,2014EP,12-048-002,880,172,0,172,0,1,171
Listas,2014EP,12-049-001,549,174,0,174,0,0,174
Listas,2014EP,12-049-002,552,140,0,140,0,1,139
Listas,2014EP,12-050-001,874,158,0,158,0,1,157
Listas,2014EP,12-050-002,1173,401,0,401,0,1,400
Listas,2014EP,12-050-003,980,342,0,342,0,0,342
Listas,2014EP,12-050-004,833,288,0,288,0,0,288
Listas,2014EP,12-050-005,770,209,0,209,0,1,208
Listas,2014EP,12-050-006,855,184,0,184,0,0,184
Listas,2014EP,12-050-007,712,204,0,204,0,1,203
Listas,2014EP,12-051-001,831,205,0,205,0,1,204
Listas,2014EP,12-051-002,967,220,0,220,0,0,220
Listas,2014EP,12-051-003,970,231,0,231,0,0,231
Listas,2014EP,12-051-004,1255,367,0,367,0,0,367
Listas,2014EP,12-051-005,1060,170,0,170,0,0,170
Listas,2014EP,12-051-006,825,178,0,178,0,1,177
Listas,2014EP,12-051-007,1027,161,0,161,0,0,161
Listas,2014EP,12-051-008,931,142,0,142,0,2,140
Listas,2014EP,12-051-009,918,240,0,240,0,0,240
Listas,2014EP,12-051-010,959,233,0,233,0,1,232
Listas,2014EP,12-051-011,975,220,0,220,0,0,220
Listas,2014EP,12-051-012,902,208,0,208,0,0,208
Listas,2014EP,12-051-013,994,239,0,239,0,1,238
Listas,2014EP,12-051-014,1016,265,0,265,0,0,265
Listas,2014EP,12-051-015,928,283,0,283,0,2,281
Listas,2014EP,12-051-016,944,216,0,216,0,0,216
Listas,2014EP,12-052-001,1021,235,0,235,0,0,235
Listas,2014EP,12-052-002,977,306,0,306,0,2,304
Listas,2014EP,12-053-001,827,285,0,285,0,3,282
Listas,2014EP,12-053-002,840,232,0,232,0,3,229
Listas,2014EP,12-054-001,1134,251,0,249,-2,0,249
Listas,2014EP,12-055-001,712,163,0,163,0,0,163
Listas,2014EP,12-055-002,773,210,0,210,0,1,209
Listas,2014EP,12-055-003,791,156,0,156,0,1,155
Listas,2014EP,12-056-001,994,138,0,138,0,0,138
Listas,2014EP,12-057-001,820,208,0,208,0,0,208
Listas,2014EP,12-057-002,884,241,0,241,0,1,240
Listas,2014EP,12-058-001,1223,223,0,223,0,0,223
Listas,2014EP,12-059-001,978,301,0,301,0,1,300
Listas,2014EP,12-059-002,941,265,0,265,0,0,265
Listas,2014EP,12-060-001,892,260,0,260,0,0,260
Listas,2014EP,12-061-001,720,171,0,171,0,0,171
Listas,2014EP,12-061-002,993,262,0,262,0,3,259
Listas,2014EP,12-062-001,1296,275,0,274,-1,1,273
Listas,2014EP,12-063-001,932,293,0,293,0,2,291
Listas,2014EP,12-063-002,1082,298,0,298,0,1,297
Listas,2014EP,12-063-003,113,15,0,15,0,0,15
Listas,2014EP,12-064-001,931,321,0,321,0,2,319
Listas,2014EP,12-064-002,804,288,0,288,0,1,287
Listas,2014EP,12-064-003,807,223,0,225,2,14,211
Listas,2014EP,12-064-004,788,195,0,195,0,1,194
Listas,2014EP,12-064-005,798,270,0,270,0,0,270
Listas,2014EP,12-064-006,776,214,0,214,0,1,213
Listas,2014EP,12-064-007,821,245,0,245,0,0,245
Listas,2014EP,12-064-008,688,275,0,275,0,3,272
Listas,2014EP,12-064-009,734,211,0,211,0,1,210
Listas,2014EP,12-064-010,690,219,0,219,0,1,218
Listas,2014EP,12-064-011,637,195,0,195,0,0,195
Listas,2014EP,12-064-012,1131,345,0,345,0,1,344
Listas,2014EP,12-064-013,682,284,0,284,0,1,283
Listas,2014EP,12-064-014,759,298,0,298,0,1,297
Listas,2014EP,12-064-015,799,320,0,320,0,1,319
Listas,2014EP,12-064-016,787,338,1,337,-1,0,337
Listas,2014EP,12-064-017,822,297,1,296,-1,1,295
Listas,2014EP,12-064-018,733,206,0,206,0,2,204
Listas,2014EP,12-064-019,774,213,0,213,0,1,212
Listas,2014EP,12-064-020,804,317,0,317,0,0,317
Listas,2014EP,12-064-021,834,314,0,314,0,1,313
Listas,2014EP,12-064-022,979,248,0,248,0,0,248
Listas,2014EP,12-064-023,1102,373,0,373,0,1,372
Listas,2014EP,12-064-024,499,152,0,152,0,1,151
Listas,2014EP,12-065-001,1007,336,0,336,0,2,334
Listas,2014EP,12-065-002,943,283,0,283,0,1,282
Listas,2014EP,12-065-003,621,98,0,98,0,2,96
Listas,2014EP,12-065-004,675,36,0,36,0,0,36
Listas,2014EP,12-065-005,836,61,0,61,0,2,59
Listas,2014EP,12-065-006,870,200,0,200,0,3,197
Listas,2014EP,12-065-007,977,293,0,293,0,1,292
Listas,2014EP,12-065-008,1050,272,0,272,0,0,272
Listas,2014EP,12-065-009,654,165,0,165,0,2,163
Listas,2014EP,12-065-010,928,378,0,378,0,2,376
Listas,2014EP,12-065-011,894,335,0,335,0,0,335
Listas,2014EP,12-065-012,1103,315,0,315,0,1,314
Listas,2014EP,12-065-013,1025,309,0,309,0,0,309
Listas,2014EP,12-065-014,972,191,0,191,0,0,191
Listas,2014EP,12-065-015,780,169,0,169,0,0,169
Listas,2014EP,12-065-016,729,184,0,184,0,0,184
Listas,2014EP,12-065-017,1092,307,0,307,0,0,307
Listas,2014EP,12-065-018,1109,372,0,372,0,3,369
Listas,2014EP,12-065-019,1081,398,0,398,0,1,397
Listas,2014EP,12-065-020,842,314,0,314,0,0,314
Listas,2014EP,12-065-021,829,290,0,290,0,0,290
Listas,2014EP,12-065-022,950,245,0,245,0,0,245
Listas,2014EP,12-065-023,938,258,0,258,0,0,258
Listas,2014EP,12-065-024,921,233,0,233,0,2,231
Listas,2014EP,12-065-025,643,177,0,177,0,0,177
Listas,2014EP,12-065-026,765,178,0,178,0,2,176
Listas,2014EP,12-065-027,904,291,0,291,0,2,289
Listas,2014EP,12-065-028,1115,272,0,272,0,2,270
Listas,2014EP,12-065-029,939,261,0,261,0,2,259
Listas,2014EP,12-065-030,906,261,0,261,0,1,260
Listas,2014EP,12-065-031,916,303,0,303,0,1,302
Listas,2014EP,12-065-032,899,249,0,249,0,1,248
Listas,2014EP,12-065-033,860,258,0,258,0,1,257
Listas,2014EP,12-065-034,1052,241,0,241,0,1,240
Listas,2014EP,12-065-035,978,271,0,271,0,3,268
Listas,2014EP,12-065-036,954,264,0,264,0,0,264
Listas,2014EP,12-065-037,1926,466,0,465,-1,0,465
Listas,2014EP,12-065-038,1014,323,0,323,0,2,321
Listas,2014EP,12-065-039,1047,268,0,267,-1,0,267
Listas,2014EP,12-065-040,933,231,0,231,0,2,229
Listas,2014EP,12-065-041,934,262,0,262,0,3,259
Listas,2014EP,12-065-042,851,208,0,208,0,1,207
Listas,2014EP,12-065-043,849,221,0,221,0,0,221
Listas,2014EP,12-065-044,970,273,0,273,0,1,272
Listas,2014EP,12-065-045,956,252,0,252,0,2,250
Listas,2014EP,12-065-046,873,233,0,233,0,0,233
Listas,2014EP,12-065-047,991,281,0,280,-1,2,278
Listas,2014EP,12-065-048,870,241,0,241,0,0,241
Listas,2014EP,12-065-049,1027,264,0,264,0,1,263
Listas,2014EP,12-065-050,850,198,0,198,0,0,198
Listas,2014EP,12-065-051,792,164,0,164,0,0,164
Listas,2014EP,12-065-052,819,220,0,219,-1,1,218
Listas,2014EP,12-065-053,1156,272,0,272,0,1,271
Listas,2014EP,12-065-054,984,135,0,135,0,0,135
Listas,2014EP,12-065-055,938,138,0,138,0,0,138
Listas,2014EP,12-065-056,892,124,0,124,0,0,124
Listas,2014EP,12-065-057,923,299,0,299,0,2,297
Listas,2014EP,12-065-058,1083,314,0,314,0,1,313
Listas,2014EP,12-065-059,1094,295,0,295,0,1,294
Listas,2014EP,12-065-060,908,187,0,187,0,1,186
Listas,2014EP,12-066-001,1012,188,0,188,0,0,188
Listas,2014EP,12-066-002,200,28,0,28,0,0,28
Listas,2014EP,12-067-001,589,208,0,208,0,1,207
Listas,2014EP,12-067-002,1050,303,0,303,0,1,302
Listas,2014EP,12-067-003,728,152,0,152,0,0,152
Listas,2014EP,12-067-004,759,177,0,177,0,1,176
Listas,2014EP,12-067-005,803,213,0,213,0,1,212
Listas,2014EP,12-067-006,605,184,1,183,-1,3,180
Listas,2014EP,12-068-001,214,42,0,42,0,0,42
Listas,2014EP,12-068-002,687,198,0,198,0,2,196
Listas,2014EP,12-068-003,729,195,0,195,0,1,194
Listas,2014EP,12-068-004,746,155,0,155,0,0,155
Listas,2014EP,12-068-005,1069,238,0,238,0,0,238
Listas,2014EP,12-069-001,837,162,0,162,0,0,162
Listas,2014EP,12-069-002,841,174,0,174,0,2,172
Listas,2014EP,12-069-003,685,162,0,162,0,1,161
Listas,2014EP,12-070-001,576,166,0,166,0,0,166
Listas,2014EP,12-071-001,504,165,0,165,0,1,164
Listas,2014EP,12-072-001,486,135,0,135,0,0,135
Listas,2014EP,12-073-001,1106,264,0,264,0,0,264
Listas,2014EP,12-074-001,822,284,0,284,0,0,284
Listas,2014EP,12-074-002,862,184,0,184,0,0,184
Listas,2014EP,12-074-003,878,298,1,297,-1,1,296
Listas,2014EP,12-075-001,424,120,0,120,0,0,120
Listas,2014EP,12-076-001,720,108,0,108,0,2,106
Listas,2014EP,12-076-002,662,158,0,158,0,0,158
Listas,2014EP,13-001-001,505,170,0,170,0,2,168
Listas,2014EP,13-002-001,225,75,0,75,0,2,73
Listas,2014EP,13-003-001,842,250,0,250,0,0,250
Listas,2014EP,13-003-002,984,346,0,346,0,1,345
Listas,2014EP,13-003-003,866,246,0,246,0,0,246
Listas,2014EP,13-003-004,751,189,0,189,0,3,186
Listas,2014EP,13-003-005,823,269,0,269,0,1,268
Listas,2014EP,13-003-006,855,232,0,232,0,14,218
Listas,2014EP,13-003-007,845,237,0,237,0,0,237
Listas,2014EP,13-003-008,822,213,0,213,0,1,212
Listas,2014EP,13-003-009,766,287,0,287,0,1,286
Listas,2014EP,13-003-010,946,214,0,214,0,0,214
Listas,2014EP,13-003-011,680,237,0,237,0,1,236
Listas,2014EP,13-003-012,829,217,0,217,0,0,217
Listas,2014EP,13-003-013,770,243,0,243,0,0,243
Listas,2014EP,13-003-014,804,290,0,290,0,7,283
Listas,2014EP,13-003-015,783,277,0,277,0,0,277
Listas,2014EP,13-003-016,799,252,0,252,0,1,251
Listas,2014EP,13-004-001,608,266,0,266,0,0,266
Listas,2014EP,13-005-001,861,175,0,175,0,0,175
Listas,2014EP,13-006-001,616,141,0,141,0,0,141
Listas,2014EP,13-006-002,667,142,0,142,0,0,142
Listas,2014EP,13-006-003,703,123,0,122,-1,2,120
Listas,2014EP,13-006-004,562,132,0,132,0,1,131
Listas,2014EP,13-006-005,735,145,0,145,0,0,145
Listas,2014EP,13-006-006,641,175,0,175,0,1,174
Listas,2014EP,13-006-007,1278,322,0,322,0,0,322
Listas,2014EP,13-006-008,602,158,0,158,0,0,158
Listas,2014EP,13-006-009,631,214,0,214,0,0,214
Listas,2014EP,13-006-010,787,233,0,233,0,0,233
Listas,2014EP,13-006-011,693,165,0,165,0,2,163
Listas,2014EP,13-006-012,640,202,0,202,0,0,202
Listas,2014EP,13-006-013,707,170,0,169,-1,1,168
Listas,2014EP,13-006-014,615,113,0,113,0,1,112
Listas,2014EP,13-006-015,687,169,0,169,0,3,166
Listas,2014EP,13-007-001,479,132,0,132,0,2,130
Listas,2014EP,13-008-001,775,180,1,179,-1,1,178
Listas,2014EP,13-008-002,748,214,0,214,0,2,212
Listas,2014EP,13-009-001,522,171,0,171,0,0,171
Listas,2014EP,13-010-001,305,103,0,103,0,0,103
Listas,2014EP,13-011-001,106,63,0,63,0,1,62
Listas,2014EP,13-012-001,774,187,0,187,0,0,187
Listas,2014EP,13-013-001,885,168,0,168,0,0,168
Listas,2014EP,13-013-002,842,138,0,138,0,0,138
Listas,2014EP,13-014-001,959,180,0,180,0,2,178
Listas,2014EP,13-015-001,290,103,0,103,0,0,103
Listas,2014EP,13-016-001,693,231,0,231,0,0,231
Listas,2014EP,13-017-001,123,59,0,59,0,3,56
Listas,2014EP,13-018-001,247,78,0,78,0,1,77
Listas,2014EP,13-019-001,758,165,0,165,0,1,164
Listas,2014EP,13-020-001,364,92,0,92,0,0,92
Listas,2014EP,13-021-001,75,34,0,34,0,0,34
Listas,2014EP,13-022-001,1157,311,0,311,0,0,311
Listas,2014EP,13-023-001,717,233,0,233,0,0,233
Listas,2014EP,13-023-002,795,223,0,223,0,0,223
Listas,2014EP,13-023-003,750,200,0,200,0,0,200
Listas,2014EP,13-024-001,560,185,0,185,0,1,184
Listas,2014EP,13-024-002,345,90,0,90,0,0,90
Listas,2014EP,13-025-001,1162,312,0,312,0,0,312
Listas,2014EP,13-026-001,936,157,0,157,0,0,157
Listas,2014EP,13-027-001,419,115,0,115,0,0,115
Listas,2014EP,13-028-001,590,130,0,130,0,0,130
Listas,2014EP,13-029-001,914,117,0,117,0,0,117
Listas,2014EP,13-030-001,454,189,0,189,0,1,188
Listas,2014EP,13-031-001,454,92,0,92,0,1,91
Listas,2014EP,13-032-001,708,189,0,189,0,1,188
Listas,2014EP,13-032-002,146,31,0,31,0,0,31
Listas,2014EP,13-032-003,253,26,0,26,0,0,26
Listas,2014EP,13-033-001,727,227,0,227,0,1,226
Listas,2014EP,13-033-002,858,234,0,234,0,0,234
Listas,2014EP,13-033-003,641,223,0,223,0,1,222
Listas,2014EP,13-033-004,727,177,0,177,0,0,177
Listas,2014EP,13-034-001,487,189,0,189,0,1,188
Listas,2014EP,13-035-001,132,49,0,49,0,0,49
Listas,2014EP,13-036-001,535,125,0,125,0,1,124
Listas,2014EP,13-037-001,46,33,0,33,0,0,33
Listas,2014EP,13-038-001,521,175,0,175,0,2,173
Listas,2014EP,13-039-001,803,163,0,163,0,1,162
Listas,2014EP,13-040-001,309,150,0,150,0,0,150
Listas,2014EP,13-041-001,443,142,0,142,0,0,142
Listas,2014EP,13-042-001,153,94,0,94,0,1,93
Listas,2014EP,13-043-001,643,108,0,108,0,0,108
Listas,2014EP,13-044-001,156,62,0,62,0,0,62
Listas,2014EP,13-045-001,376,97,0,97,0,0,97
Listas,2014EP,13-046-001,694,165,0,165,0,0,165
Listas,2014EP,13-047-001,855,201,0,201,0,1,200
Listas,2014EP,13-047-002,795,200,0,200,0,0,200
Listas,2014EP,13-048-001,690,152,0,152,0,1,151
Listas,2014EP,13-048-002,586,137,0,137,0,2,135
Listas,2014EP,13-049-001,741,180,0,180,0,5,175
Listas,2014EP,13-050-001,715,142,0,142,0,0,142
Listas,2014EP,13-050-002,591,130,0,130,0,0,130
Listas,2014EP,13-050-003,183,56,0,56,0,0,56
Listas,2014EP,13-051-001,729,129,0,129,0,0,129
Listas,2014EP,13-051-002,744,189,0,189,0,0,189
Listas,2014EP,13-051-003,692,198,0,198,0,0,198
Listas,2014EP,13-052-001,936,177,0,177,0,0,177
Listas,2014EP,13-053-001,596,129,0,129,0,1,128
Listas,2014EP,13-053-002,672,129,0,129,0,0,129
Listas,2014EP,13-053-003,277,77,0,77,0,0,77
Listas,2014EP,13-054-001,1068,206,0,206,0,1,205
Listas,2014EP,13-055-001,585,156,0,156,0,0,156
Listas,2014EP,13-056-001,414,163,0,163,0,0,163
Listas,2014EP,13-057-001,367,80,0,80,0,1,79
Listas,2014EP,13-058-001,163,82,0,82,0,0,82
Listas,2014EP,13-059-001,154,60,0,60,0,0,60
Listas,2014EP,13-060-001,481,169,0,169,0,1,168
Listas,2014EP,13-061-001,152,78,0,78,0,0,78
Listas,2014EP,13-062-001,85,42,0,42,0,0,42
Listas,2014EP,13-063-001,366,105,0,105,0,2,103
Listas,2014EP,13-064-001,648,158,0,158,0,0,158
Listas,2014EP,13-065-001,498,141,0,141,0,0,141
Listas,2014EP,13-066-001,614,106,0,106,0,0,106
Listas,2014EP,13-066-002,408,78,0,78,0,1,77
Listas,2014EP,13-067-001,631,167,0,167,0,3,164
Listas,2014EP,13-068-001,963,219,0,219,0,0,219
Listas,2014EP,13-069-001,202,79,0,79,0,0,79
Listas,2014EP,13-070-001,674,190,0,190,0,2,188
Listas,2014EP,13-071-001,958,226,0,226,0,0,226
Listas,2014EP,13-071-002,516,89,0,89,0,0,89
Listas,2014EP,13-072-001,800,183,0,183,0,0,183
Listas,2014EP,13-073-001,1267,253,0,253,0,2,251
Listas,2014EP,13-074-001,932,221,0,221,0,1,220
Listas,2014EP,13-074-002,609,176,0,176,0,0,176
Listas,2014EP,13-075-001,657,143,0,143,0,0,143
Listas,2014EP,13-075-002,641,107,0,107,0,1,106
Listas,2014EP,13-075-003,234,62,0,62,0,0,62
Listas,2014EP,13-076-001,520,156,0,156,0,0,156
Listas,2014EP,13-077-001,743,132,0,132,0,1,131
Listas,2014EP,13-078-001,515,134,0,134,0,0,134
Listas,2014EP,13-079-001,222,65,0,65,0,0,65
Listas,2014EP,13-080-001,659,110,0,110,0,1,109
Listas,2014EP,13-080-002,497,98,0,98,0,1,97
Listas,2014EP,13-080-003,61,31,0,31,0,0,31
Listas,2014EP,13-081-001,794,168,0,168,0,2,166
Listas,2014EP,13-081-002,895,181,0,181,0,0,181
Listas,2014EP,13-082-001,628,194,0,194,0,0,194
Listas,2014EP,13-083-001,942,249,0,249,0,0,249
Listas,2014EP,13-084-001,730,255,0,255,0,1,254
Listas,2014EP,13-084-002,514,171,0,171,0,0,171
Listas,2014EP,13-085-001,557,119,0,119,0,0,119
Listas,2014EP,13-086-001,427,104,0,104,0,0,104
Listas,2014EP,13-087-001,622,133,0,133,0,0,133
Listas,2014EP,13-087-002,620,113,0,113,0,1,112
Listas,2014EP,13-088-001,753,251,0,251,0,0,251
Listas,2014EP,13-089-001,626,163,0,163,0,0,163
Listas,2014EP,13-090-001,471,151,0,151,0,0,151
Listas,2014EP,13-091-001,969,300,0,300,0,1,299
Listas,2014EP,13-092-001,875,283,0,283,0,1,282
Listas,2014EP,13-093-001,287,113,0,113,0,0,113
Listas,2014EP,13-094-001,607,144,0,144,0,1,143
Listas,2014EP,13-094-002,737,197,0,197,0,2,195
Listas,2014EP,13-095-001,756,247,0,247,0,1,246
Listas,2014EP,13-096-001,578,175,0,175,0,0,175
Listas,2014EP,13-097-001,963,294,0,294,0,1,293
Listas,2014EP,13-097-002,998,162,0,162,0,1,161
Listas,2014EP,13-097-003,806,276,0,276,0,1,275
Listas,2014EP,13-097-004,851,270,0,270,0,0,270
Listas,2014EP,13-097-005,1031,269,0,269,0,4,265
Listas,2014EP,13-097-006,963,258,0,258,0,1,257
Listas,2014EP,13-097-007,1117,356,0,356,0,2,354
Listas,2014EP,13-097-008,772,196,0,196,0,0,196
Listas,2014EP,13-097-009,322,142,0,142,0,1,141
Listas,2014EP,13-098-001,483,114,0,114,0,2,112
Listas,2014EP,13-099-001,125,77,0,77,0,0,77
Listas,2014EP,13-100-001,1191,357,0,357,0,2,355
Listas,2014EP,13-100-002,1122,371,1,371,0,0,371
Listas,2014EP,13-101-001,813,134,0,134,0,1,133
Listas,2014EP,13-101-002,586,170,0,170,0,0,170
Listas,2014EP,13-102-001,857,214,0,214,0,1,213
Listas,2014EP,13-102-002,912,207,0,207,0,1,206
Listas,2014EP,13-103-001,230,73,0,73,0,0,73
Listas,2014EP,13-103-002,218,74,0,74,0,0,74
Listas,2014EP,13-103-003,865,236,0,236,0,2,234
Listas,2014EP,13-103-004,821,256,0,256,0,4,252
Listas,2014EP,13-103-005,1080,331,0,331,0,0,331
Listas,2014EP,13-103-006,672,250,0,250,0,0,250
Listas,2014EP,13-103-007,879,362,0,363,1,9,354
Listas,2014EP,13-103-008,854,304,0,304,0,1,303
Listas,2014EP,13-103-009,837,288,0,288,0,0,288
Listas,2014EP,13-103-010,117,31,0,31,0,0,31
Listas,2014EP,13-103-011,134,59,0,59,0,0,59
Listas,2014EP,13-103-012,552,119,0,118,-1,1,117
Listas,2014EP,13-103-013,949,214,0,214,0,0,214
Listas,2014EP,13-103-014,769,147,0,147,0,0,147
Listas,2014EP,13-103-015,596,133,0,133,0,0,133
Listas,2014EP,13-103-016,1011,272,0,272,0,1,271
Listas,2014EP,13-103-017,924,323,0,323,0,0,323
Listas,2014EP,13-103-018,1230,428,0,428,0,3,425
Listas,2014EP,13-103-019,563,168,1,168,0,0,168
Listas,2014EP,13-103-020,656,201,0,201,0,0,201
Listas,2014EP,13-103-021,999,419,0,419,0,1,418
Listas,2014EP,13-103-022,835,264,0,264,0,0,264
Listas,2014EP,13-103-023,656,226,0,226,0,0,226
Listas,2014EP,13-103-024,699,189,0,189,0,0,189
Listas,2014EP,13-103-025,909,254,0,254,0,2,252
Listas,2014EP,13-103-026,1100,304,0,304,0,0,304
Listas,2014EP,13-103-027,1045,229,0,229,0,2,227
Listas,2014EP,13-103-028,890,297,0,297,0,2,295
Listas,2014EP,13-103-029,823,207,0,207,0,0,207
Listas,2014EP,13-103-030,630,210,0,210,0,0,210
Listas,2014EP,13-103-031,855,296,0,296,0,0,296
Listas,2014EP,13-103-032,725,140,0,140,0,0,140
Listas,2014EP,13-103-033,701,171,0,171,0,1,170
Listas,2014EP,13-103-034,815,162,0,162,0,0,162
Listas,2014EP,13-103-035,941,175,0,175,0,0,175
Listas,2014EP,13-103-036,861,108,0,108,0,0,108
Listas,2014EP,13-103-037,617,159,0,159,0,3,156
Listas,2014EP,13-103-038,1359,383,0,383,0,3,380
Listas,2014EP,13-103-039,969,227,0,227,0,1,226
Listas,2014EP,13-103-040,803,203,0,203,0,0,203
Listas,2014EP,13-104-001,771,155,0,155,0,0,155
Listas,2014EP,13-105-001,227,91,0,91,0,1,90
Listas,2014EP,13-106-001,636,108,0,108,0,2,106
Listas,2014EP,13-107-001,360,90,0,90,0,0,90
Listas,2014EP,13-108-001,394,132,0,132,0,1,131
Listas,2014EP,13-108-002,164,63,0,63,0,0,63
Listas,2014EP,13-109-001,339,94,0,94,0,1,93
Listas,2014EP,13-110-001,398,68,0,68,0,1,67
Listas,2014EP,13-111-001,1034,326,0,326,0,0,326
Listas,2014EP,13-111-002,254,78,0,78,0,1,77
Listas,2014EP,13-112-001,297,89,0,89,0,2,87
Listas,2014EP,13-113-001,191,79,0,79,0,1,78
Listas,2014EP,13-114-001,1152,373,0,373,0,4,369
Listas,2014EP,13-114-002,1156,368,0,368,0,3,365
Listas,2014EP,13-114-003,1149,346,0,346,0,2,344
Listas,2014EP,13-114-004,1181,331,0,331,0,1,330
Listas,2014EP,13-114-005,160,54,0,54,0,0,54
Listas,2014EP,13-114-006,232,60,0,60,0,0,60
Listas,2014EP,13-115-001,364,99,0,99,0,2,97
Listas,2014EP,13-116-001,256,63,0,63,0,0,63
Listas,2014EP,13-117-001,843,104,0,104,0,1,103
Listas,2014EP,13-118-001,430,147,0,147,0,0,147
Listas,2014EP,13-118-002,89,51,0,51,0,2,49
Listas,2014EP,13-119-001,980,250,0,250,0,0,250
Listas,2014EP,13-119-002,685,148,0,148,0,0,148
Listas,2014EP,13-120-001,627,152,0,152,0,0,152
Listas,2014EP,13-120-002,561,161,0,161,0,1,160
Listas,2014EP,13-121-001,856,157,0,157,0,2,155
Listas,2014EP,13-121-002,713,159,0,159,0,0,159
Listas,2014EP,13-122-001,547,161,0,161,0,1,160
Listas,2014EP,13-123-001,318,127,0,127,0,0,127
Listas,2014EP,13-124-001,619,197,0,197,0,4,193
Listas,2014EP,13-125-001,1058,255,0,255,0,2,253
Listas,2014EP,13-126-001,628,162,0,162,0,0,162
Listas,2014EP,13-126-002,737,258,0,258,0,1,257
Listas,2014EP,13-127-001,1132,202,0,201,-1,0,201
Listas,2014EP,13-128-001,392,61,0,61,0,0,61
Listas,2014EP,13-129-001,510,129,0,129,0,0,129
Listas,2014EP,13-130-001,519,144,0,144,0,0,144
Listas,2014EP,13-131-001,1049,274,0,274,0,2,272
Listas,2014EP,13-131-002,883,277,2,275,-2,2,273
Listas,2014EP,14-001-001,771,131,0,131,0,3,128
Listas,2014EP,14-001-002,780,173,0,173,0,0,173
Listas,2014EP,14-001-003,738,107,0,107,0,0,107
Listas,2014EP,14-001-004,746,131,0,131,0,1,130
Listas,2014EP,14-001-005,728,155,0,155,0,1,154
Listas,2014EP,14-001-006,721,180,0,180,0,2,178
Listas,2014EP,14-001-007,745,162,0,162,0,1,161
Listas,2014EP,14-001-008,753,150,0,150,0,0,150
Listas,2014EP,14-001-009,746,140,0,140,0,0,140
Listas,2014EP,14-001-010,768,116,0,116,0,1,115
Listas,2014EP,14-001-011,755,187,0,187,0,0,187
Listas,2014EP,14-001-012,729,154,0,154,0,1,153
Listas,2014EP,14-001-013,751,165,0,165,0,1,164
Listas,2014EP,14-001-014,740,164,0,164,0,1,163
Listas,2014EP,14-001-015,720,188,0,188,0,0,188
Listas,2014EP,14-001-016,675,220,0,220,0,0,220
Listas,2014EP,14-002-001,1132,228,0,228,0,0,228
Listas,2014EP,14-003-001,592,179,0,179,0,0,179
Listas,2014EP,14-003-002,650,230,0,230,0,1,229
Listas,2014EP,14-003-003,610,134,0,134,0,1,133
Listas,2014EP,14-003-004,569,144,0,144,0,0,144
Listas,2014EP,14-003-005,596,139,0,139,0,0,139
Listas,2014EP,14-003-006,671,124,0,124,0,0,124
Listas,2014EP,14-003-007,671,128,0,128,0,1,127
Listas,2014EP,14-003-008,649,147,1,147,0,2,145
Listas,2014EP,14-003-009,640,159,0,159,0,1,158
Listas,2014EP,14-003-010,618,106,0,106,0,0,106
Listas,2014EP,14-003-011,621,143,0,143,0,0,143
Listas,2014EP,14-003-012,610,126,0,126,0,1,125
Listas,2014EP,14-003-013,564,131,0,131,0,0,131
Listas,2014EP,14-003-014,596,147,0,147,0,0,147
Listas,2014EP,14-003-015,616,121,0,121,0,0,121
Listas,2014EP,14-003-016,680,102,0,102,0,0,102
Listas,2014EP,14-004-001,745,202,0,202,0,0,202
Listas,2014EP,14-004-002,783,181,0,181,0,1,180
Listas,2014EP,14-004-003,778,217,0,217,0,1,216
Listas,2014EP,14-004-004,727,183,1,182,-1,3,179
Listas,2014EP,14-004-005,972,230,0,230,0,2,228
Listas,2014EP,14-005-001,980,152,0,152,0,0,152
Listas,2014EP,14-006-001,840,247,0,247,0,2,245
Listas,2014EP,14-006-002,791,221,0,221,0,0,221
Listas,2014EP,14-006-003,774,237,0,237,0,1,236
Listas,2014EP,14-006-004,1046,295,0,295,0,0,295
Listas,2014EP,14-006-005,579,174,0,174,0,0,174
Listas,2014EP,14-006-006,898,221,0,221,0,0,221
Listas,2014EP,14-007-001,968,230,0,230,0,0,230
Listas,2014EP,14-008-001,732,284,0,284,0,0,284
Listas,2014EP,14-008-002,760,199,0,199,0,0,199
Listas,2014EP,14-008-003,814,212,0,212,0,2,210
Listas,2014EP,14-008-004,680,245,0,245,0,0,245
Listas,2014EP,14-009-001,702,225,0,225,0,0,225
Listas,2014EP,14-010-001,949,245,0,245,0,2,243
Listas,2014EP,14-011-001,1196,461,0,461,0,0,461
Listas,2014EP,14-011-002,1094,370,0,370,0,0,370
Listas,2014EP,14-011-003,1142,403,0,402,-1,0,402
Listas,2014EP,14-011-004,1268,454,0,454,0,1,453
Listas,2014EP,14-011-005,1227,522,0,522,0,2,520
Listas,2014EP,14-011-006,1085,409,0,409,0,2,407
Listas,2014EP,14-011-007,1225,347,0,347,0,2,345
Listas,2014EP,14-011-008,1206,427,0,427,0,1,426
Listas,2014EP,14-012-001,728,337,0,337,0,0,337
Listas,2014EP,14-012-002,710,331,0,331,0,1,330
Listas,2014EP,14-013-001,1150,465,0,465,0,1,464
Listas,2014EP,14-013-002,989,338,0,338,0,2,336
Listas,2014EP,14-013-003,1182,461,0,461,0,1,460
Listas,2014EP,14-013-004,1107,387,0,387,0,0,387
Listas,2014EP,14-013-005,1036,409,0,409,0,6,403
Listas,2014EP,14-013-006,983,455,0,455,0,2,453
Listas,2014EP,14-013-007,1054,429,1,428,-1,0,428
Listas,2014EP,14-013-008,983,404,0,404,0,3,401
Listas,2014EP,14-014-001,704,385,0,385,0,3,382
Listas,2014EP,14-014-002,623,292,0,292,0,2,290
Listas,2014EP,14-014-003,913,463,0,462,-1,2,460
Listas,2014EP,14-014-004,598,259,0,259,0,1,258
Listas,2014EP,14-014-005,772,299,0,299,0,0,299
Listas,2014EP,14-014-006,709,323,0,323,0,1,322
Listas,2014EP,14-014-007,618,332,0,332,0,1,331
Listas,2014EP,14-014-008,698,390,0,390,0,0,390
Listas,2014EP,14-014-009,681,279,0,279,0,0,279
Listas,2014EP,14-014-010,672,265,0,265,0,0,265
Listas,2014EP,14-014-011,634,291,0,291,0,0,291
Listas,2014EP,14-014-012,697,377,0,377,0,0,377
Listas,2014EP,14-014-013,730,356,0,356,0,0,356
Listas,2014EP,14-014-014,596,256,0,255,-1,0,255
Listas,2014EP,14-014-015,781,324,0,325,1,8,317
Listas,2014EP,14-014-016,610,240,0,240,0,1,239
Listas,2014EP,14-015-001,1062,437,0,437,0,0,437
Listas,2014EP,14-015-002,1459,650,0,650,0,1,649
Listas,2014EP,14-015-003,1135,438,0,438,0,0,438
Listas,2014EP,14-015-004,1081,438,0,439,1,7,432
Listas,2014EP,14-015-005,1139,496,0,496,0,1,495
Listas,2014EP,14-015-006,994,451,0,450,-1,2,448
Listas,2014EP,14-015-007,1108,491,0,491,0,0,491
Listas,2014EP,14-015-008,1087,525,0,526,1,7,519
Listas,2014EP,14-015-009,1096,346,0,346,0,1,345
Listas,2014EP,14-015-010,1107,350,0,350,0,2,348
Listas,2014EP,14-015-011,1103,328,0,328,0,2,326
Listas,2014EP,14-015-012,1097,335,0,335,0,1,334
Listas,2014EP,14-015-013,1112,371,0,371,0,3,368
Listas,2014EP,14-015-014,1168,347,0,346,-1,0,346
Listas,2014EP,14-015-015,1091,415,0,415,0,1,414
Listas,2014EP,14-015-016,1108,436,3,433,-3,1,432
Listas,2014EP,14-015-017,1092,486,0,486,0,1,485
Listas,2014EP,14-015-018,1163,494,0,494,0,1,493
Listas,2014EP,14-015-019,897,367,0,367,0,2,365
Listas,2014EP,14-015-020,1054,501,0,501,0,1,500
Listas,2014EP,14-016-001,738,181,0,181,0,0,181
Listas,2014EP,14-016-002,770,145,0,145,0,0,145
Listas,2014EP,14-016-003,670,159,0,159,0,2,157
Listas,2014EP,14-016-004,716,157,0,157,0,0,157
Listas,2014EP,14-016-005,873,156,0,156,0,4,152
Listas,2014EP,14-016-006,220,33,0,33,0,0,33
Listas,2014EP,14-016-007,189,20,0,20,0,0,20
Listas,2014EP,14-017-001,837,323,0,323,0,0,323
Listas,2014EP,14-017-002,896,383,0,383,0,0,383
Listas,2014EP,14-017-003,1163,366,0,366,0,2,364
Listas,2014EP,14-017-004,773,245,0,245,0,0,245
Listas,2014EP,14-017-005,1099,327,0,327,0,3,324
Listas,2014EP,14-017-006,765,271,0,271,0,0,271
Listas,2014EP,14-017-007,629,158,0,158,0,0,158
Listas,2014EP,14-017-008,651,247,0,247,0,1,246
Listas,2014EP,14-017-009,905,339,0,339,0,1,338
Listas,2014EP,14-017-010,949,331,0,331,0,1,330
Listas,2014EP,14-017-011,644,231,0,231,0,1,230
Listas,2014EP,14-017-012,680,225,0,225,0,3,222
Listas,2014EP,14-017-013,1349,377,0,377,0,1,376
Listas,2014EP,14-017-014,1081,261,0,261,0,1,260
Listas,2014EP,14-017-015,909,357,0,357,0,1,356
Listas,2014EP,14-017-016,834,288,0,288,0,1,287
Listas,2014EP,14-017-017,894,215,0,215,0,1,214
Listas,2014EP,14-017-018,767,116,0,116,0,1,115
Listas,2014EP,14-017-019,216,22,0,22,0,0,22
Listas,2014EP,14-017-020,1178,223,0,223,0,1,222
Listas,2014EP,14-017-021,1005,198,0,198,0,0,198
Listas,2014EP,14-017-022,1089,246,0,246,0,0,246
Listas,2014EP,14-017-023,1140,319,0,319,0,2,317
Listas,2014EP,14-017-024,843,196,0,196,0,0,196
Listas,2014EP,14-017-025,875,164,0,164,0,0,164
Listas,2014EP,14-017-026,1105,137,0,137,0,0,137
Listas,2014EP,14-017-027,1052,187,0,187,0,2,185
Listas,2014EP,14-017-028,811,275,0,275,0,2,273
Listas,2014EP,14-017-029,656,130,0,130,0,1,129
Listas,2014EP,14-017-030,701,197,0,197,0,1,196
Listas,2014EP,14-017-031,955,383,0,383,0,1,382
Listas,2014EP,14-017-032,1280,257,0,257,0,1,256
Listas,2014EP,14-017-033,1085,207,0,206,-1,1,205
Listas,2014EP,14-018-001,784,185,0,185,0,1,184
Listas,2014EP,14-018-002,736,188,0,188,0,0,188
Listas,2014EP,14-018-003,730,164,0,164,0,1,163
Listas,2014EP,14-018-004,690,204,0,204,0,1,203
Listas,2014EP,14-018-005,647,173,0,173,0,0,173
Listas,2014EP,14-019-001,1211,290,0,290,0,0,290
Listas,2014EP,14-019-002,886,141,0,141,0,0,141
Listas,2014EP,14-019-003,1241,198,0,198,0,3,195
Listas,2014EP,14-020-001,832,173,0,173,0,0,173
Listas,2014EP,14-020-002,733,135,0,135,0,1,134
Listas,2014EP,14-021-001,855,160,0,160,0,0,160
Listas,2014EP,14-021-002,853,367,0,367,0,4,363
Listas,2014EP,14-021-003,795,322,0,322,0,0,322
Listas,2014EP,14-022-001,1193,290,0,290,0,2,288
Listas,2014EP,14-023-001,1143,396,0,396,0,4,392
Listas,2014EP,14-023-002,977,369,0,369,0,3,366
Listas,2014EP,14-023-003,895,359,0,359,0,2,357
Listas,2014EP,14-023-004,958,295,0,294,-1,0,294
Listas,2014EP,14-023-005,1006,307,0,307,0,1,306
Listas,2014EP,14-023-006,1042,302,0,302,0,2,300
Listas,2014EP,14-023-007,1049,344,0,344,0,1,343
Listas,2014EP,14-024-001,532,144,0,144,0,2,142
Listas,2014EP,14-025-001,820,211,0,211,0,0,211
Listas,2014EP,14-025-002,814,231,0,231,0,1,230
Listas,2014EP,14-025-003,916,284,0,284,0,0,284
Listas,2014EP,14-025-004,813,194,0,194,0,1,193
Listas,2014EP,14-025-005,795,212,0,212,0,0,212
Listas,2014EP,14-025-006,847,266,0,266,0,2,264
Listas,2014EP,14-025-007,970,273,0,273,0,0,273
Listas,2014EP,14-025-008,783,216,0,216,0,1,215
Listas,2014EP,14-025-009,839,257,0,257,0,0,257
Listas,2014EP,14-025-010,797,204,0,204,0,0,204
Listas,2014EP,14-025-011,805,198,0,198,0,0,198
Listas,2014EP,14-025-012,855,236,0,236,0,1,235
Listas,2014EP,14-025-013,910,189,0,189,0,0,189
Listas,2014EP,14-025-014,777,165,0,165,0,2,163
Listas,2014EP,14-025-015,1106,178,0,178,0,1,177
Listas,2014EP,14-025-016,598,114,0,114,0,0,114
Listas,2014EP,14-026-001,815,146,0,146,0,0,146
Listas,2014EP,14-026-002,1143,197,0,197,0,0,197
Listas,2014EP,14-026-003,326,67,0,67,0,0,67
Listas,2014EP,14-027-001,792,232,0,232,0,0,232
Listas,2014EP,14-027-002,834,233,0,233,0,0,233
Listas,2014EP,14-027-003,884,223,0,223,0,0,223
Listas,2014EP,14-027-004,981,212,0,212,0,3,209
Listas,2014EP,14-028-001,910,182,0,182,0,0,182
Listas,2014EP,14-028-002,1050,257,0,257,0,0,257
Listas,2014EP,14-028-003,982,178,0,178,0,1,177
Listas,2014EP,14-029-001,806,339,0,338,-1,1,337
Listas,2014EP,14-029-002,917,313,0,313,0,0,313
Listas,2014EP,14-029-003,777,356,0,356,0,0,356
Listas,2014EP,14-029-004,864,259,0,259,0,1,258
Listas,2014EP,14-029-005,875,308,0,308,0,2,306
Listas,2014EP,14-029-006,904,301,0,300,-1,0,300
Listas,2014EP,14-029-007,822,343,0,343,0,0,343
Listas,2014EP,14-029-008,957,348,0,348,0,0,348
Listas,2014EP,14-030-001,573,131,0,131,0,0,131
Listas,2014EP,14-030-002,775,250,0,250,0,0,250
Listas,2014EP,14-030-003,298,75,0,75,0,2,73
Listas,2014EP,14-031-001,916,169,0,169,0,0,169
Listas,2014EP,14-031-002,962,274,0,274,0,2,272
Listas,2014EP,14-031-003,1003,269,0,269,0,4,265
Listas,2014EP,14-031-004,955,275,0,275,0,5,270
Listas,2014EP,14-031-005,955,215,0,215,0,0,215
Listas,2014EP,14-032-001,731,323,0,323,0,1,322
Listas,2014EP,14-032-002,1146,403,0,403,0,3,400
Listas,2014EP,14-032-003,774,294,0,294,0,1,293
Listas,2014EP,14-033-001,1206,285,0,285,0,1,284
Listas,2014EP,14-033-002,981,240,0,240,0,2,238
Listas,2014EP,14-033-003,980,295,0,295,0,0,295
Listas,2014EP,14-033-004,903,280,0,280,0,3,277
Listas,2014EP,14-033-005,927,267,0,267,0,0,267
Listas,2014EP,14-033-006,1007,378,0,377,-1,1,376
Listas,2014EP,14-033-007,880,335,0,335,0,1,334
Listas,2014EP,14-033-008,1167,379,0,379,0,1,378
Listas,2014EP,14-033-009,973,308,0,308,0,1,307
Listas,2014EP,14-033-010,1049,302,0,302,0,0,302
Listas,2014EP,14-033-011,1050,339,0,339,0,4,335
Listas,2014EP,14-033-012,1126,257,0,257,0,1,256
Listas,2014EP,14-033-013,970,214,0,214,0,0,214
Listas,2014EP,14-033-014,1097,304,0,304,0,1,303
Listas,2014EP,14-033-015,995,269,0,269,0,0,269
Listas,2014EP,14-033-016,944,279,0,279,0,0,279
Listas,2014EP,14-034-001,1076,358,0,358,0,0,358
Listas,2014EP,14-034-002,1092,360,0,360,0,1,359
Listas,2014EP,14-034-003,1096,367,0,367,0,0,367
Listas,2014EP,14-034-004,1113,371,0,371,0,0,371
Listas,2014EP,14-034-005,1039,294,0,294,0,1,293
Listas,2014EP,14-034-006,1257,337,0,337,0,0,337
Listas,2014EP,14-034-007,1046,365,0,365,0,1,364
Listas,2014EP,14-034-008,1097,415,0,415,0,0,415
Listas,2014EP,14-034-009,1181,383,0,383,0,0,383
Listas,2014EP,14-034-010,1109,322,0,322,0,0,322
Listas,2014EP,14-034-011,1220,507,0,507,0,2,505
Listas,2014EP,14-034-012,947,325,0,325,0,1,324
Listas,2014EP,14-034-013,1127,469,0,469,0,0,469
Listas,2014EP,14-034-014,931,368,0,368,0,2,366
Listas,2014EP,14-034-015,905,346,0,346,0,1,345
Listas,2014EP,14-034-016,1083,433,0,433,0,4,429
Listas,2014EP,14-034-017,1025,359,0,359,0,0,359
Listas,2014EP,14-034-018,949,305,0,305,0,0,305
Listas,2014EP,14-034-019,1239,419,0,419,0,4,415
Listas,2014EP,14-034-020,942,352,0,352,0,4,348
Listas,2014EP,14-034-021,864,270,0,270,0,2,268
Listas,2014EP,14-034-022,862,233,0,233,0,0,233
Listas,2014EP,14-034-023,1247,261,0,261,0,0,261
Listas,2014EP,14-034-024,1036,239,0,239,0,0,239
Listas,2014EP,14-034-025,1288,326,0,326,0,2,324
Listas,2014EP,14-034-026,1262,347,0,347,0,0,347
Listas,2014EP,14-034-027,1331,316,0,316,0,0,316
Listas,2014EP,14-034-028,1173,332,0,332,0,0,332
Listas,2014EP,14-034-029,1160,342,0,338,-4,0,338
Listas,2014EP,14-034-030,902,296,0,296,0,1,295
Listas,2014EP,14-035-001,967,260,0,260,0,1,259
Listas,2014EP,14-035-002,1015,297,0,297,0,0,297
Listas,2014EP,14-035-003,1021,190,0,190,0,1,189
Listas,2014EP,14-035-004,996,245,0,245,0,0,245
Listas,2014EP,14-035-005,994,239,0,239,0,0,239
Listas,2014EP,14-035-006,1003,222,0,222,0,0,222
Listas,2014EP,14-036-001,1015,340,0,340,0,4,336
Listas,2014EP,14-036-002,1144,339,0,339,0,1,338
Listas,2014EP,14-036-003,844,283,0,283,0,3,280
Listas,2014EP,14-037-001,1059,318,0,318,0,3,315
Listas,2014EP,14-037-002,956,224,0,220,-4,1,219
Listas,2014EP,14-037-003,1030,277,0,277,0,1,276
Listas,2014EP,14-037-004,947,271,0,270,-1,1,269
Listas,2014EP,14-037-005,1006,238,0,238,0,1,237
Listas,2014EP,14-037-006,1055,244,0,244,0,1,243
Listas,2014EP,14-038-001,1118,247,0,247,0,0,247
Listas,2014EP,14-038-002,1048,307,0,306,-1,1,305
Listas,2014EP,14-038-003,942,342,0,342,0,2,340
Listas,2014EP,14-038-004,1057,295,0,294,-1,1,293
Listas,2014EP,14-038-005,1249,504,0,504,0,2,502
Listas,2014EP,14-038-006,1162,391,0,391,0,0,391
Listas,2014EP,14-038-007,1245,387,0,387,0,0,387
Listas,2014EP,14-038-008,1125,293,0,293,0,0,293
Listas,2014EP,14-038-009,951,170,0,170,0,0,170
Listas,2014EP,14-038-010,872,170,0,170,0,1,169
Listas,2014EP,14-038-011,1164,312,0,312,0,1,311
Listas,2014EP,14-038-012,1126,386,0,386,0,4,382
Listas,2014EP,14-038-013,1044,344,0,344,0,1,343
Listas,2014EP,14-038-014,1097,402,0,402,0,13,389
Listas,2014EP,14-038-015,1100,417,0,417,0,2,415
Listas,2014EP,14-038-016,1014,348,0,348,0,1,347
Listas,2014EP,14-038-017,1077,329,0,328,-1,1,327
Listas,2014EP,14-038-018,999,403,0,403,0,0,403
Listas,2014EP,14-038-019,1113,382,0,382,0,1,381
Listas,2014EP,14-038-020,1175,344,0,344,0,3,341
Listas,2014EP,14-038-021,984,255,0,255,0,2,253
Listas,2014EP,14-038-022,997,304,0,304,0,0,304
Listas,2014EP,14-038-023,1023,397,0,397,0,1,396
Listas,2014EP,14-038-024,1069,461,0,461,0,0,461
Listas,2014EP,14-038-025,1079,278,0,278,0,0,278
Listas,2014EP,14-038-026,1126,316,0,316,0,2,314
Listas,2014EP,14-038-027,1171,381,0,381,0,1,380
Listas,2014EP,14-038-028,1091,300,0,300,0,2,298
Listas,2014EP,14-038-029,1118,506,0,506,0,2,504
Listas,2014EP,14-038-030,976,298,0,298,0,3,295
Listas,2014EP,14-038-031,1021,362,0,362,0,0,362
Listas,2014EP,14-038-032,1103,367,0,367,0,1,366
Listas,2014EP,14-038-033,1135,258,0,258,0,1,257
Listas,2014EP,14-038-034,974,206,0,206,0,0,206
Listas,2014EP,14-038-035,1053,282,0,281,-1,1,280
Listas,2014EP,14-038-036,1099,326,0,326,0,0,326
Listas,2014EP,14-038-037,1066,378,0,378,0,1,377
Listas,2014EP,14-038-038,1031,324,0,323,-1,1,322
Listas,2014EP,14-038-039,1056,275,0,275,0,1,274
Listas,2014EP,14-038-040,1075,390,0,390,0,1,389
Listas,2014EP,14-038-041,1166,391,0,391,0,3,388
Listas,2014EP,14-038-042,1038,349,0,348,-1,0,348
Listas,2014EP,14-038-043,1068,333,0,333,0,0,333
Listas,2014EP,14-038-044,991,292,0,292,0,0,292
Listas,2014EP,14-038-045,1054,350,0,350,0,1,349
Listas,2014EP,14-038-046,1036,376,0,376,0,1,375
Listas,2014EP,14-038-047,1063,358,0,358,0,0,358
Listas,2014EP,14-038-048,1050,260,0,260,0,0,260
Listas,2014EP,14-039-001,1185,315,0,315,0,7,308
Listas,2014EP,14-039-002,874,168,0,168,0,1,167
Listas,2014EP,14-039-003,863,137,0,135,-2,0,135
Listas,2014EP,14-040-001,868,186,0,186,0,3,183
Listas,2014EP,14-040-002,855,220,0,220,0,0,220
Listas,2014EP,14-040-003,921,214,0,214,0,0,214
Listas,2014EP,14-041-001,1020,377,0,377,0,0,377
Listas,2014EP,14-041-002,887,312,0,312,0,1,311
Listas,2014EP,14-041-003,966,311,0,311,0,0,311
Listas,2014EP,14-041-004,916,291,0,291,0,0,291
Listas,2014EP,14-041-005,924,271,0,271,0,0,271
Listas,2014EP,14-041-006,925,217,0,217,0,0,217
Listas,2014EP,14-041-007,1031,284,0,284,0,0,284
Listas,2014EP,14-041-008,868,233,0,233,0,0,233
Listas,2014EP,14-041-009,956,208,0,208,0,0,208
Listas,2014EP,14-041-010,968,285,0,285,0,0,285
Listas,2014EP,14-041-011,896,254,0,254,0,0,254
Listas,2014EP,14-041-012,901,178,0,178,0,0,178
Listas,2014EP,14-041-013,1025,311,0,311,0,0,311
Listas,2014EP,14-041-014,970,277,0,277,0,1,276
Listas,2014EP,14-041-015,897,237,0,237,0,0,237
Listas,2014EP,14-041-016,992,272,0,272,0,0,272
Listas,2014EP,14-042-001,803,235,0,235,0,0,235
Listas,2014EP,14-043-001,687,249,0,249,0,1,248
Listas,2014EP,14-043-002,681,196,0,196,0,2,194
Listas,2014EP,14-043-003,701,118,0,118,0,1,117
Listas,2014EP,14-044-001,918,255,0,255,0,0,255
Listas,2014EP,14-044-002,575,139,0,139,0,0,139
Listas,2014EP,14-045-001,1140,282,0,282,0,0,282
Listas,2014EP,14-045-002,1080,228,0,228,0,4,224
Listas,2014EP,14-045-003,89,28,0,28,0,0,28
Listas,2014EP,14-046-001,700,283,0,283,0,0,283
Listas,2014EP,14-046-002,691,297,0,297,0,1,296
Listas,2014EP,14-046-003,859,359,0,359,0,0,359
Listas,2014EP,14-046-004,1036,474,0,474,0,0,474
Listas,2014EP,14-046-005,806,291,0,291,0,0,291
Listas,2014EP,14-046-006,711,321,0,321,0,3,318
Listas,2014EP,14-046-007,922,290,0,290,0,1,289
Listas,2014EP,14-046-008,853,297,0,297,0,0,297
Listas,2014EP,14-046-009,274,65,0,65,0,0,65
Listas,2014EP,14-046-010,753,249,0,249,0,1,248
Listas,2014EP,14-046-011,962,404,0,404,0,1,403
Listas,2014EP,14-046-012,847,367,0,367,0,2,365
Listas,2014EP,14-046-013,977,367,0,367,0,1,366
Listas,2014EP,14-046-014,1018,415,0,415,0,4,411
Listas,2014EP,14-046-015,987,398,0,398,0,0,398
Listas,2014EP,14-046-016,931,330,0,330,0,1,329
Listas,2014EP,14-046-017,951,251,0,251,0,2,249
Listas,2014EP,14-047-001,804,323,0,323,0,1,322
Listas,2014EP,14-047-002,824,183,0,183,0,0,183
Listas,2014EP,14-047-003,1230,404,0,404,0,0,404
Listas,2014EP,14-047-004,810,296,0,296,0,1,295
Listas,2014EP,14-047-005,879,287,0,287,0,0,287
Listas,2014EP,14-047-006,1058,353,0,353,0,0,353
Listas,2014EP,14-047-007,885,259,0,259,0,1,258
Listas,2014EP,14-047-008,794,268,0,268,0,0,268
Listas,2014EP,14-047-009,909,325,0,325,0,1,324
Listas,2014EP,14-047-010,217,100,0,100,0,0,100
Listas,2014EP,14-047-011,1155,409,0,409,0,1,408
Listas,2014EP,14-047-012,1070,442,0,442,0,0,442
Listas,2014EP,14-047-013,926,324,0,324,0,0,324
Listas,2014EP,14-047-014,869,241,0,241,0,1,240
Listas,2014EP,14-047-015,886,278,0,278,0,0,278
Listas,2014EP,14-047-016,1020,402,0,402,0,1,401
Listas,2014EP,14-047-017,1121,500,0,500,0,2,498
Listas,2014EP,14-047-018,855,256,0,256,0,0,256
Listas,2014EP,14-047-019,882,293,0,293,0,1,292
Listas,2014EP,14-047-020,844,277,0,276,-1,1,275
Listas,2014EP,14-047-021,1110,377,0,377,0,4,373
Listas,2014EP,14-047-022,628,256,0,256,0,0,256
Listas,2014EP,14-047-023,669,271,0,271,0,3,268
Listas,2014EP,14-047-024,1093,496,0,496,0,1,495
Listas,2014EP,14-047-025,829,316,0,315,-1,0,315
Listas,2014EP,14-047-026,842,349,0,349,0,2,347
Listas,2014EP,14-047-027,944,297,0,296,-1,2,294
Listas,2014EP,14-047-028,1083,401,0,401,0,1,400
Listas,2014EP,14-048-001,1091,381,0,381,0,2,379
Listas,2014EP,14-048-002,1143,371,0,371,0,4,367
Listas,2014EP,14-048-003,1167,252,0,252,0,1,251
Listas,2014EP,14-048-004,1190,270,0,270,0,0,270
Listas,2014EP,14-048-005,1153,244,0,244,0,1,243
Listas,2014EP,14-048-006,1090,228,0,228,0,2,226
Listas,2014EP,14-048-007,1079,258,0,257,-1,0,257
Listas,2014EP,14-048-008,944,224,0,224,0,1,223
Listas,2014EP,14-048-009,1223,206,0,206,0,1,205
Listas,2014EP,14-048-010,1090,216,0,216,0,1,215
Listas,2014EP,14-048-011,916,266,0,266,0,1,265
Listas,2014EP,14-048-012,913,217,0,217,0,2,215
Listas,2014EP,14-048-013,845,202,0,202,0,0,202
Listas,2014EP,14-048-014,943,190,0,190,0,0,190
Listas,2014EP,14-048-015,958,212,0,212,0,1,211
Listas,2014EP,14-048-016,773,148,0,148,0,0,148
Listas,2014EP,14-048-017,1189,293,0,293,0,0,293
Listas,2014EP,14-048-018,917,256,0,256,0,0,256
Listas,2014EP,14-049-001,854,165,0,165,0,1,164
Listas,2014EP,14-049-002,894,247,0,246,-1,4,242
Listas,2014EP,14-049-003,892,342,0,342,0,3,339
Listas,2014EP,14-049-004,859,238,0,238,0,1,237
Listas,2014EP,14-049-005,818,237,0,236,-1,2,234
Listas,2014EP,14-049-006,693,177,0,177,0,0,177
Listas,2014EP,14-049-007,847,229,0,229,0,0,229
Listas,2014EP,14-049-008,805,164,1,163,-1,1,162
Listas,2014EP,14-049-009,784,150,0,150,0,2,148
Listas,2014EP,14-049-010,829,282,0,282,0,2,280
Listas,2014EP,14-049-011,781,240,0,240,0,0,240
Listas,2014EP,14-049-012,847,273,0,273,0,1,272
Listas,2014EP,14-049-013,769,206,0,206,0,1,205
Listas,2014EP,14-049-014,796,162,0,162,0,0,162
Listas,2014EP,14-049-015,847,238,0,238,0,0,238
Listas,2014EP,14-049-016,847,193,1,193,0,1,192
Listas,2014EP,14-050-001,768,273,0,273,0,0,273
Listas,2014EP,14-050-002,778,190,0,190,0,0,190
Listas,2014EP,14-050-003,948,254,0,254,0,1,253
Listas,2014EP,14-050-004,870,211,0,211,0,0,211
Listas,2014EP,14-050-005,894,258,0,258,0,2,256
Listas,2014EP,14-050-006,919,233,0,233,0,0,233
Listas,2014EP,14-050-007,1010,306,0,306,0,0,306
Listas,2014EP,14-050-008,1264,345,1,345,0,0,345
Listas,2014EP,14-051-001,779,267,0,267,0,0,267
Listas,2014EP,14-051-002,839,305,0,305,0,2,303
Listas,2014EP,14-052-001,986,161,0,161,0,2,159
Listas,2014EP,14-052-002,1191,204,0,204,0,2,202
Listas,2014EP,14-052-003,1079,226,0,226,0,3,223
Listas,2014EP,14-053-001,938,247,0,247,0,1,246
Listas,2014EP,14-053-002,778,208,0,208,0,0,208
Listas,2014EP,14-053-003,791,266,0,266,0,2,264
Listas,2014EP,14-054-001,915,268,0,268,0,2,266
Listas,2014EP,14-054-002,808,191,0,191,0,1,190
Listas,2014EP,14-055-001,1017,257,1,257,0,1,256
Listas,2014EP,14-055-002,803,200,0,200,0,0,200
Listas,2014EP,14-055-003,974,246,0,246,0,1,245
Listas,2014EP,14-055-004,834,210,0,210,0,0,210
Listas,2014EP,14-056-001,298,109,0,109,0,0,109
Listas,2014EP,14-057-001,231,59,0,59,0,0,59
Listas,2014EP,14-058-001,1235,355,0,354,-1,4,350
Listas,2014EP,14-058-002,1180,285,0,285,0,0,285
Listas,2014EP,14-058-003,1130,278,0,278,0,0,278
Listas,2014EP,14-058-004,1274,240,0,240,0,0,240
Listas,2014EP,14-058-005,1033,307,0,307,0,0,307
Listas,2014EP,14-058-006,1032,350,0,350,0,1,349
Listas,2014EP,14-058-007,1051,240,0,240,0,2,238
Listas,2014EP,14-058-008,1000,205,0,205,0,0,205
Listas,2014EP,14-059-001,786,109,0,109,0,1,108
Listas,2014EP,14-059-002,699,128,0,128,0,0,128
Listas,2014EP,14-059-003,682,156,0,156,0,0,156
Listas,2014EP,14-060-001,781,236,0,236,0,3,233
Listas,2014EP,14-060-002,644,172,0,172,0,0,172
Listas,2014EP,14-060-003,815,206,0,206,0,0,206
Listas,2014EP,14-061-001,834,203,0,203,0,0,203
Listas,2014EP,14-061-002,787,178,0,178,0,2,176
Listas,2014EP,14-061-003,816,159,0,159,0,0,159
Listas,2014EP,14-061-004,767,154,0,154,0,0,154
Listas,2014EP,14-061-005,745,184,0,184,0,3,181
Listas,2014EP,14-061-006,788,169,0,169,0,1,168
Listas,2014EP,14-062-001,529,154,0,154,0,0,154
Listas,2014EP,14-063-001,838,257,0,257,0,3,254
Listas,2014EP,14-064-001,1030,271,0,271,0,0,271
Listas,2014EP,14-064-002,1012,323,0,323,0,4,319
Listas,2014EP,14-064-003,1067,351,0,351,0,2,349
Listas,2014EP,14-064-004,1104,281,0,281,0,1,280
Listas,2014EP,14-064-005,994,294,0,294,0,1,293
Listas,2014EP,14-064-006,968,348,0,348,0,1,347
Listas,2014EP,14-064-007,974,303,0,303,0,0,303
Listas,2014EP,14-064-008,915,295,0,295,0,1,294
Listas,2014EP,14-065-001,744,173,0,173,0,0,173
Listas,2014EP,14-065-002,1288,317,0,317,0,2,315
Listas,2014EP,14-065-003,1134,207,0,207,0,2,205
Listas,2014EP,14-065-004,1056,257,0,257,0,0,257
Listas,2014EP,14-065-005,1054,215,0,215,0,1,214
Listas,2014EP,14-065-006,1085,264,0,264,0,2,262
Listas,2014EP,14-065-007,758,195,0,195,0,0,195
Listas,2014EP,14-066-001,884,379,0,379,0,1,378
Listas,2014EP,14-066-002,930,402,0,402,0,0,402
Listas,2014EP,14-067-001,552,161,0,161,0,0,161
Listas,2014EP,14-068-001,811,355,0,355,0,0,355
Listas,2014EP,14-069-001,1200,391,0,391,0,2,389
Listas,2014EP,14-069-002,1237,380,0,380,0,2,378
Listas,2014EP,14-069-003,1255,400,0,400,0,0,400
Listas,2014EP,14-069-004,1242,324,0,324,0,1,323
Listas,2014EP,14-069-005,1201,439,0,439,0,2,437
Listas,2014EP,14-069-006,1187,385,0,385,0,0,385
Listas,2014EP,14-069-007,1081,343,0,343,0,2,341
Listas,2014EP,14-069-008,1179,294,0,294,0,3,291
Listas,2014EP,14-070-001,674,180,0,180,0,0,180
Listas,2014EP,14-070-002,806,199,0,199,0,0,199
Listas,2014EP,14-071-001,1149,361,0,361,0,2,359
Listas,2014EP,14-071-002,849,233,0,233,0,2,231
Listas,2014EP,14-072-001,638,175,0,175,0,0,175
Listas,2014EP,14-072-002,708,170,0,170,0,1,169
Listas,2014EP,14-072-003,1100,197,0,197,0,0,197
Listas,2014EP,14-072-004,1030,149,0,149,0,1,148
Listas,2014EP,14-073-001,607,185,0,185,0,2,183
Listas,2014EP,14-074-001,708,198,0,198,0,2,196
Listas,2014EP,14-075-001,969,436,0,436,0,3,433
Listas,2014EP,14-075-002,984,330,0,330,0,1,329
Listas,2014EP,14-075-003,904,388,1,387,-1,1,386
Listas,2014EP,14-076-001,914,278,0,278,0,2,276
Listas,2014EP,14-077-001,260,53,0,53,0,0,53
Listas,2014EP,14-078-001,1128,357,0,357,0,2,355
Listas,2014EP,14-078-002,1207,373,0,373,0,1,372
Listas,2014EP,14-078-003,1327,321,0,321,0,2,319
Listas,2014EP,14-078-004,1159,293,0,293,0,0,293
Listas,2014EP,14-078-005,1216,297,0,297,0,1,296
Listas,2014EP,14-078-006,1094,312,0,312,0,1,311
Listas,2014EP,14-078-007,1109,298,0,298,0,0,298
Listas,2014EP,14-078-008,1242,354,0,354,0,1,353
Listas,2014EP,14-079-001,1261,409,0,409,0,1,408
Listas,2014EP,14-080-001,1018,232,0,232,0,3,229
Listas,2014EP,14-081-001,676,178,0,178,0,2,176
Listas,2014EP,14-082-001,791,207,0,207,0,2,205
Listas,2014EP,14-082-002,807,238,0,238,0,1,237
Listas,2014EP,14-082-003,845,154,0,154,0,0,154
Listas,2014EP,14-082-004,963,227,0,227,0,0,227
Listas,2014EP,14-083-001,590,121,0,121,0,1,120
Listas,2014EP,14-084-001,995,389,0,389,0,0,389
Listas,2014EP,14-084-002,1028,356,0,356,0,1,355
Listas,2014EP,14-084-003,1029,356,0,356,0,4,352
Listas,2014EP,14-084-004,973,280,0,280,0,1,279
Listas,2014EP,14-084-005,977,284,0,284,0,0,284
Listas,2014EP,14-085-001,821,262,0,262,0,1,261
Listas,2014EP,14-085-002,910,144,0,144,0,0,144
Listas,2014EP,14-085-003,881,257,0,257,0,0,257
Listas,2014EP,14-085-004,967,261,0,261,0,0,261
Listas,2014EP,14-085-005,828,250,0,250,0,0,250
Listas,2014EP,14-085-006,915,234,0,234,0,0,234
Listas,2014EP,14-085-007,984,228,0,228,0,1,227
Listas,2014EP,14-085-008,820,195,0,195,0,0,195
Listas,2014EP,14-085-009,873,244,0,244,0,0,244
Listas,2014EP,14-085-010,910,292,0,292,0,0,292
Listas,2014EP,14-085-011,964,377,0,377,0,2,375
Listas,2014EP,14-085-012,890,322,0,322,0,1,321
Listas,2014EP,14-085-013,1029,312,0,312,0,1,311
Listas,2014EP,14-085-014,860,298,0,298,0,0,298
Listas,2014EP,14-085-015,858,242,0,242,0,0,242
Listas,2014EP,14-085-016,971,200,0,200,0,2,198
Listas,2014EP,14-086-001,549,217,0,217,0,0,217
Listas,2014EP,14-087-001,651,206,0,206,0,3,203
Listas,2014EP,14-087-002,815,157,0,157,0,0,157
Listas,2014EP,14-087-003,719,178,0,178,0,1,177
Listas,2014EP,14-087-004,1095,363,1,362,-1,0,362
Listas,2014EP,14-087-005,1180,270,0,270,0,0,270
Listas,2014EP,14-087-006,1175,316,0,316,0,2,314
Listas,2014EP,14-087-007,665,116,0,116,0,1,115
Listas,2014EP,14-087-008,1123,187,0,187,0,0,187
Listas,2014EP,14-087-009,726,164,0,164,0,0,164
Listas,2014EP,14-087-010,662,161,0,161,0,0,161
Listas,2014EP,14-087-011,655,157,0,157,0,1,156
Listas,2014EP,14-087-012,640,176,0,176,0,1,175
Listas,2014EP,14-088-001,799,344,0,342,-2,3,339
Listas,2014EP,14-088-002,915,359,0,359,0,1,358
Listas,2014EP,14-088-003,817,378,0,378,0,1,377
Listas,2014EP,14-088-004,854,398,0,398,0,0,398
Listas,2014EP,14-088-005,1043,481,0,481,0,2,479
Listas,2014EP,14-088-006,1003,408,0,408,0,0,408
Listas,2014EP,14-089-001,1172,217,0,217,0,1,216
Listas,2014EP,14-089-002,1136,305,0,305,0,0,305
Listas,2014EP,14-089-003,1170,294,0,294,0,2,292
Listas,2014EP,14-089-004,1119,289,0,289,0,1,288
Listas,2014EP,14-089-005,1148,233,0,233,0,1,232
Listas,2014EP,14-089-006,1119,291,0,291,0,0,291
Listas,2014EP,14-089-007,916,176,0,176,0,0,176
Listas,2014EP,14-089-008,749,175,0,175,0,0,175
Listas,2014EP,14-089-009,771,221,0,221,0,1,220
Listas,2014EP,14-089-010,842,253,1,253,0,2,251
Listas,2014EP,14-089-011,774,204,0,203,-1,1,202
Listas,2014EP,14-089-012,793,246,0,246,0,0,246
Listas,2014EP,14-089-013,1131,165,0,165,0,0,165
Listas,2014EP,14-089-014,1092,180,0,180,0,2,178
Listas,2014EP,14-089-015,769,215,0,215,0,1,214
Listas,2014EP,14-089-016,787,105,0,105,0,1,104
Listas,2014EP,14-089-017,1032,180,0,180,0,0,180
Listas,2014EP,14-089-018,905,170,0,170,0,1,169
Listas,2014EP,14-089-019,920,291,0,291,0,1,290
Listas,2014EP,14-089-020,917,174,0,174,0,0,174
Listas,2014EP,14-090-001,978,289,0,289,0,1,288
Listas,2014EP,14-090-002,1035,370,0,370,0,0,370
Listas,2014EP,14-090-003,950,469,0,469,0,0,469
Listas,2014EP,14-090-004,974,391,0,390,-1,1,389
Listas,2014EP,14-091-001,771,174,0,174,0,0,174
Listas,2014EP,14-091-002,744,244,0,244,0,0,244
Listas,2014EP,14-091-003,713,268,0,268,0,1,267
Listas,2014EP,14-091-004,755,268,0,268,0,1,267
Listas,2014EP,14-092-001,1033,202,0,202,0,2,200
Listas,2014EP,14-092-002,1014,246,0,245,-1,3,242
Listas,2014EP,14-092-003,941,195,0,195,0,3,192
Listas,2014EP,14-093-001,797,100,0,100,0,1,99
Listas,2014EP,14-093-002,765,132,0,132,0,1,131
Listas,2014EP,14-094-001,881,169,0,169,0,0,169
Listas,2014EP,14-094-002,950,265,0,265,0,0,265
Listas,2014EP,14-094-003,797,226,0,226,0,1,225
Listas,2014EP,14-094-004,1001,226,0,226,0,0,226
Listas,2014EP,14-094-005,740,191,0,191,0,0,191
Listas,2014EP,14-094-006,935,246,0,246,0,1,245
Listas,2014EP,14-094-007,687,197,0,197,0,1,196
Listas,2014EP,14-094-008,152,35,0,35,0,0,35
Listas,2014EP,14-094-009,321,22,0,22,0,0,22
Listas,2014EP,14-094-010,945,236,0,236,0,0,236
Listas,2014EP,14-095-001,671,135,0,135,0,0,135
Listas,2014EP,14-095-002,1036,127,0,127,0,0,127
Listas,2014EP,14-095-003,953,225,0,225,0,0,225
Listas,2014EP,14-095-004,1030,227,0,227,0,2,225
Listas,2014EP,14-096-001,771,174,0,174,0,1,173
Listas,2014EP,14-096-002,886,223,0,223,0,0,223
Listas,2014EP,14-096-003,803,243,0,243,0,1,242
Listas,2014EP,14-096-004,806,215,0,215,0,0,215
Listas,2014EP,14-096-005,746,223,0,223,0,1,222
Listas,2014EP,14-096-006,734,185,0,185,0,0,185
Listas,2014EP,14-096-007,822,242,0,242,0,1,241
Listas,2014EP,14-097-001,700,140,0,140,0,0,140
Listas,2014EP,14-097-002,777,116,0,116,0,0,116
Listas,2014EP,14-098-001,941,263,1,262,-1,0,262
Listas,2014EP,14-098-002,1110,457,0,457,0,0,457
Listas,2014EP,14-098-003,1139,422,0,422,0,2,420
Listas,2014EP,14-098-004,1205,332,0,332,0,2,330
Listas,2014EP,14-098-005,1099,456,0,456,0,1,455
Listas,2014EP,14-099-001,1210,298,0,298,0,0,298
Listas,2014EP,14-100-001,871,289,0,289,0,1,288
Listas,2014EP,14-100-002,784,241,0,241,0,2,239
Listas,2014EP,14-101-001,278,135,0,135,0,0,135
Listas,2014EP,14-102-001,811,215,0,215,0,2,213
Listas,2014EP,14-102-002,743,232,0,232,0,1,231
Listas,2014EP,14-102-003,1419,448,0,445,-3,0,445
Listas,2014EP,14-102-004,1346,418,0,418,0,1,417
Listas,2014EP,14-102-005,853,285,0,285,0,0,285
Listas,2014EP,14-102-006,691,266,0,266,0,0,266
Listas,2014EP,14-102-007,941,278,0,278,0,4,274
Listas,2014EP,14-102-008,878,270,0,270,0,0,270
Listas,2014EP,14-102-009,644,150,0,150,0,1,149
Listas,2014EP,14-102-010,891,237,0,237,0,0,237
Listas,2014EP,14-102-011,1461,441,0,441,0,2,439
Listas,2014EP,14-102-012,1473,388,0,388,0,0,388
Listas,2014EP,14-103-001,991,263,0,263,0,0,263
Listas,2014EP,14-103-002,742,177,0,177,0,2,175
Listas,2014EP,14-104-001,1120,160,0,160,0,0,160
Listas,2014EP,14-104-002,1147,234,0,234,0,0,234
Listas,2014EP,14-104-003,1048,253,0,253,0,3,250
Listas,2014EP,14-104-004,1189,335,0,335,0,0,335
Listas,2014EP,14-104-005,1109,284,0,284,0,0,284
Listas,2014EP,14-104-006,1125,182,0,182,0,1,181
Listas,2014EP,14-104-007,1146,184,0,184,0,0,184
Listas,2014EP,14-104-008,647,120,0,120,0,1,119
Listas,2014EP,14-104-009,664,104,0,104,0,0,104
Listas,2014EP,14-105-001,1075,441,0,441,0,0,441
Listas,2014EP,14-105-002,1292,532,0,532,0,2,530
Listas,2014EP,14-105-003,436,146,0,146,0,0,146
Listas,2014EP,14-106-001,902,281,0,281,0,0,281
Listas,2014EP,14-106-002,1041,192,0,192,0,1,191
Listas,2014EP,14-106-003,1097,515,0,515,0,5,510
Listas,2014EP,14-106-004,769,372,0,372,0,1,371
Listas,2014EP,14-106-005,1449,560,0,560,0,1,559
Listas,2014EP,14-106-006,665,293,0,293,0,0,293
Listas,2014EP,14-107-001,1241,338,0,338,0,0,338
Listas,2014EP,14-108-001,904,271,0,271,0,0,271
Listas,2014EP,14-108-002,1124,338,0,338,0,1,337
Listas,2014EP,14-109-001,1200,440,0,440,0,2,438
Listas,2014EP,14-109-002,1187,476,0,476,0,0,476
Listas,2014EP,14-109-003,1075,386,0,384,-2,4,380
Listas,2014EP,14-110-001,926,332,0,332,0,0,332
Listas,2014EP,14-110-002,818,263,0,263,0,0,263
Listas,2014EP,14-111-001,907,280,0,280,0,1,279
Listas,2014EP,14-112-001,1468,518,0,518,0,0,518
Listas,2014EP,14-112-002,1438,334,0,334,0,0,334
Listas,2014EP,14-112-003,1372,488,0,488,0,1,487
Listas,2014EP,14-112-004,1329,478,0,478,0,1,477
Listas,2014EP,14-112-005,1367,370,0,370,0,0,370
Listas,2014EP,14-112-006,1419,457,0,457,0,0,457
Listas,2014EP,14-112-007,1461,531,0,531,0,3,528
Listas,2014EP,14-112-008,1389,337,0,337,0,1,336
Listas,2014EP,14-113-001,772,258,0,258,0,1,257
Listas,2014EP,14-113-002,822,297,0,297,0,3,294
Listas,2014EP,14-113-003,855,240,0,240,0,1,239
Listas,2014EP,14-113-004,777,155,0,155,0,0,155
Listas,2014EP,14-113-005,798,295,0,295,0,0,295
Listas,2014EP,14-113-006,831,297,0,297,0,0,297
Listas,2014EP,14-113-007,872,315,0,315,0,2,313
Listas,2014EP,14-113-008,1050,413,0,413,0,3,410
Listas,2014EP,14-113-009,886,317,0,317,0,1,316
Listas,2014EP,14-113-010,796,312,0,312,0,0,312
Listas,2014EP,14-113-011,773,312,0,312,0,1,311
Listas,2014EP,14-113-012,744,264,0,264,0,0,264
Listas,2014EP,14-113-013,829,287,0,287,0,1,286
Listas,2014EP,14-113-014,848,315,0,315,0,1,314
Listas,2014EP,14-113-015,872,319,0,319,0,0,319
Listas,2014EP,14-113-016,873,336,0,335,-1,0,335
Listas,2014EP,14-114-001,931,289,0,289,0,2,287
Listas,2014EP,14-114-002,799,319,0,319,0,0,319
Listas,2014EP,14-115-001,1132,205,0,205,0,0,205
Listas,2014EP,14-116-001,906,232,0,231,-1,1,230
Listas,2014EP,14-117-001,1142,327,1,326,-1,1,325
Listas,2014EP,14-118-001,589,186,0,186,0,1,185
Listas,2014EP,14-119-001,1064,455,0,455,0,3,452
Listas,2014EP,14-119-002,1006,215,0,215,0,0,215
Listas,2014EP,14-119-003,998,298,1,297,-1,1,296
Listas,2014EP,14-119-004,992,270,0,270,0,0,270
Listas,2014EP,14-119-005,967,210,0,210,0,1,209
Listas,2014EP,14-119-006,969,124,0,124,0,0,124
Listas,2014EP,14-119-007,1006,350,0,350,0,1,349
Listas,2014EP,14-119-008,934,269,0,269,0,0,269
Listas,2014EP,14-120-001,1462,416,0,416,0,0,416
Listas,2014EP,14-121-001,991,428,0,428,0,2,426
Listas,2014EP,14-121-002,995,428,0,428,0,2,426
Listas,2014EP,14-121-003,987,494,0,494,0,0,494
Listas,2014EP,14-121-004,1121,571,0,570,-1,1,569
Listas,2014EP,14-121-005,1121,467,0,467,0,2,465
Listas,2014EP,14-121-006,1001,457,0,457,0,5,452
Listas,2014EP,14-121-007,1003,438,0,438,0,0,438
Listas,2014EP,14-121-008,1008,376,0,376,0,1,375
Listas,2014EP,14-122-001,960,275,0,275,0,3,272
Listas,2014EP,14-122-002,816,243,0,243,0,1,242
Listas,2014EP,14-122-003,807,230,0,230,0,1,229
Listas,2014EP,14-123-001,810,181,0,181,0,0,181
Listas,2014EP,14-123-002,946,272,0,272,0,2,270
Listas,2014EP,14-123-003,945,232,0,232,0,0,232
Listas,2014EP,14-123-004,1011,305,0,305,0,1,304
Listas,2014EP,14-123-005,821,238,0,238,0,0,238
Listas,2014EP,14-123-006,892,236,0,236,0,1,235
Listas,2014EP,14-123-007,1026,207,0,207,0,2,205
Listas,2014EP,14-124-001,1228,384,0,384,0,1,383
Listas,2014EP,14-124-002,1185,372,0,372,0,1,371
Listas,2014EP,14-124-003,1226,393,0,393,0,0,393
Listas,2014EP,14-125-001,856,229,0,229,0,0,229
Listas,2014EP,14-125-002,902,231,0,231,0,1,230
Listas,2014EP,14-125-003,857,222,0,222,0,0,222
Listas,2014EP,14-125-004,923,241,0,241,0,0,241
Listas,2014EP,14-125-005,970,248,0,248,0,0,248
Listas,2014EP,14-125-006,850,268,0,268,0,1,267
Listas,2014EP,14-125-007,966,280,0,280,0,1,279
Listas,2014EP,14-125-008,1040,389,0,389,0,4,385
Listas,2014EP,14-125-009,912,248,0,248,0,0,248
Listas,2014EP,14-125-010,940,317,0,317,0,0,317
Listas,2014EP,14-125-011,928,314,0,314,0,0,314
Listas,2014EP,14-125-012,965,351,0,351,0,1,350
Listas,2014EP,14-125-013,871,306,0,305,-1,0,305
Listas,2014EP,14-125-014,884,328,0,328,0,1,327
Listas,2014EP,14-125-015,1217,320,0,320,0,0,320
Listas,2014EP,14-125-016,1060,357,0,357,0,0,357
Listas,2014EP,14-126-001,988,494,0,494,0,0,494
Listas,2014EP,14-126-002,1291,595,0,595,0,3,592
Listas,2014EP,14-126-003,1024,316,0,316,0,0,316
Listas,2014EP,14-126-004,992,347,0,347,0,1,346
Listas,2014EP,14-126-005,1013,445,0,445,0,1,444
Listas,2014EP,14-126-006,1008,425,0,425,0,0,425
Listas,2014EP,14-126-007,1058,384,0,384,0,0,384
Listas,2014EP,14-126-008,1117,357,0,357,0,0,357
Listas,2014EP,14-126-009,976,366,0,366,0,0,366
Listas,2014EP,14-126-010,1144,416,0,416,0,1,415
Listas,2014EP,14-126-011,1020,477,0,477,0,1,476
Listas,2014EP,14-126-012,1016,443,0,443,0,3,440
Listas,2014EP,14-126-013,967,435,0,435,0,0,435
Listas,2014EP,14-126-014,1001,419,0,418,-1,2,416
Listas,2014EP,14-126-015,1004,379,0,379,0,1,378
Listas,2014EP,14-126-016,980,294,0,294,0,3,291
Listas,2014EP,14-126-017,976,384,0,384,0,1,383
Listas,2014EP,14-126-018,1098,408,0,408,0,0,408
Listas,2014EP,14-126-019,983,352,0,352,0,1,351
Listas,2014EP,14-126-020,980,365,0,365,0,1,364
Listas,2014EP,14-127-001,794,149,0,149,0,0,149
Listas,2014EP,14-127-002,742,151,0,151,0,2,149
Listas,2014EP,14-128-001,956,191,0,191,0,4,187
Listas,2014EP,14-128-002,942,232,0,232,0,3,229
Listas,2014EP,14-128-003,1084,161,0,161,0,0,161
Listas,2014EP,14-128-004,978,222,0,222,0,2,220
Listas,2014EP,14-129-001,1107,347,0,347,0,1,346
Listas,2014EP,14-130-001,992,274,0,274,0,2,272
Listas,2014EP,14-130-002,980,269,1,268,-1,1,267
Listas,2014EP,14-131-001,794,181,0,181,0,0,181
Listas,2014EP,14-131-002,814,157,0,157,0,0,157
Listas,2014EP,14-131-003,887,240,0,240,0,0,240
Listas,2014EP,14-131-004,983,297,0,297,0,3,294
Listas,2014EP,14-131-005,831,174,0,174,0,0,174
Listas,2014EP,14-131-006,922,164,0,164,0,0,164
Listas,2014EP,14-131-007,750,149,0,149,0,0,149
Listas,2014EP,14-131-008,758,145,0,145,0,2,143
Listas,2014EP,14-131-009,888,225,0,225,0,0,225
Listas,2014EP,14-131-010,873,271,0,271,0,1,270
Listas,2014EP,14-131-011,775,187,0,187,0,1,186
Listas,2014EP,14-131-012,826,219,0,219,0,1,218
Listas,2014EP,14-131-013,837,165,0,165,0,0,165
Listas,2014EP,14-131-014,940,242,0,242,0,0,242
Listas,2014EP,14-131-015,896,179,0,179,0,0,179
Listas,2014EP,14-131-016,920,209,0,209,0,0,209
Listas,2014EP,14-132-001,1030,376,0,376,0,1,375
Listas,2014EP,14-132-002,1007,360,0,360,0,3,357
Listas,2014EP,14-133-001,900,262,0,262,0,0,262
Listas,2014EP,14-133-002,948,286,1,286,0,2,284
Listas,2014EP,14-134-001,781,218,0,218,0,1,217
Listas,2014EP,14-134-002,940,228,0,228,0,1,227
Listas,2014EP,14-134-003,1003,210,0,210,0,1,209
Listas,2014EP,14-134-004,1033,148,0,148,0,0,148
Listas,2014EP,14-134-005,954,260,0,260,0,0,260
Listas,2014EP,14-134-006,895,261,1,260,-1,0,260
Listas,2014EP,14-134-007,914,227,0,227,0,1,226
Listas,2014EP,14-134-008,964,353,0,353,0,0,353
Listas,2014EP,14-134-009,1003,203,0,203,0,0,203
Listas,2014EP,14-134-010,1097,258,0,258,0,0,258
Listas,2014EP,14-134-011,709,225,0,225,0,0,225
Listas,2014EP,14-134-012,798,218,0,218,0,0,218
Listas,2014EP,14-134-013,677,199,0,199,0,2,197
Listas,2014EP,14-134-014,668,232,0,232,0,1,231
Listas,2014EP,14-134-015,1172,327,0,327,0,1,326
Listas,2014EP,14-134-016,751,284,0,284,0,1,283
Listas,2014EP,14-134-017,614,194,0,194,0,1,193
Listas,2014EP,14-134-018,630,223,0,223,0,1,222
Listas,2014EP,14-134-019,920,280,0,280,0,0,280
Listas,2014EP,14-134-020,871,237,0,237,0,1,236
Listas,2014EP,14-134-021,948,268,0,268,0,0,268
Listas,2014EP,14-134-022,809,224,0,224,0,1,223
Listas,2014EP,14-134-023,745,212,0,212,0,1,211
Listas,2014EP,14-134-024,774,285,0,285,0,0,285
Listas,2014EP,14-134-025,916,267,0,267,0,2,265
Listas,2014EP,14-134-026,1235,187,0,187,0,0,187
Listas,2014EP,14-134-027,1257,231,0,231,0,0,231
Listas,2014EP,14-134-028,1027,335,0,334,-1,0,334
Listas,2014EP,14-134-029,1210,300,0,300,0,0,300
Listas,2014EP,14-134-030,1167,302,0,302,0,2,300
Listas,2014EP,14-135-001,1013,270,0,270,0,1,269
Listas,2014EP,14-135-002,757,201,0,201,0,1,200
Listas,2014EP,14-136-001,678,191,0,191,0,1,190
Listas,2014EP,14-136-002,706,187,0,187,0,1,186
Listas,2014EP,14-136-003,870,294,0,294,0,1,293
Listas,2014EP,14-137-001,632,148,0,148,0,0,148
Listas,2014EP,14-137-002,819,182,0,182,0,0,182
Listas,2014EP,14-138-001,980,257,0,257,0,0,257
Listas,2014EP,14-138-002,988,295,0,295,0,1,294
Listas,2014EP,14-138-003,858,200,0,200,0,0,200
Listas,2014EP,14-139-001,1031,416,0,416,0,0,416
Listas,2014EP,14-139-002,1010,331,0,331,0,0,331
Listas,2014EP,14-139-003,804,259,0,259,0,0,259
Listas,2014EP,14-139-004,757,292,0,292,0,2,290
Listas,2014EP,14-140-001,978,337,0,337,0,2,335
Listas,2014EP,14-140-002,1144,320,0,320,0,2,318
Listas,2014EP,14-140-003,1287,464,0,463,-1,1,462
Listas,2014EP,14-140-004,1200,401,0,401,0,0,401
Listas,2014EP,14-141-001,722,192,0,192,0,0,192
Listas,2014EP,14-141-002,937,254,0,254,0,0,254
Listas,2014EP,14-141-003,690,202,0,202,0,0,202
Listas,2014EP,14-141-004,947,193,0,193,0,1,192
Listas,2014EP,14-141-005,892,258,0,258,0,1,257
Listas,2014EP,14-141-006,848,226,0,226,0,0,226
Listas,2014EP,14-142-001,770,189,0,189,0,1,188
Listas,2014EP,14-142-002,663,141,0,141,0,1,140
Listas,2014EP,14-143-001,1008,209,0,209,0,2,207
Listas,2014EP,14-143-002,855,152,0,152,0,0,152
Listas,2014EP,14-143-003,806,115,0,115,0,1,114
Listas,2014EP,14-144-001,940,239,0,239,0,5,234
Listas,2014EP,14-144-002,953,197,0,197,0,0,197
Listas,2014EP,14-144-003,941,148,0,148,0,0,148
Listas,2014EP,14-145-001,603,115,0,115,0,1,114
Listas,2014EP,14-145-002,809,155,0,155,0,2,153
Listas,2014EP,14-145-003,628,147,0,147,0,2,145
Listas,2014EP,14-145-004,679,120,0,120,0,1,119
Listas,2014EP,14-146-001,521,99,0,99,0,1,98
Listas,2014EP,14-146-002,850,245,0,245,0,1,244
Listas,2014EP,14-146-003,799,189,0,189,0,2,187
Listas,2014EP,14-147-001,776,148,0,148,0,0,148
Listas,2014EP,14-147-002,797,136,0,136,0,3,133
Listas,2014EP,14-147-003,677,131,0,131,0,0,131
Listas,2014EP,14-147-004,1152,260,0,260,0,0,260
Listas,2014EP,14-147-005,992,329,0,329,0,1,328
Listas,2014EP,14-147-006,704,161,0,161,0,1,160
Listas,2014EP,14-148-001,834,154,0,154,0,0,154
Listas,2014EP,14-148-002,846,88,0,88,0,0,88
Listas,2014EP,14-148-003,724,146,0,146,0,0,146
Listas,2014EP,14-148-004,821,88,0,88,0,0,88
Listas,2014EP,14-148-005,844,151,0,151,0,1,150
Listas,2014EP,14-148-006,765,138,0,138,0,2,136
Listas,2014EP,14-149-001,992,251,0,251,0,1,250
Listas,2014EP,14-149-002,900,302,0,302,0,0,302
Listas,2014EP,14-149-003,993,261,0,261,0,0,261
Listas,2014EP,14-149-004,1165,180,0,180,0,1,179
Listas,2014EP,14-149-005,367,88,0,88,0,1,87
Listas,2014EP,14-150-001,481,85,0,85,0,1,84
Listas,2014EP,14-150-002,574,119,0,119,0,2,117
Listas,2014EP,14-150-003,826,174,0,174,0,0,174
Listas,2014EP,14-150-004,562,115,0,115,0,0,115
Listas,2014EP,14-151-001,1027,230,0,230,0,2,228
Listas,2014EP,14-151-002,836,269,0,269,0,0,269
Listas,2014EP,14-151-003,1131,382,0,382,0,1,381
Listas,2014EP,14-151-004,1167,238,0,238,0,3,235
Listas,2014EP,14-151-005,1036,282,0,282,0,0,282
Listas,2014EP,14-151-006,1061,338,0,338,0,1,337
Listas,2014EP,14-151-007,1020,310,0,310,0,0,310
Listas,2014EP,14-152-001,736,410,0,410,0,1,409
Listas,2014EP,14-152-002,647,264,0,264,0,0,264
Listas,2014EP,14-152-003,634,307,0,307,0,1,306
Listas,2014EP,14-152-004,631,329,0,329,0,1,328
Listas,2014EP,14-153-001,81,41,0,41,0,0,41
Listas,2014EP,14-154-001,1275,304,0,304,0,0,304
Listas,2014EP,14-155-001,821,170,0,170,0,1,169
Listas,2014EP,14-155-002,960,189,0,189,0,1,188
Listas,2014EP,14-155-003,932,166,0,166,0,1,165
Listas,2014EP,14-156-001,1080,337,0,337,0,2,335
Listas,2014EP,14-157-001,855,146,0,146,0,1,145
Listas,2014EP,14-157-002,840,228,0,228,0,0,228
Listas,2014EP,14-157-003,1109,307,0,307,0,1,306
Listas,2014EP,14-157-004,1147,299,0,299,0,1,298
Listas,2014EP,14-157-005,1023,228,0,228,0,0,228
Listas,2014EP,14-157-006,900,235,0,235,0,1,234
Listas,2014EP,14-157-007,1176,227,0,227,0,0,227
Listas,2014EP,14-157-008,1090,262,0,262,0,0,262
Listas,2014EP,14-158-001,598,206,0,206,0,0,206
Listas,2014EP,14-158-002,622,209,1,208,-1,0,208
Listas,2014EP,14-158-003,599,192,0,192,0,0,192
Listas,2014EP,14-158-004,641,235,0,235,0,0,235
Listas,2014EP,14-158-005,678,262,0,262,0,1,261
Listas,2014EP,14-158-006,690,299,0,299,0,2,297
Listas,2014EP,14-158-007,623,184,0,184,0,0,184
Listas,2014EP,14-158-008,601,210,0,210,0,0,210
Listas,2014EP,14-158-009,663,295,0,295,0,1,294
Listas,2014EP,14-158-010,671,278,0,278,0,0,278
Listas,2014EP,14-158-011,645,141,0,141,0,1,140
Listas,2014EP,14-158-012,656,149,0,149,0,0,149
Listas,2014EP,14-158-013,626,260,0,261,1,8,253
Listas,2014EP,14-158-014,611,187,0,187,0,0,187
Listas,2014EP,14-158-015,631,195,0,195,0,4,191
Listas,2014EP,14-158-016,780,348,0,348,0,1,347
Listas,2014EP,14-159-001,907,165,0,165,0,1,164
Listas,2014EP,14-159-002,890,188,0,188,0,0,188
Listas,2014EP,14-159-003,823,144,0,144,0,0,144
Listas,2014EP,14-159-004,794,170,0,170,0,2,168
Listas,2014EP,14-160-001,755,234,0,234,0,0,234
Listas,2014EP,14-160-002,996,79,0,79,0,0,79
Listas,2014EP,14-160-003,953,224,0,224,0,0,224
Listas,2014EP,14-160-004,704,125,0,125,0,0,125
Listas,2014EP,14-160-005,726,187,0,187,0,3,184
Listas,2014EP,14-160-006,719,201,0,201,0,0,201
Listas,2014EP,14-160-007,643,198,0,198,0,0,198
Listas,2014EP,14-160-008,763,212,0,212,0,2,210
Listas,2014EP,14-161-001,693,265,0,265,0,0,265
Listas,2014EP,14-161-002,761,235,0,235,0,2,233
Listas,2014EP,14-161-003,793,232,0,232,0,1,231
Listas,2014EP,14-162-001,698,165,0,165,0,0,165
Listas,2014EP,14-162-002,727,221,0,221,0,3,218
Listas,2014EP,14-163-001,663,122,0,122,0,1,121
Listas,2014EP,14-163-002,759,160,0,160,0,1,159
Listas,2014EP,14-163-003,745,122,0,122,0,0,122
Listas,2014EP,14-164-001,1061,265,0,265,0,1,264
Listas,2014EP,14-164-002,987,302,0,302,0,2,300
Listas,2014EP,14-165-001,1170,298,2,296,-2,1,295
Listas,2014EP,14-165-002,1253,338,0,338,0,0,338
Listas,2014EP,14-165-003,1030,182,0,182,0,0,182
Listas,2014EP,14-165-004,1057,165,0,165,0,0,165
Listas,2014EP,14-165-005,1062,170,0,170,0,2,168
Listas,2014EP,14-165-006,1188,334,0,334,0,0,334
Listas,2014EP,14-165-007,1121,289,0,289,0,1,288
Listas,2014EP,14-165-008,1262,330,0,330,0,1,329
Listas,2014EP,14-166-001,1076,454,0,454,0,1,453
Listas,2014EP,14-166-002,1156,424,0,424,0,2,422
Listas,2014EP,14-166-003,1017,395,0,395,0,2,393
Listas,2014EP,14-166-004,1149,413,0,413,0,0,413
Listas,2014EP,14-166-005,1069,440,0,440,0,0,440
Listas,2014EP,14-167-001,1016,208,0,208,0,0,208
Listas,2014EP,14-167-002,840,143,0,143,0,0,143
Listas,2014EP,14-168-001,1289,316,0,316,0,1,315
Listas,2014EP,14-168-002,246,56,0,56,0,0,56
Listas,2014EP,14-169-001,703,166,0,166,0,0,166
Listas,2014EP,14-169-002,1148,347,0,347,0,1,346
Listas,2014EP,14-169-003,989,484,0,483,-1,2,481
Listas,2014EP,14-169-004,1075,320,0,320,0,1,319
Listas,2014EP,14-169-005,1021,385,0,385,0,0,385
Listas,2014EP,14-169-006,916,342,0,342,0,1,341
Listas,2014EP,14-169-007,817,325,0,325,0,0,325
Listas,2014EP,14-169-008,856,359,0,359,0,1,358
Listas,2014EP,14-169-009,846,307,0,307,0,1,306
Listas,2014EP,14-169-010,891,384,0,384,0,0,384
Listas,2014EP,14-169-011,924,284,0,284,0,1,283
Listas,2014EP,14-169-012,721,300,0,300,0,1,299
Listas,2014EP,14-169-013,737,184,0,184,0,0,184
Listas,2014EP,14-169-014,853,274,0,274,0,1,273
Listas,2014EP,14-169-015,1057,349,0,349,0,1,348
Listas,2014EP,14-169-016,727,216,0,216,0,0,216
Listas,2014EP,14-169-017,879,260,0,260,0,3,257
Listas,2014EP,14-169-018,773,174,0,174,0,0,174
Listas,2014EP,14-169-019,622,267,0,267,0,0,267
Listas,2014EP,14-169-020,998,389,0,389,0,0,389
Listas,2014EP,14-169-021,948,382,0,382,0,2,380
Listas,2014EP,14-169-022,653,262,0,262,0,0,262
Listas,2014EP,14-169-023,1041,423,0,423,0,2,421
Listas,2014EP,14-169-024,1203,347,0,347,0,0,347
Listas,2014EP,14-169-025,1161,448,0,448,0,1,447
Listas,2014EP,14-169-026,680,206,0,206,0,0,206
Listas,2014EP,14-169-027,895,225,0,225,0,2,223
Listas,2014EP,14-169-028,1025,403,0,403,0,0,403
Listas,2014EP,14-169-029,1114,317,0,317,0,0,317
Listas,2014EP,14-169-030,1139,443,0,443,0,0,443
Listas,2014EP,14-170-001,1070,320,0,320,0,1,319
Listas,2014EP,14-171-001,679,167,0,167,0,1,166
Listas,2014EP,14-172-001,721,217,0,217,0,1,216
Listas,2014EP,14-172-002,740,209,0,209,0,1,208
Listas,2014EP,14-173-001,397,99,0,99,0,0,99
Listas,2014EP,14-174-001,678,206,0,206,0,1,205
Listas,2014EP,14-174-002,752,189,0,189,0,0,189
Listas,2014EP,14-175-001,871,187,0,187,0,1,186
Listas,2014EP,14-175-002,808,196,0,196,0,3,193
Listas,2014EP,14-176-001,624,161,0,161,0,1,160
Listas,2014EP,14-176-002,620,165,0,165,0,4,161
Listas,2014EP,14-177-001,572,195,0,195,0,0,195
Listas,2014EP,14-177-002,618,209,0,209,0,0,209
Listas,2014EP,14-177-003,610,204,0,204,0,1,203
Listas,2014EP,14-177-004,648,225,0,225,0,0,225
Listas,2014EP,14-177-005,795,324,0,324,0,0,324
Listas,2014EP,14-177-006,673,208,0,208,0,0,208
Listas,2014EP,14-177-007,652,179,0,179,0,0,179
Listas,2014EP,14-177-008,634,171,0,171,0,0,171
Listas,2014EP,14-177-009,611,143,0,143,0,0,143
Listas,2014EP,14-177-010,655,171,0,171,0,1,170
Listas,2014EP,14-177-011,612,146,0,146,0,0,146
Listas,2014EP,14-177-012,669,192,0,192,0,0,192
Listas,2014EP,14-177-013,734,197,0,197,0,0,197
Listas,2014EP,14-177-014,746,177,0,177,0,0,177
Listas,2014EP,14-177-015,730,176,0,176,0,0,176
Listas,2014EP,14-177-016,634,198,0,197,-1,1,196
Listas,2014EP,14-177-017,640,157,0,157,0,2,155
Listas,2014EP,14-177-018,649,189,0,189,0,1,188
Listas,2014EP,14-177-019,719,225,0,225,0,4,221
Listas,2014EP,14-177-020,726,205,0,205,0,0,205
Listas,2014EP,14-177-021,807,197,0,197,0,0,197
Listas,2014EP,14-177-022,799,158,0,158,0,1,157
Listas,2014EP,14-177-023,801,194,0,194,0,0,194
Listas,2014EP,14-177-024,719,169,0,169,0,0,169
Listas,2014EP,14-178-001,670,198,0,198,0,0,198
Listas,2014EP,14-178-002,752,183,0,183,0,0,183
Listas,2014EP,14-178-003,895,321,0,321,0,0,321
Listas,2014EP,14-178-004,761,193,0,193,0,0,193
Listas,2014EP,14-178-005,680,202,0,202,0,1,201
Listas,2014EP,14-178-006,686,202,0,202,0,1,201
Listas,2014EP,14-178-007,807,312,0,312,0,1,311
Listas,2014EP,14-178-008,748,239,0,239,0,0,239
Listas,2014EP,14-178-009,907,240,0,240,0,0,240
Listas,2014EP,14-178-010,907,298,1,298,0,0,298
Listas,2014EP,14-178-011,816,283,0,283,0,1,282
Listas,2014EP,14-178-012,814,296,0,296,0,0,296
Listas,2014EP,14-178-013,799,252,0,252,0,0,252
Listas,2014EP,14-178-014,759,247,0,247,0,0,247
Listas,2014EP,14-178-015,742,224,0,224,0,0,224
Listas,2014EP,14-178-016,767,218,0,217,-1,0,217
Listas,2014EP,14-179-001,948,377,0,377,0,0,377
Listas,2014EP,14-179-002,936,314,0,314,0,0,314
Listas,2014EP,14-179-003,1001,431,0,431,0,2,429
Listas,2014EP,14-180-001,1104,215,0,215,0,1,214
Listas,2014EP,14-181-001,847,369,0,369,0,4,365
Listas,2014EP,14-181-002,670,241,0,241,0,1,240
Listas,2014EP,14-182-001,1060,424,0,424,0,2,422
Listas,2014EP,14-183-001,1029,365,0,365,0,2,363
Listas,2014EP,14-183-002,1163,348,0,348,0,2,346
Listas,2014EP,14-183-003,943,323,0,323,0,1,322
Listas,2014EP,14-183-004,950,312,0,312,0,3,309
Listas,2014EP,14-184-001,941,233,0,233,0,0,233
Listas,2014EP,14-184-002,961,203,0,203,0,2,201
Listas,2014EP,14-185-001,832,142,0,142,0,0,142
Listas,2014EP,14-185-002,693,153,0,153,0,2,151
Listas,2014EP,14-186-001,556,300,0,300,0,0,300
Listas,2014EP,14-187-001,970,229,0,229,0,1,228
Listas,2014EP,14-187-002,738,175,0,175,0,0,175
Listas,2014EP,14-187-003,794,158,0,158,0,0,158
Listas,2014EP,14-187-004,1004,211,0,211,0,1,210
Listas,2014EP,15-001-001,228,69,0,69,0,0,69
Listas,2014EP,15-002-001,769,156,0,156,0,0,156
Listas,2014EP,15-002-002,110,36,0,36,0,1,35
Listas,2014EP,15-003-001,808,176,0,176,0,0,176
Listas,2014EP,15-003-002,972,191,0,191,0,0,191
Listas,2014EP,15-004-001,663,138,0,138,0,1,137
Listas,2014EP,15-004-002,604,98,0,98,0,0,98
Listas,2014EP,15-005-001,155,33,0,33,0,0,33
Listas,2014EP,15-006-001,926,321,0,321,0,1,320
Listas,2014EP,15-007-001,1155,516,0,516,0,2,514
Listas,2014EP,15-007-002,794,231,0,231,0,1,230
Listas,2014EP,15-007-003,904,298,0,297,-1,0,297
Listas,2014EP,15-007-004,895,216,0,216,0,0,216
Listas,2014EP,15-007-005,838,319,0,319,0,0,319
Listas,2014EP,15-007-006,587,129,0,129,0,1,128
Listas,2014EP,15-008-001,1115,278,0,278,0,0,278
Listas,2014EP,15-009-001,1108,552,0,551,-1,3,548
Listas,2014EP,15-009-002,870,233,0,233,0,0,233
Listas,2014EP,15-009-003,112,11,0,11,0,0,11
Listas,2014EP,15-010-001,1111,516,0,516,0,3,513
Listas,2014EP,15-010-002,1058,402,0,402,0,1,401
Listas,2014EP,15-011-001,729,209,0,209,0,1,208
Listas,2014EP,15-011-002,672,174,0,174,0,0,174
Listas,2014EP,15-012-001,867,205,0,205,0,1,204
Listas,2014EP,15-012-002,1061,396,0,396,0,1,395
Listas,2014EP,15-012-003,786,260,0,260,0,3,257
Listas,2014EP,15-012-004,736,224,0,224,0,1,223
Listas,2014EP,15-012-005,838,251,0,251,0,1,250
Listas,2014EP,15-013-001,740,315,0,315,0,2,313
Listas,2014EP,15-014-001,477,203,0,203,0,0,203
Listas,2014EP,15-015-001,669,211,0,211,0,1,210
Listas,2014EP,15-015-002,621,112,0,112,0,1,111
Listas,2014EP,15-015-003,527,96,0,96,0,0,96
Listas,2014EP,15-015-004,594,189,0,189,0,3,186
Listas,2014EP,15-016-001,1074,513,0,513,0,1,512
Listas,2014EP,15-016-002,902,265,0,265,0,1,264
Listas,2014EP,15-017-001,898,363,0,363,0,0,363
Listas,2014EP,15-017-002,735,292,0,292,0,0,292
Listas,2014EP,15-018-001,678,212,0,212,0,1,211
Listas,2014EP,15-018-002,652,193,0,193,0,0,193
Listas,2014EP,15-019-001,428,118,0,118,0,0,118
Listas,2014EP,15-020-001,1049,280,0,280,0,2,278
Listas,2014EP,15-020-002,927,253,0,253,0,0,253
Listas,2014EP,15-020-003,610,167,0,167,0,0,167
Listas,2014EP,15-020-004,1159,113,0,113,0,1,112
Listas,2014EP,15-020-005,1154,223,0,223,0,0,223
Listas,2014EP,15-020-006,1178,365,0,365,0,0,365
Listas,2014EP,15-020-007,1126,237,0,237,0,1,236
Listas,2014EP,15-020-008,1137,269,0,269,0,1,268
Listas,2014EP,15-020-009,540,129,0,129,0,0,129
Listas,2014EP,15-020-010,266,63,0,63,0,0,63
Listas,2014EP,15-021-001,673,137,0,137,0,0,137
Listas,2014EP,15-022-001,668,125,0,125,0,0,125
Listas,2014EP,15-023-001,451,74,0,74,0,0,74
Listas,2014EP,15-024-001,954,188,0,188,0,1,187
Listas,2014EP,15-025-001,324,62,0,62,0,3,59
Listas,2014EP,15-026-001,482,52,0,52,0,0,52
Listas,2014EP,15-027-001,896,229,0,229,0,0,229
Listas,2014EP,15-027-002,1103,223,0,223,0,0,223
Listas,2014EP,15-028-001,317,89,0,89,0,1,88
Listas,2014EP,15-029-001,353,118,0,118,0,1,117
Listas,2014EP,15-030-001,363,79,0,79,0,1,78
Listas,2014EP,15-031-001,612,106,0,106,0,0,106
Listas,2014EP,15-032-001,229,54,0,54,0,1,53
Listas,2014EP,15-033-001,948,127,0,127,0,0,127
Listas,2014EP,15-033-002,932,165,0,165,0,1,164
Listas,2014EP,15-034-001,430,87,0,87,0,1,86
Listas,2014EP,15-035-001,681,186,0,186,0,0,186
Listas,2014EP,15-035-002,435,128,0,128,0,1,127
Listas,2014EP,15-036-001,237,42,0,42,0,0,42
Listas,2014EP,15-037-001,189,34,0,34,0,0,34
Listas,2014EP,15-038-001,184,74,0,74,0,0,74
Listas,2014EP,15-039-001,648,187,0,187,0,1,186
Listas,2014EP,15-039-002,590,127,0,127,0,1,126
Listas,2014EP,15-040-001,373,111,0,111,0,0,111
Listas,2014EP,15-041-001,230,66,0,66,0,0,66
Listas,2014EP,15-042-001,799,134,0,134,0,1,133
Listas,2014EP,15-043-001,238,74,0,74,0,0,74
Listas,2014EP,15-044-001,611,106,0,106,0,0,106
Listas,2014EP,15-044-002,745,146,0,146,0,2,144
Listas,2014EP,15-044-003,815,225,0,225,0,0,225
Listas,2014EP,15-044-004,908,270,0,270,0,0,270
Listas,2014EP,15-044-005,628,171,0,171,0,0,171
Listas,2014EP,15-044-006,601,128,0,128,0,0,128
Listas,2014EP,15-045-001,128,48,0,48,0,0,48
Listas,2014EP,15-046-001,725,140,0,140,0,0,140
Listas,2014EP,15-047-001,118,38,0,38,0,0,38
Listas,2014EP,15-048-001,202,55,0,55,0,0,55
Listas,2014EP,15-049-001,180,45,0,45,0,0,45
Listas,2014EP,15-050-001,159,47,0,47,0,0,47
Listas,2014EP,15-051-001,344,73,0,73,0,2,71
Listas,2014EP,15-052-001,124,28,0,28,0,0,28
Listas,2014EP,15-053-001,254,58,0,58,0,2,56
Listas,2014EP,15-054-001,1250,527,0,527,0,0,527
Listas,2014EP,15-054-002,1074,348,0,348,0,0,348
Listas,2014EP,15-054-003,1135,363,0,363,0,0,363
Listas,2014EP,15-054-004,1046,232,0,232,0,1,231
Listas,2014EP,15-055-001,69,24,0,24,0,0,24
Listas,2014EP,15-056-001,81,26,0,26,0,0,26
Listas,2014EP,15-057-001,274,41,0,41,0,1,40
Listas,2014EP,15-058-001,513,111,0,111,0,0,111
Listas,2014EP,15-058-002,85,22,0,22,0,0,22
Listas,2014EP,15-059-001,207,50,0,50,0,1,49
Listas,2014EP,15-060-001,263,46,0,46,0,0,46
Listas,2014EP,15-061-001,669,172,0,172,0,0,172
Listas,2014EP,15-061-002,94,11,0,11,0,0,11
Listas,2014EP,15-062-001,405,73,0,73,0,0,73
Listas,2014EP,15-062-002,495,70,0,70,0,0,70
Listas,2014EP,15-063-001,850,210,0,210,0,1,209
Listas,2014EP,15-064-001,218,49,0,49,0,0,49
Listas,2014EP,15-065-001,186,37,0,37,0,0,37
Listas,2014EP,15-066-001,306,71,0,71,0,1,70
Listas,2014EP,15-067-001,371,73,0,73,0,0,73
Listas,2014EP,15-067-002,221,47,0,47,0,0,47
Listas,2014EP,15-068-001,343,63,0,63,0,2,61
Listas,2014EP,15-069-001,287,46,0,46,0,0,46
Listas,2014EP,15-070-001,221,73,0,73,0,0,73
Listas,2014EP,15-071-001,949,196,0,196,0,0,196
Listas,2014EP,15-072-001,202,51,0,51,0,1,50
Listas,2014EP,15-073-001,902,125,0,125,0,0,125
Listas,2014EP,15-074-001,37,17,0,17,0,0,17
Listas,2014EP,15-075-001,1063,314,0,314,0,1,313
Listas,2014EP,15-076-001,377,78,0,78,0,0,78
Listas,2014EP,15-077-001,1017,179,0,179,0,0,179
Listas,2014EP,15-078-001,968,102,0,102,0,0,102
Listas,2014EP,15-079-001,386,86,0,86,0,1,85
Listas,2014EP,15-080-001,521,109,0,109,0,0,109
Listas,2014EP,15-081-001,1018,289,0,289,0,1,288
Listas,2014EP,15-082-001,710,111,0,111,0,0,111
Listas,2014EP,15-082-002,665,83,0,83,0,2,81
Listas,2014EP,15-082-003,693,128,0,128,0,0,128
Listas,2014EP,15-083-001,554,100,0,100,0,0,100
Listas,2014EP,15-084-001,721,159,0,159,0,1,158
Listas,2014EP,15-084-002,674,104,0,104,0,0,104
Listas,2014EP,15-085-001,93,45,0,45,0,0,45
Listas,2014EP,15-086-001,374,85,0,85,0,3,82
Listas,2014EP,15-087-001,253,40,0,40,0,0,40
Listas,2014EP,15-088-001,671,154,0,154,0,0,154
Listas,2014EP,15-088-002,697,161,0,160,-1,0,160
Listas,2014EP,15-088-003,655,171,0,171,0,1,170
Listas,2014EP,15-089-001,837,198,0,198,0,1,197
Listas,2014EP,15-090-001,593,127,0,127,0,0,127
Listas,2014EP,15-091-001,1105,323,0,323,0,0,323
Listas,2014EP,15-091-002,723,205,0,205,0,10,195
Listas,2014EP,15-091-003,801,176,0,176,0,1,175
Listas,2014EP,15-091-004,750,211,0,211,0,0,211
Listas,2014EP,15-091-005,971,288,0,288,0,1,287
Listas,2014EP,15-091-006,1052,354,0,353,-1,1,352
Listas,2014EP,15-091-007,1103,348,0,348,0,3,345
Listas,2014EP,15-091-008,825,162,0,162,0,0,162
Listas,2014EP,15-091-009,801,182,0,182,0,2,180
Listas,2014EP,15-091-010,627,186,0,186,0,0,186
Listas,2014EP,15-091-011,705,227,0,227,0,0,227
Listas,2014EP,15-091-012,966,305,0,304,-1,2,302
Listas,2014EP,15-091-013,770,161,0,161,0,0,161
Listas,2014EP,15-091-014,621,160,0,160,0,0,160
Listas,2014EP,15-091-015,800,262,0,262,0,1,261
Listas,2014EP,15-091-016,1148,337,0,337,0,2,335
Listas,2014EP,15-091-017,1130,382,0,382,0,0,382
Listas,2014EP,15-091-018,808,219,0,219,0,0,219
Listas,2014EP,15-091-019,640,184,0,184,0,1,183
Listas,2014EP,15-091-020,785,171,0,171,0,2,169
Listas,2014EP,15-091-021,1130,303,0,303,0,2,301
Listas,2014EP,15-091-022,1148,281,0,281,0,0,281
Listas,2014EP,15-091-023,1137,314,0,314,0,0,314
Listas,2014EP,15-091-024,1354,326,0,326,0,0,326
Listas,2014EP,15-091-025,750,225,0,225,0,0,225
Listas,2014EP,15-091-026,832,265,0,265,0,0,265
Listas,2014EP,15-091-027,801,213,0,213,0,0,213
Listas,2014EP,15-091-028,728,186,0,186,0,1,185
Listas,2014EP,15-091-029,835,189,0,190,1,7,183
Listas,2014EP,15-091-030,1240,376,0,376,0,3,373
Listas,2014EP,15-091-031,1069,316,0,316,0,1,315
Listas,2014EP,15-091-032,822,193,0,193,0,0,193
Listas,2014EP,15-091-033,891,207,0,207,0,0,207
Listas,2014EP,15-091-034,818,313,0,313,0,0,313
Listas,2014EP,15-091-035,801,298,0,298,0,2,296
Listas,2014EP,15-091-036,956,371,0,370,-1,1,369
Listas,2014EP,15-091-037,896,301,0,301,0,5,296
Listas,2014EP,15-091-038,1019,341,0,340,-1,1,339
Listas,2014EP,15-091-039,1151,322,0,322,0,0,322
Listas,2014EP,15-091-040,830,350,0,350,0,2,348
Listas,2014EP,15-091-041,717,262,0,262,0,0,262
Listas,2014EP,15-091-042,870,343,0,343,0,1,342
Listas,2014EP,15-091-043,940,367,0,367,0,1,366
Listas,2014EP,15-091-044,865,359,0,359,0,0,359
Listas,2014EP,15-091-045,896,269,0,269,0,2,267
Listas,2014EP,15-091-046,823,270,0,270,0,0,270
Listas,2014EP,15-091-047,724,283,0,283,0,2,281
Listas,2014EP,15-091-048,644,247,0,247,0,0,247
Listas,2014EP,15-091-049,740,318,0,318,0,2,316
Listas,2014EP,15-091-050,1004,336,0,336,0,0,336
Listas,2014EP,15-091-051,858,196,0,196,0,1,195
Listas,2014EP,15-091-052,1360,488,0,488,0,2,486
Listas,2014EP,15-091-053,637,187,0,187,0,0,187
Listas,2014EP,15-091-054,1061,250,0,250,0,0,250
Listas,2014EP,15-091-055,895,125,0,125,0,1,124
Listas,2014EP,15-091-056,776,201,0,201,0,0,201
Listas,2014EP,15-091-057,1084,351,0,351,0,0,351
Listas,2014EP,15-091-058,962,218,0,218,0,2,216
Listas,2014EP,15-091-059,1117,385,0,385,0,0,385
Listas,2014EP,15-092-001,578,159,0,159,0,0,159
Listas,2014EP,15-092-002,678,145,0,145,0,1,144
Listas,2014EP,15-093-001,184,43,0,43,0,1,42
Listas,2014EP,15-094-001,97,37,0,37,0,0,37
Listas,2014EP,15-095-001,240,42,0,42,0,1,41
Listas,2014EP,15-096-001,479,64,0,64,0,1,63
Listas,2014EP,15-097-001,368,69,0,69,0,0,69
Listas,2014EP,15-098-001,46,29,0,29,0,0,29
Listas,2014EP,15-099-001,254,60,0,60,0,0,60
Listas,2014EP,15-100-001,327,83,0,83,0,0,83
Listas,2014EP,15-101-001,468,101,0,101,0,0,101
Listas,2014EP,15-102-001,610,120,0,120,0,0,120
Listas,2014EP,15-102-002,509,141,0,141,0,0,141
Listas,2014EP,15-102-003,640,160,0,160,0,2,158
Listas,2014EP,15-103-001,150,25,0,25,0,0,25
Listas,2014EP,15-104-001,314,50,0,50,0,0,50
Listas,2014EP,15-105-001,346,63,0,63,0,1,62
Listas,2014EP,15-106-001,133,29,0,29,0,0,29
Listas,2014EP,15-107-001,176,49,0,49,0,0,49
Listas,2014EP,15-108-001,723,107,0,107,0,0,107
Listas,2014EP,15-109-001,154,47,0,47,0,0,47
Listas,2014EP,15-110-001,418,126,0,126,0,0,126
Listas,2014EP,15-111-001,295,39,0,39,0,0,39
Listas,2014EP,15-111-002,139,21,0,20,-1,0,20
Listas,2014EP,15-112-001,1191,354,0,354,0,0,354
Listas,2014EP,15-113-001,550,121,0,121,0,1,120
Listas,2014EP,15-113-002,634,107,0,107,0,0,107
Listas,2014EP,15-114-001,502,91,0,91,0,1,90
Listas,2014EP,15-115-001,446,51,0,51,0,0,51
Listas,2014EP,15-116-001,877,160,0,160,0,2,158
Listas,2014EP,15-116-002,746,144,0,144,0,0,144
Listas,2014EP,15-117-001,531,132,0,132,0,0,132
Listas,2014EP,15-117-002,603,147,0,147,0,1,146
Listas,2014EP,15-118-001,815,222,0,222,0,0,222
Listas,2014EP,15-118-002,800,136,0,136,0,0,136
Listas,2014EP,15-118-003,872,163,0,163,0,1,162
Listas,2014EP,15-119-001,28,17,0,17,0,0,17
Listas,2014EP,15-120-001,170,72,0,72,0,0,72
Listas,2014EP,15-121-001,556,115,0,115,0,1,114
Listas,2014EP,15-121-002,159,54,0,54,0,0,54
Listas,2014EP,15-122-001,505,119,0,119,0,0,119
Listas,2014EP,15-123-001,1085,231,0,230,-1,0,230
Listas,2014EP,15-123-002,169,49,0,49,0,0,49
Listas,2014EP,15-123-003,969,218,0,218,0,1,217
Listas,2014EP,15-123-004,1267,283,0,283,0,1,282
Listas,2014EP,15-123-005,1181,387,0,387,0,3,384
Listas,2014EP,15-123-006,1162,326,0,326,0,0,326
Listas,2014EP,15-123-007,1211,229,0,229,0,1,228
Listas,2014EP,15-123-008,842,219,0,219,0,3,216
Listas,2014EP,15-123-009,1134,242,0,242,0,0,242
Listas,2014EP,15-123-010,404,87,0,87,0,2,85
Listas,2014EP,15-123-011,82,35,0,35,0,0,35
Listas,2014EP,15-123-012,305,42,0,42,0,1,41
Listas,2014EP,15-124-001,558,169,0,169,0,0,169
Listas,2014EP,15-124-002,531,106,0,106,0,0,106
Listas,2014EP,15-124-003,112,32,0,32,0,0,32
Listas,2014EP,15-125-001,631,153,0,153,0,1,152
Listas,2014EP,15-125-002,448,132,0,132,0,0,132
Listas,2014EP,15-126-001,967,140,0,140,0,1,139
Listas,2014EP,15-127-001,487,85,0,85,0,1,84
Listas,2014EP,15-128-001,188,63,0,63,0,0,63
Listas,2014EP,15-129-001,766,194,0,194,0,1,193
Listas,2014EP,15-130-001,228,42,0,42,0,0,42
Listas,2014EP,15-130-002,1142,264,0,264,0,0,264
Listas,2014EP,15-130-003,1162,305,0,305,0,3,302
Listas,2014EP,15-130-004,1200,311,0,311,0,0,311
Listas,2014EP,15-130-005,1144,389,0,389,0,1,388
Listas,2014EP,15-130-006,1190,369,0,369,0,0,369
Listas,2014EP,15-130-007,1188,281,0,281,0,1,280
Listas,2014EP,15-130-008,1118,265,0,265,0,0,265
Listas,2014EP,15-130-009,950,176,0,175,-1,1,174
Listas,2014EP,15-131-001,868,145,0,145,0,1,144
Listas,2014EP,15-131-002,853,104,0,104,0,0,104
Listas,2014EP,15-131-003,816,102,0,102,0,0,102
Listas,2014EP,15-132-001,1106,183,0,183,0,0,183
Listas,2014EP,15-133-001,1192,253,0,253,0,1,252
Listas,2014EP,15-134-001,306,106,0,106,0,0,106
Listas,2014EP,15-135-001,458,122,0,122,0,2,120
Listas,2014EP,15-136-001,347,80,0,80,0,1,79
Listas,2014EP,15-137-001,495,82,0,82,0,0,82
Listas,2014EP,15-138-001,519,84,0,84,0,0,84
Listas,2014EP,15-139-001,81,29,0,29,0,1,28
Listas,2014EP,15-140-001,541,123,0,123,0,0,123
Listas,2014EP,15-141-001,445,105,0,105,0,0,105
Listas,2014EP,15-141-002,101,40,0,40,0,0,40
Listas,2014EP,15-142-001,249,49,0,49,0,0,49
Listas,2014EP,15-143-001,474,109,0,109,0,0,109
Listas,2014EP,15-144-001,665,163,0,163,0,1,162
Listas,2014EP,15-145-001,368,70,0,70,0,0,70
Listas,2014EP,15-145-002,243,66,0,66,0,0,66
Listas,2014EP,15-146-001,592,90,0,90,0,0,90
Listas,2014EP,15-146-002,595,101,0,101,0,0,101
Listas,2014EP,15-147-001,677,119,0,119,0,1,118
Listas,2014EP,15-148-001,115,35,0,35,0,0,35
Listas,2014EP,15-148-002,322,96,0,96,0,1,95
Listas,2014EP,15-149-001,184,77,0,77,0,1,76
Listas,2014EP,15-150-001,271,99,0,99,0,1,98
Listas,2014EP,15-151-001,50,17,0,17,0,0,17
Listas,2014EP,15-152-001,208,43,0,43,0,0,43
Listas,2014EP,15-153-001,211,45,0,45,0,0,45
Listas,2014EP,15-154-001,129,50,0,50,0,0,50
Listas,2014EP,15-155-001,379,59,0,59,0,0,59
Listas,2014EP,15-156-001,175,50,0,50,0,0,50
Listas,2014EP,15-157-001,188,52,0,52,0,1,51
Listas,2014EP,15-158-001,220,59,0,59,0,0,59
Listas,2014EP,15-159-001,72,34,0,34,0,0,34
Listas,2014EP,15-160-001,180,60,0,60,0,0,60
Listas,2014EP,15-161-001,517,114,0,114,0,1,113
Listas,2014EP,15-161-002,123,21,0,21,0,0,21
Listas,2014EP,15-162-001,327,105,0,105,0,0,105
Listas,2014EP,15-163-001,386,86,0,86,0,0,86
Listas,2014EP,15-164-001,130,15,0,15,0,0,15
Listas,2014EP,15-165-001,116,44,0,44,0,0,44
Listas,2014EP,15-166-001,305,48,0,48,0,0,48
Listas,2014EP,15-167-001,241,52,0,52,0,0,52
Listas,2014EP,15-168-001,41,12,0,12,0,0,12
Listas,2014EP,15-169-001,766,203,0,203,0,2,201
Listas,2014EP,15-169-002,756,158,0,158,0,1,157
Listas,2014EP,15-170-001,469,118,0,118,0,0,118
Listas,2014EP,15-171-001,388,68,0,68,0,0,68
Listas,2014EP,15-172-001,925,133,0,133,0,1,132
Listas,2014EP,15-172-002,1025,169,0,169,0,0,169
Listas,2014EP,15-173-001,130,52,0,52,0,0,52
Listas,2014EP,15-174-001,291,69,0,69,0,0,69
Listas,2014EP,15-175-001,265,101,0,101,0,0,101
Listas,2014EP,15-175-002,549,226,0,226,0,0,226
Listas,2014EP,15-175-003,583,222,0,222,0,0,222
Listas,2014EP,15-175-004,1007,639,0,639,0,0,639
Listas,2014EP,15-175-005,1167,378,0,378,0,2,376
Listas,2014EP,15-175-006,1371,435,0,435,0,0,435
Listas,2014EP,15-175-007,1048,347,0,347,0,0,347
Listas,2014EP,15-175-008,920,286,0,286,0,1,285
Listas,2014EP,15-175-009,1026,421,0,421,0,4,417
Listas,2014EP,15-175-010,1129,372,0,371,-1,0,371
Listas,2014EP,15-175-011,696,252,0,252,0,0,252
Listas,2014EP,15-175-012,648,262,0,262,0,0,262
Listas,2014EP,15-175-013,766,255,0,255,0,1,254
Listas,2014EP,15-175-014,986,312,0,312,0,3,309
Listas,2014EP,15-175-015,848,272,0,272,0,1,271
Listas,2014EP,15-175-016,852,305,0,305,0,0,305
Listas,2014EP,15-175-017,1189,271,0,271,0,0,271
Listas,2014EP,15-175-018,1084,312,0,312,0,1,311
Listas,2014EP,15-175-019,1158,240,0,240,0,0,240
Listas,2014EP,15-175-020,1256,277,0,277,0,0,277
Listas,2014EP,15-175-021,1310,351,0,351,0,0,351
Listas,2014EP,15-175-022,283,76,0,76,0,1,75
Listas,2014EP,15-175-023,708,204,0,204,0,0,204
Listas,2014EP,15-176-001,491,122,0,122,0,0,122
Listas,2014EP,15-177-001,558,123,0,123,0,1,122
Listas,2014EP,15-178-001,339,79,0,79,0,0,79
Listas,2014EP,15-179-001,157,44,0,44,0,0,44
Listas,2014EP,15-180-001,127,25,0,25,0,0,25
Listas,2014EP,15-181-001,470,124,0,124,0,1,123
Listas,2014EP,15-181-002,150,38,0,38,0,0,38
Listas,2014EP,15-182-001,440,107,0,107,0,0,107
Listas,2014EP,15-183-001,87,42,0,42,0,0,42
Listas,2014EP,15-184-001,133,31,0,31,0,0,31
Listas,2014EP,15-185-001,133,40,0,40,0,0,40
Listas,2014EP,15-186-001,179,37,0,37,0,0,37
Listas,2014EP,15-187-001,401,98,0,98,0,0,98
Listas,2014EP,15-188-001,374,71,0,71,0,1,70
Listas,2014EP,15-189-001,555,130,0,129,-1,0,129
Listas,2014EP,15-189-002,770,153,0,153,0,0,153
Listas,2014EP,15-190-001,419,91,0,91,0,0,91
Listas,2014EP,15-191-001,532,105,0,105,0,0,105
Listas,2014EP,15-192-001,440,79,0,79,0,2,77
Listas,2014EP,15-192-002,587,111,0,111,0,0,111
Listas,2014EP,15-193-001,57,30,0,30,0,0,30
Listas,2014EP,15-194-001,525,100,0,100,0,1,99
Listas,2014EP,15-195-001,597,150,0,150,0,5,145
Listas,2014EP,15-196-001,583,181,0,181,0,1,180
Listas,2014EP,15-196-002,786,144,0,144,0,1,143
Listas,2014EP,15-197-001,367,121,0,121,0,0,121
Listas,2014EP,15-198-001,474,119,0,119,0,0,119
Listas,2014EP,15-198-002,450,80,0,80,0,0,80
Listas,2014EP,15-199-001,615,101,0,101,0,0,101
Listas,2014EP,15-200-001,811,172,0,172,0,1,171
Listas,2014EP,15-200-002,480,130,0,130,0,1,129
Listas,2014EP,15-200-003,125,38,0,38,0,1,37
Listas,2014EP,15-201-001,260,59,0,59,0,0,59
Listas,2014EP,15-201-002,178,39,0,39,0,0,39
Listas,2014EP,15-202-001,252,70,0,70,0,2,68
Listas,2014EP,15-203-001,440,115,0,115,0,3,112
Listas,2014EP,15-204-001,641,297,0,297,0,0,297
Listas,2014EP,15-205-001,164,57,0,57,0,0,57
Listas,2014EP,15-206-001,592,199,0,199,0,1,198
Listas,2014EP,15-207-001,332,74,0,74,0,0,74
Listas,2014EP,15-208-001,264,110,0,110,0,0,110
Listas,2014EP,15-209-001,104,36,0,36,0,0,36
Listas,2014EP,15-210-001,416,86,0,86,0,0,86
Listas,2014EP,15-211-001,239,35,0,35,0,0,35
Listas,2014EP,15-212-001,171,66,0,66,0,1,65
Listas,2014EP,15-213-001,89,36,0,36,0,0,36
Listas,2014EP,15-214-001,496,211,1,210,-1,1,209
Listas,2014EP,15-215-001,230,84,0,84,0,1,83
Listas,2014EP,15-216-001,493,108,0,108,0,0,108
Listas,2014EP,15-216-002,510,90,0,90,0,0,90
Listas,2014EP,15-217-001,526,134,0,134,0,0,134
Listas,2014EP,15-218-001,722,158,0,158,0,1,157
Listas,2014EP,15-218-002,773,154,0,154,0,1,153
Listas,2014EP,15-218-003,659,108,0,108,0,0,108
Listas,2014EP,15-218-004,774,169,0,169,0,0,169
Listas,2014EP,15-218-005,805,226,0,226,0,1,225
Listas,2014EP,15-219-001,578,97,0,97,0,2,95
Listas,2014EP,15-220-001,457,59,0,59,0,0,59
Listas,2014EP,15-220-002,471,58,0,58,0,3,55
Listas,2014EP,15-221-001,802,185,0,185,0,0,185
Listas,2014EP,15-221-002,845,199,0,199,0,1,198
Listas,2014EP,15-222-001,325,105,0,105,0,0,105
Listas,2014EP,15-223-001,157,52,0,52,0,0,52
Listas,2014EP,15-224-001,367,52,0,52,0,0,52
Listas,2014EP,15-225-001,106,27,0,27,0,3,24
Listas,2014EP,15-226-001,213,75,0,75,0,0,75
Listas,2014EP,15-227-001,183,55,0,55,0,0,55
Listas,2014EP,15-228-001,353,99,0,99,0,0,99
Listas,2014EP,15-229-001,117,27,0,27,0,0,27
Listas,2014EP,15-229-002,113,32,0,32,0,0,32
Listas,2014EP,15-230-001,119,43,0,43,0,0,43
Listas,2014EP,15-231-001,421,115,0,115,0,0,115
Listas,2014EP,15-232-001,622,96,0,96,0,0,96
Listas,2014EP,15-233-001,193,47,0,47,0,0,47
Listas,2014EP,15-234-001,181,60,0,60,0,1,59
Listas,2014EP,15-235-001,488,108,0,108,0,0,108
Listas,2014EP,15-236-001,337,107,0,107,0,0,107
Listas,2014EP,15-237-001,226,54,0,54,0,0,54
Listas,2014EP,15-238-001,1279,653,1,652,-1,4,648
Listas,2014EP,15-238-002,1154,378,0,378,0,6,372
Listas,2014EP,15-239-001,425,116,0,116,0,1,115
Listas,2014EP,15-239-002,519,134,0,134,0,0,134
Listas,2014EP,15-240-001,303,57,0,57,0,2,55
Listas,2014EP,15-241-001,457,104,0,104,0,2,102
Listas,2014EP,15-242-001,205,44,0,44,0,0,44
Listas,2014EP,15-243-001,264,67,0,67,0,0,67
Listas,2014EP,15-244-001,348,101,0,101,0,0,101
Listas,2014EP,15-245-001,466,91,0,91,0,0,91
Listas,2014EP,15-246-001,1224,431,0,431,0,3,428
Listas,2014EP,16-001-001,1036,201,0,201,0,0,201
Listas,2014EP,16-001-002,974,201,0,201,0,1,200
Listas,2014EP,16-001-003,1186,194,0,194,0,0,194
Listas,2014EP,16-002-001,822,166,0,166,0,0,166
Listas,2014EP,16-002-002,795,87,0,87,0,0,87
Listas,2014EP,16-003-001,639,141,0,141,0,1,140
Listas,2014EP,16-003-002,638,116,0,116,0,1,115
Listas,2014EP,16-003-003,641,114,0,114,0,0,114
Listas,2014EP,16-004-001,733,145,0,145,0,0,145
Listas,2014EP,16-004-002,725,124,0,124,0,3,121
Listas,2014EP,16-005-001,770,536,0,536,0,0,536
Listas,2014EP,16-005-002,828,531,0,531,0,2,529
Listas,2014EP,16-005-003,1202,760,0,760,0,7,753
Listas,2014EP,16-006-001,834,221,0,221,0,0,221
Listas,2014EP,16-006-002,1025,230,0,230,0,1,229
Listas,2014EP,16-006-003,1164,219,0,219,0,1,218
Listas,2014EP,16-006-004,359,50,0,50,0,1,49
Listas,2014EP,16-006-005,705,69,0,69,0,2,67
Listas,2014EP,16-006-006,1034,138,0,138,0,2,136
Listas,2014EP,16-007-001,690,163,0,163,0,2,161
Listas,2014EP,16-008-001,714,198,0,198,0,4,194
Listas,2014EP,16-009-001,539,160,0,160,0,0,160
Listas,2014EP,16-010-001,352,167,0,167,0,0,167
Listas,2014EP,16-011-001,698,290,0,290,0,1,289
Listas,2014EP,16-012-001,654,213,0,213,0,3,210
Listas,2014EP,16-013-001,656,235,0,235,0,1,234
Listas,2014EP,16-014-001,530,177,0,177,0,1,176
Listas,2014EP,16-015-001,808,82,0,82,0,1,81
Listas,2014EP,16-016-001,1151,202,0,202,0,2,200
Listas,2014EP,16-017-001,526,131,0,131,0,0,131
Listas,2014EP,16-018-001,618,156,0,156,0,0,156
Listas,2014EP,16-018-002,652,120,0,120,0,1,119
Listas,2014EP,16-018-003,610,136,0,136,0,0,136
Listas,2014EP,16-018-004,615,92,0,92,0,0,92
Listas,2014EP,16-019-001,582,183,0,183,0,1,182
Listas,2014EP,16-019-002,686,184,0,184,0,1,183
Listas,2014EP,16-019-003,566,103,0,103,0,0,103
Listas,2014EP,16-020-001,549,213,0,213,0,2,211
Listas,2014EP,16-021-001,411,240,0,240,0,3,237
Listas,2014EP,16-022-001,490,183,0,183,0,2,181
Listas,2014EP,16-023-001,297,76,0,76,0,0,76
Listas,2014EP,16-024-001,546,221,0,221,0,1,220
Listas,2014EP,16-025-001,762,126,0,126,0,0,126
Listas,2014EP,16-025-002,821,215,0,215,0,3,212
Listas,2014EP,16-025-003,893,217,0,217,0,1,216
Listas,2014EP,16-025-004,766,238,0,238,0,2,236
Listas,2014EP,16-025-005,824,181,0,181,0,0,181
Listas,2014EP,16-026-001,614,157,0,157,0,1,156
Listas,2014EP,16-027-001,677,280,0,280,0,0,280
Listas,2014EP,16-028-001,138,42,0,42,0,0,42
Listas,2014EP,16-029-001,616,152,0,152,0,0,152
Listas,2014EP,16-029-002,897,194,0,194,0,2,192
Listas,2014EP,16-029-003,971,147,0,147,0,0,147
Listas,2014EP,16-029-004,633,126,0,126,0,2,124
Listas,2014EP,16-029-005,244,41,0,41,0,2,39
Listas,2014EP,16-030-001,1090,181,0,181,0,0,181
Listas,2014EP,16-030-002,1049,271,0,271,0,3,268
Listas,2014EP,16-030-003,934,219,0,219,0,1,218
Listas,2014EP,16-031-001,881,120,0,120,0,0,120
Listas,2014EP,16-031-002,837,125,0,125,0,1,124
Listas,2014EP,16-032-001,693,132,0,132,0,0,132
Listas,2014EP,16-032-002,748,116,0,116,0,0,116
Listas,2014EP,16-033-001,908,212,0,212,0,1,211
Listas,2014EP,16-034-001,657,75,0,75,0,0,75
Listas,2014EP,16-034-002,654,92,0,92,0,1,91
Listas,2014EP,16-035-001,491,75,0,75,0,1,74
Listas,2014EP,16-035-002,740,147,0,147,0,0,147
Listas,2014EP,16-035-003,186,51,0,51,0,1,50
Listas,2014EP,16-036-001,978,320,0,320,0,3,317
Listas,2014EP,16-036-002,982,341,0,341,0,0,341
Listas,2014EP,16-036-003,938,278,0,278,0,1,277
Listas,2014EP,16-036-004,924,345,0,345,0,3,342
Listas,2014EP,16-036-005,941,368,0,368,0,1,367
Listas,2014EP,16-036-006,957,268,0,268,0,0,268
Listas,2014EP,16-036-007,924,207,0,207,0,0,207
Listas,2014EP,16-037-001,1008,315,0,315,0,1,314
Listas,2014EP,16-037-002,981,222,0,222,0,1,221
Listas,2014EP,16-038-001,367,105,0,105,0,0,105
Listas,2014EP,16-039-001,242,110,0,110,0,0,110
Listas,2014EP,16-040-001,594,119,0,119,0,0,119
Listas,2014EP,16-041-001,115,83,0,83,0,0,83
Listas,2014EP,16-042-001,933,242,0,242,0,1,241
Listas,2014EP,16-042-002,956,250,0,250,0,2,248
Listas,2014EP,16-042-003,941,257,0,257,0,0,257
Listas,2014EP,16-043-001,483,127,0,127,0,0,127
Listas,2014EP,16-044-001,651,220,0,220,0,3,217
Listas,2014EP,16-045-001,733,187,0,187,0,2,185
Listas,2014EP,16-045-002,704,150,0,149,-1,0,149
Listas,2014EP,16-046-001,452,161,0,161,0,1,160
Listas,2014EP,16-047-001,822,118,0,118,0,0,118
Listas,2014EP,16-047-002,749,103,0,103,0,1,102
Listas,2014EP,16-048-001,722,152,0,152,0,3,149
Listas,2014EP,16-049-001,94,34,0,34,0,0,34
Listas,2014EP,16-050-001,1213,264,0,264,0,2,262
Listas,2014EP,16-051-001,763,112,0,112,0,0,112
Listas,2014EP,16-051-002,836,70,0,70,0,0,70
Listas,2014EP,16-052-001,235,72,0,72,0,0,72
Listas,2014EP,16-053-001,967,207,0,207,0,0,207
Listas,2014EP,16-054-001,222,105,0,105,0,1,104
Listas,2014EP,16-055-001,251,60,0,60,0,0,60
Listas,2014EP,16-056-001,883,151,0,151,0,4,147
Listas,2014EP,16-056-002,743,139,0,139,0,2,137
Listas,2014EP,16-056-003,797,203,0,203,0,8,195
Listas,2014EP,16-057-001,1009,244,0,244,0,1,243
Listas,2014EP,16-057-002,999,256,0,256,0,0,256
Listas,2014EP,16-057-003,1028,212,0,212,0,0,212
Listas,2014EP,16-057-004,1048,135,0,135,0,0,135
Listas,2014EP,16-057-005,1086,186,0,186,0,2,184
Listas,2014EP,16-057-006,182,63,0,63,0,0,63
Listas,2014EP,16-058-001,935,212,0,212,0,1,211
Listas,2014EP,16-059-001,630,122,0,122,0,1,121
Listas,2014EP,16-060-001,1349,305,0,305,0,3,302
Listas,2014EP,16-061-001,1048,244,0,244,0,0,244
Listas,2014EP,16-062-001,614,98,0,98,0,1,97
Listas,2014EP,16-063-001,639,122,0,122,0,1,121
Listas,2014EP,16-063-002,877,140,0,140,0,0,140
Listas,2014EP,16-063-003,598,114,0,114,0,0,114
Listas,2014EP,16-063-004,707,154,0,154,0,1,153
Listas,2014EP,16-063-005,239,42,0,42,0,0,42
Listas,2014EP,16-064-001,735,181,0,181,0,1,180
Listas,2014EP,16-064-002,622,151,0,151,0,0,151
Listas,2014EP,16-064-003,182,44,0,44,0,0,44
Listas,2014EP,16-065-001,701,172,0,172,0,3,169
Listas,2014EP,16-065-002,908,224,0,224,0,5,219
Listas,2014EP,16-066-001,1085,350,0,350,0,3,347
Listas,2014EP,16-066-002,1040,401,0,401,0,3,398
Listas,2014EP,16-066-003,771,296,0,296,0,2,294
Listas,2014EP,16-066-004,925,271,0,271,0,2,269
Listas,2014EP,16-067-001,711,108,0,108,0,1,107
Listas,2014EP,16-067-002,806,150,0,150,0,0,150
Listas,2014EP,16-068-001,619,173,0,173,0,1,172
Listas,2014EP,16-068-002,606,74,0,74,0,2,72
Listas,2014EP,16-069-001,249,88,0,88,0,0,88
Listas,2014EP,16-070-001,855,188,0,188,0,0,188
Listas,2014EP,16-071-001,49,31,0,31,0,0,31
Listas,2014EP,16-072-001,1353,294,0,294,0,0,294
Listas,2014EP,16-073-001,243,91,0,91,0,0,91
Listas,2014EP,16-074-001,451,166,0,166,0,1,165
Listas,2014EP,16-075-001,445,99,0,99,0,0,99
Listas,2014EP,16-076-001,852,239,0,239,0,1,238
Listas,2014EP,16-077-001,782,162,0,162,0,0,162
Listas,2014EP,16-077-002,944,184,0,184,0,1,183
Listas,2014EP,16-077-003,743,184,0,184,0,1,183
Listas,2014EP,16-077-004,1066,270,0,270,0,8,262
Listas,2014EP,16-077-005,1128,288,0,288,0,0,288
Listas,2014EP,16-077-006,769,219,0,219,0,0,219
Listas,2014EP,16-077-007,855,159,0,159,0,0,159
Listas,2014EP,16-077-008,960,233,0,233,0,0,233
Listas,2014EP,16-077-009,851,169,0,169,0,0,169
Listas,2014EP,16-077-010,852,212,0,212,0,0,212
Listas,2014EP,16-077-011,865,255,0,255,0,1,254
Listas,2014EP,16-077-012,740,213,0,213,0,0,213
Listas,2014EP,16-077-013,933,155,0,155,0,2,153
Listas,2014EP,16-077-014,843,216,0,216,0,1,215
Listas,2014EP,16-077-015,810,189,0,189,0,1,188
Listas,2014EP,16-077-016,827,160,0,160,0,0,160
Listas,2014EP,16-078-001,994,191,0,191,0,2,189
Listas,2014EP,16-078-002,641,143,0,143,0,0,143
Listas,2014EP,16-078-003,736,114,0,114,0,0,114
Listas,2014EP,16-079-001,106,43,0,43,0,0,43
Listas,2014EP,16-080-001,1109,190,0,190,0,0,190
Listas,2014EP,16-081-001,1194,188,0,188,0,0,188
Listas,2014EP,16-081-002,1207,223,0,223,0,1,222
Listas,2014EP,16-081-003,1207,283,0,283,0,0,283
Listas,2014EP,16-082-001,1069,268,0,268,0,1,267
Listas,2014EP,16-083-001,470,111,0,111,0,2,109
Listas,2014EP,16-084-001,806,144,0,144,0,0,144
Listas,2014EP,16-085-001,794,136,0,136,0,0,136
Listas,2014EP,16-085-002,750,185,0,185,0,2,183
Listas,2014EP,16-085-003,771,145,0,145,0,2,143
Listas,2014EP,16-086-001,702,160,0,160,0,0,160
Listas,2014EP,16-087-001,418,103,0,103,0,0,103
Listas,2014EP,16-088-001,205,92,0,92,0,1,91
Listas,2014EP,16-089-001,749,161,0,161,0,2,159
Listas,2014EP,16-090-001,232,56,0,56,0,0,56
Listas,2014EP,16-091-001,691,177,0,177,0,1,176
Listas,2014EP,16-091-002,807,147,0,147,0,1,146
Listas,2014EP,16-091-003,989,131,0,131,0,3,128
Listas,2014EP,16-091-004,871,202,0,202,0,0,202
Listas,2014EP,16-092-001,873,268,0,268,0,2,266
Listas,2014EP,16-092-002,890,164,0,164,0,1,163
Listas,2014EP,16-093-001,436,135,0,135,0,1,134
Listas,2014EP,16-094-001,1150,306,0,306,0,2,304
Listas,2014EP,16-094-002,722,254,0,254,0,0,254
Listas,2014EP,16-094-003,729,233,0,233,0,1,232
Listas,2014EP,16-094-004,855,256,0,256,0,0,256
Listas,2014EP,16-094-005,815,176,0,176,0,1,175
Listas,2014EP,16-094-006,874,234,0,234,0,0,234
Listas,2014EP,16-094-007,970,217,0,217,0,0,217
Listas,2014EP,16-094-008,776,215,0,215,0,3,212
Listas,2014EP,16-094-009,852,267,0,267,0,1,266
Listas,2014EP,16-094-010,828,225,0,226,1,7,219
Listas,2014EP,16-094-011,852,179,0,179,0,1,178
Listas,2014EP,16-094-012,1002,266,0,266,0,2,264
Listas,2014EP,16-094-013,864,258,0,258,0,0,258
Listas,2014EP,16-094-014,799,227,0,227,0,0,227
Listas,2014EP,16-094-015,953,241,0,241,0,1,240
Listas,2014EP,16-094-016,947,261,0,261,0,2,259
Listas,2014EP,16-095-001,229,56,0,56,0,0,56
Listas,2014EP,16-096-001,841,195,0,195,0,3,192
Listas,2014EP,16-097-001,576,139,0,139,0,2,137
Listas,2014EP,16-098-001,1050,284,0,284,0,1,283
Listas,2014EP,16-098-002,699,183,0,183,0,0,183
Listas,2014EP,16-099-001,724,134,0,134,0,2,132
Listas,2014EP,16-100-001,531,141,0,141,0,1,140
Listas,2014EP,16-101-001,957,152,0,152,0,0,152
Listas,2014EP,16-101-002,258,49,0,49,0,0,49
Listas,2014EP,16-101-003,113,36,0,36,0,0,36
Listas,2014EP,16-102-001,816,184,0,184,0,0,184
Listas,2014EP,16-102-002,795,151,0,151,0,1,150
Listas,2014EP,16-103-001,1102,197,0,197,0,1,196
Listas,2014EP,16-103-002,603,102,0,102,0,0,102
Listas,2014EP,16-103-003,876,121,0,121,0,0,121
Listas,2014EP,16-103-004,705,90,0,90,0,0,90
Listas,2014EP,16-103-005,1021,111,0,111,0,0,111
Listas,2014EP,16-103-006,835,138,0,138,0,1,137
Listas,2014EP,16-104-001,732,162,0,162,0,0,162
Listas,2014EP,16-104-002,645,129,0,129,0,2,127
Listas,2014EP,16-104-003,810,104,0,104,0,1,103
Listas,2014EP,16-104-004,859,93,0,93,0,0,93
Listas,2014EP,16-104-005,762,109,0,109,0,0,109
Listas,2014EP,16-104-006,783,126,0,126,0,0,126
Listas,2014EP,16-105-001,107,56,0,56,0,0,56
Listas,2014EP,16-106-001,983,258,0,258,0,0,258
Listas,2014EP,16-106-002,1013,154,0,154,0,0,154
Listas,2014EP,16-106-003,989,189,0,189,0,0,189
Listas,2014EP,16-106-004,913,192,0,192,0,0,192
Listas,2014EP,16-106-005,966,233,0,233,0,4,229
Listas,2014EP,16-106-006,984,126,0,126,0,2,124
Listas,2014EP,16-106-007,959,190,1,190,0,1,189
Listas,2014EP,16-106-008,1035,199,0,199,0,0,199
Listas,2014EP,16-107-001,452,120,0,120,0,1,119
Listas,2014EP,16-108-001,1215,292,0,292,0,1,291
Listas,2014EP,16-109-001,945,195,0,195,0,0,195
Listas,2014EP,16-109-002,1039,185,0,185,0,1,184
Listas,2014EP,16-109-003,1058,119,0,119,0,1,118
Listas,2014EP,16-110-001,763,192,0,192,0,1,191
Listas,2014EP,16-111-001,81,30,0,30,0,0,30
Listas,2014EP,16-112-001,1347,458,0,458,0,2,456
Listas,2014EP,16-112-002,1222,373,0,373,0,1,372
Listas,2014EP,16-112-003,1112,371,0,371,0,2,369
Listas,2014EP,16-112-004,1181,373,0,373,0,1,372
Listas,2014EP,16-112-005,1220,432,0,432,0,2,430
Listas,2014EP,16-112-006,1289,467,0,465,-2,2,463
Listas,2014EP,16-112-007,1210,342,0,342,0,4,338
Listas,2014EP,16-112-008,1174,418,0,418,0,0,418
Listas,2014EP,16-113-001,737,191,0,191,0,0,191
Listas,2014EP,16-113-002,895,203,0,203,0,0,203
Listas,2014EP,16-113-003,584,72,0,72,0,0,72
Listas,2014EP,16-114-001,920,471,0,471,0,6,465
Listas,2014EP,16-114-002,766,388,0,387,-1,0,387
Listas,2014EP,16-114-003,862,342,0,342,0,4,338
Listas,2014EP,16-115-001,598,109,0,109,0,1,108
Listas,2014EP,16-115-002,902,116,0,116,0,1,115
Listas,2014EP,16-115-003,863,219,0,219,0,0,219
Listas,2014EP,16-116-001,1148,264,0,264,0,1,263
Listas,2014EP,16-116-002,622,102,0,102,0,1,101
Listas,2014EP,16-117-001,989,243,0,243,0,4,239
Listas,2014EP,16-118-001,497,144,0,144,0,0,144
Listas,2014EP,16-119-001,904,325,0,324,-1,0,324
Listas,2014EP,16-119-002,1111,412,0,412,0,3,409
Listas,2014EP,16-119-003,835,275,0,275,0,1,274
Listas,2014EP,16-119-004,1325,348,0,348,0,2,346
Listas,2014EP,16-119-005,1036,310,0,310,0,2,308
Listas,2014EP,16-119-006,1024,396,0,396,0,1,395
Listas,2014EP,16-119-007,940,385,0,385,0,2,383
Listas,2014EP,16-119-008,1081,359,0,359,0,2,357
Listas,2014EP,16-119-009,833,201,0,201,0,0,201
Listas,2014EP,16-119-010,877,322,0,322,0,3,319
Listas,2014EP,16-119-011,1023,268,0,268,0,0,268
Listas,2014EP,16-119-012,866,242,0,242,0,1,241
Listas,2014EP,16-119-013,1007,222,0,222,0,1,221
Listas,2014EP,16-119-014,961,349,0,349,0,1,348
Listas,2014EP,16-119-015,1157,432,0,432,0,3,429
Listas,2014EP,16-119-016,688,258,0,258,0,0,258
Listas,2014EP,16-119-017,1058,475,0,475,0,0,475
Listas,2014EP,16-119-018,768,226,0,226,0,0,226
Listas,2014EP,16-119-019,1177,269,0,269,0,0,269
Listas,2014EP,16-119-020,831,281,0,280,-1,0,280
Listas,2014EP,16-119-021,838,316,0,316,0,0,316
Listas,2014EP,16-119-022,1335,509,0,509,0,4,505
Listas,2014EP,16-119-023,777,241,0,241,0,2,239
Listas,2014EP,16-119-024,1120,320,0,320,0,1,319
Listas,2014EP,16-119-025,919,334,0,334,0,2,332
Listas,2014EP,16-119-026,888,246,0,246,0,0,246
Listas,2014EP,16-119-027,962,266,0,266,0,0,266
Listas,2014EP,16-119-028,1046,398,0,398,0,0,398
Listas,2014EP,16-119-029,944,323,0,322,-1,0,322
Listas,2014EP,16-119-030,1116,321,0,321,0,1,320
Listas,2014EP,16-119-031,931,295,0,295,0,0,295
Listas,2014EP,16-119-032,884,348,0,348,0,0,348
Listas,2014EP,16-119-033,836,291,0,291,0,0,291
Listas,2014EP,16-119-034,1010,303,0,303,0,1,302
Listas,2014EP,16-119-035,702,128,0,128,0,3,125
Listas,2014EP,16-119-036,893,235,0,235,0,0,235
Listas,2014EP,16-119-037,649,220,0,220,0,0,220
Listas,2014EP,16-119-038,675,253,0,253,0,1,252
Listas,2014EP,16-119-039,890,157,0,157,0,1,156
Listas,2014EP,16-119-040,942,223,0,223,0,0,223
Listas,2014EP,16-119-041,1194,294,1,293,-1,2,291
Listas,2014EP,16-119-042,1209,223,0,223,0,1,222
Listas,2014EP,16-119-043,770,244,0,244,0,6,238
Listas,2014EP,16-119-044,1005,376,0,376,0,2,374
Listas,2014EP,16-119-045,712,292,0,292,0,1,291
Listas,2014EP,16-119-046,968,283,0,282,-1,1,281
Listas,2014EP,16-119-047,1138,621,0,621,0,6,615
Listas,2014EP,16-119-048,1203,373,0,373,0,1,372
Listas,2014EP,16-119-049,696,162,0,162,0,1,161
Listas,2014EP,16-119-050,890,261,0,261,0,1,260
Listas,2014EP,16-119-051,1040,271,0,270,-1,0,270
Listas,2014EP,16-119-052,894,285,0,285,0,2,283
Listas,2014EP,16-119-053,728,188,0,188,0,0,188
Listas,2014EP,16-119-054,1178,366,0,366,0,0,366
Listas,2014EP,16-119-055,970,300,0,300,0,0,300
Listas,2014EP,16-119-056,691,227,0,227,0,0,227
Listas,2014EP,16-119-057,1104,350,0,350,0,0,350
Listas,2014EP,16-119-058,804,280,0,280,0,2,278
Listas,2014EP,16-119-059,940,324,0,324,0,1,323
Listas,2014EP,16-119-060,783,300,0,299,-1,0,299
Listas,2014EP,16-119-061,710,127,0,127,0,0,127
Listas,2014EP,16-119-062,1285,291,0,291,0,1,290
Listas,2014EP,16-119-063,942,216,0,216,0,1,215
Listas,2014EP,16-119-064,822,195,0,195,0,0,195
Listas,2014EP,16-119-065,1091,203,0,203,0,0,203
Listas,2014EP,16-119-066,1216,247,0,247,0,0,247
Listas,2014EP,16-119-067,1019,235,0,235,0,2,233
Listas,2014EP,16-119-068,968,244,0,244,0,0,244
Listas,2014EP,16-119-069,1143,207,0,207,0,1,206
Listas,2014EP,16-119-070,1177,380,0,380,0,0,380
Listas,2014EP,16-119-071,924,349,0,349,0,0,349
Listas,2014EP,16-119-072,808,193,0,193,0,2,191
Listas,2014EP,16-119-073,1190,394,0,394,0,1,393
Listas,2014EP,16-119-074,1098,357,0,357,0,2,355
Listas,2014EP,16-119-075,1171,376,0,376,0,0,376
Listas,2014EP,16-119-076,586,52,0,52,0,2,50
Listas,2014EP,16-119-077,673,139,0,139,0,0,139
Listas,2014EP,16-119-078,1431,285,0,285,0,1,284
Listas,2014EP,16-119-079,1314,292,0,292,0,0,292
Listas,2014EP,16-119-080,910,175,0,175,0,1,174
Listas,2014EP,16-119-081,834,118,0,118,0,0,118
Listas,2014EP,16-119-082,957,171,0,171,0,0,171
Listas,2014EP,16-119-083,1076,195,0,195,0,0,195
Listas,2014EP,16-119-084,1156,224,0,224,0,3,221
Listas,2014EP,16-119-085,1107,231,0,231,0,0,231
Listas,2014EP,16-119-086,1024,121,0,121,0,1,120
Listas,2014EP,16-119-087,899,254,0,254,0,2,252
Listas,2014EP,16-119-088,754,177,0,177,0,1,176
Listas,2014EP,16-119-089,1156,325,0,325,0,2,323
Listas,2014EP,16-119-090,995,209,0,209,0,1,208
Listas,2014EP,16-119-091,1074,223,0,223,0,1,222
Listas,2014EP,16-119-092,796,167,0,167,0,2,165
Listas,2014EP,16-119-093,840,270,0,270,0,1,269
Listas,2014EP,16-119-094,769,214,0,214,0,2,212
Listas,2014EP,16-119-095,1106,282,0,282,0,0,282
Listas,2014EP,16-119-096,1178,338,0,338,0,3,335
Listas,2014EP,16-119-097,787,178,0,178,0,3,175
Listas,2014EP,16-119-098,739,190,0,190,0,0,190
Listas,2014EP,16-119-099,925,245,0,245,0,0,245
Listas,2014EP,16-120-001,722,159,0,159,0,1,158
Listas,2014EP,16-120-002,175,51,0,51,0,0,51
Listas,2014EP,16-121-001,752,139,0,139,0,1,138
Listas,2014EP,16-121-002,822,136,0,136,0,0,136
Listas,2014EP,16-122-001,898,239,0,239,0,0,239
Listas,2014EP,16-123-001,714,315,0,315,0,0,315
Listas,2014EP,16-124-001,808,145,0,145,0,0,145
Listas,2014EP,16-124-002,1048,177,0,177,0,0,177
Listas,2014EP,16-125-001,670,277,0,277,0,1,276
Listas,2014EP,16-125-002,757,291,0,291,0,6,285
Listas,2014EP,16-126-001,647,214,0,214,0,6,208
Listas,2014EP,16-127-001,564,102,0,102,0,1,101
Listas,2014EP,16-128-001,879,232,0,232,0,1,231
Listas,2014EP,16-128-002,998,257,0,257,0,0,257
Listas,2014EP,16-128-003,402,96,0,96,0,2,94
Listas,2014EP,16-129-001,998,145,0,145,0,1,144
Listas,2014EP,16-129-002,842,122,0,122,0,0,122
Listas,2014EP,16-129-003,905,149,0,149,0,2,147
Listas,2014EP,16-129-004,854,142,0,142,0,0,142
Listas,2014EP,16-130-001,1145,272,0,272,0,1,271
Listas,2014EP,16-130-002,1065,159,0,159,0,0,159
Listas,2014EP,16-131-001,705,161,0,161,0,1,160
Listas,2014EP,16-131-002,714,121,0,121,0,1,120
Listas,2014EP,16-132-001,730,269,0,269,0,2,267
Listas,2014EP,16-133-001,1142,266,0,266,0,0,266
Listas,2014EP,16-133-002,1040,234,0,234,0,0,234
Listas,2014EP,16-133-003,674,155,0,155,0,0,155
Listas,2014EP,16-134-001,507,173,0,173,0,1,172
Listas,2014EP,16-135-001,874,110,0,110,0,0,110
Listas,2014EP,16-135-002,761,113,0,113,0,2,111
Listas,2014EP,16-136-001,839,191,0,191,0,1,190
Listas,2014EP,16-136-002,1120,216,0,216,0,0,216
Listas,2014EP,16-136-003,1140,187,0,187,0,0,187
Listas,2014EP,16-136-004,747,71,0,71,0,0,71
Listas,2014EP,16-136-005,1140,149,0,149,0,0,149
Listas,2014EP,16-136-006,714,196,0,196,0,0,196
Listas,2014EP,16-137-001,903,92,0,92,0,0,92
Listas,2014EP,16-138-001,681,241,0,241,0,2,239
Listas,2014EP,16-138-002,799,285,0,285,0,0,285
Listas,2014EP,16-139-001,807,221,0,221,0,0,221
Listas,2014EP,16-139-002,795,128,0,128,0,0,128
Listas,2014EP,16-140-001,541,157,0,157,0,1,156
Listas,2014EP,16-141-001,260,92,0,92,0,0,92
Listas,2014EP,16-142-001,663,202,0,202,0,2,200
Listas,2014EP,16-142-002,641,142,0,142,0,0,142
Listas,2014EP,16-142-003,716,137,0,137,0,1,136
Listas,2014EP,16-143-001,1082,217,0,217,0,1,216
Listas,2014EP,16-143-002,1174,164,0,164,0,1,163
Listas,2014EP,16-144-001,705,130,0,130,0,0,130
Listas,2014EP,16-144-002,720,145,0,145,0,0,145
Listas,2014EP,16-145-001,366,98,0,98,0,0,98
Listas,2014EP,16-146-001,597,170,0,170,0,4,166
Listas,2014EP,16-146-002,543,133,0,133,0,4,129
Listas,2014EP,16-147-001,522,151,0,151,0,1,150
Listas,2014EP,16-148-001,801,152,0,152,0,2,150
Listas,2014EP,16-148-002,757,87,0,87,0,1,86
Listas,2014EP,16-149-001,673,142,0,142,0,2,140
Listas,2014EP,16-150-001,966,228,0,227,-1,2,225
Listas,2014EP,16-151-001,722,197,0,197,0,0,197
Listas,2014EP,16-151-002,894,184,0,184,0,0,184
Listas,2014EP,16-151-003,630,151,0,151,0,1,150
Listas,2014EP,16-152-001,567,144,0,144,0,1,143
Listas,2014EP,16-153-001,814,206,0,205,-1,2,203
Listas,2014EP,16-154-001,633,176,0,176,0,2,174
Listas,2014EP,16-155-001,743,155,0,155,0,0,155
Listas,2014EP,16-155-002,705,140,0,140,0,1,139
Listas,2014EP,16-156-001,624,185,0,185,0,5,180
Listas,2014EP,16-156-002,680,111,0,111,0,0,111
Listas,2014EP,16-157-001,691,199,0,199,0,2,197
Listas,2014EP,16-157-002,656,147,0,147,0,0,147
Listas,2014EP,16-157-003,655,124,0,124,0,0,124
Listas,2014EP,16-158-001,680,162,0,162,0,0,162
Listas,2014EP,16-158-002,679,144,0,144,0,0,144
Listas,2014EP,16-159-001,1091,293,0,293,0,2,291
Listas,2014EP,16-160-001,677,241,0,241,0,1,240
Listas,2014EP,16-160-002,895,259,0,259,0,0,259
Listas,2014EP,16-160-003,761,192,0,192,0,1,191
Listas,2014EP,16-160-004,665,217,0,217,0,0,217
Listas,2014EP,16-160-005,828,246,0,246,0,1,245
Listas,2014EP,16-161-001,1189,187,0,187,0,0,187
Listas,2014EP,16-162-001,104,38,0,38,0,1,37
Listas,2014EP,16-163-001,805,113,0,113,0,0,113
Listas,2014EP,16-164-001,971,443,0,443,0,4,439
Listas,2014EP,16-165-001,562,162,0,162,0,0,162
Listas,2014EP,16-166-001,1164,174,0,174,0,0,174
Listas,2014EP,16-167-001,626,171,0,171,0,0,171
Listas,2014EP,16-168-001,312,122,0,122,0,0,122
Listas,2014EP,16-169-001,963,129,0,129,0,1,128
Listas,2014EP,16-170-001,580,75,0,75,0,0,75
Listas,2014EP,16-170-002,656,87,0,87,0,0,87
Listas,2014EP,16-171-001,807,154,0,154,0,2,152
Listas,2014EP,16-171-002,718,162,0,162,0,1,161
Listas,2014EP,16-171-003,724,132,0,132,0,0,132
Listas,2014EP,16-172-001,418,64,0,64,0,0,64
Listas,2014EP,16-173-001,337,66,0,66,0,0,66
Listas,2014EP,16-174-001,356,123,0,123,0,0,123
Listas,2014EP,16-175-001,614,250,0,250,0,2,248
Listas,2014EP,16-176-001,699,222,0,222,0,1,221
Listas,2014EP,16-176-002,864,175,0,175,0,0,175
Listas,2014EP,16-177-001,238,90,0,90,0,0,90
Listas,2014EP,16-178-001,354,106,0,106,0,1,105
Listas,2014EP,16-179-001,569,174,0,178,4,26,152
Listas,2014EP,16-179-002,585,192,0,192,0,1,191
Listas,2014EP,16-180-001,806,194,0,194,0,1,193
Listas,2014EP,16-181-001,842,139,0,139,0,0,139
Listas,2014EP,16-181-002,886,304,0,304,0,4,300
Listas,2014EP,16-182-001,304,146,0,146,0,0,146
Listas,2014EP,16-183-001,542,107,0,107,0,0,107
Listas,2014EP,16-184-001,872,221,0,221,0,0,221
Listas,2014EP,16-185-001,577,130,0,130,0,0,130
Listas,2014EP,16-185-002,424,92,0,92,0,2,90
Listas,2014EP,16-186-001,481,202,0,202,0,1,201
Listas,2014EP,16-187-001,1028,311,0,311,0,4,307
Listas,2014EP,16-188-001,739,249,0,249,0,5,244
Listas,2014EP,16-188-002,678,222,0,222,0,1,221
Listas,2014EP,16-189-001,720,140,0,140,0,2,138
Listas,2014EP,16-189-002,746,146,0,146,0,1,145
Listas,2014EP,16-190-001,196,75,0,75,0,0,75
Listas,2014EP,16-191-001,583,100,0,100,0,0,100
Listas,2014EP,16-191-002,574,168,0,168,0,0,168
Listas,2014EP,16-191-003,580,154,0,154,0,1,153
Listas,2014EP,16-192-001,553,145,0,145,0,3,142
Listas,2014EP,16-192-002,695,114,0,114,0,1,113
Listas,2014EP,16-192-003,780,138,0,138,0,2,136
Listas,2014EP,16-192-004,124,22,0,22,0,3,19
Listas,2014EP,16-193-001,730,169,0,169,0,5,164
Listas,2014EP,16-193-002,708,101,0,101,0,1,100
Listas,2014EP,16-193-003,406,76,0,76,0,2,74
Listas,2014EP,16-193-004,106,33,0,33,0,0,33
Listas,2014EP,16-194-001,632,134,0,134,0,2,132
Listas,2014EP,16-194-002,622,69,0,69,0,1,68
Listas,2014EP,16-195-001,744,127,0,127,0,0,127
Listas,2014EP,16-196-001,614,163,0,163,0,4,159
Listas,2014EP,16-197-001,1036,283,0,283,0,4,279
Listas,2014EP,16-197-002,1074,187,0,187,0,0,187
Listas,2014EP,16-197-003,909,229,0,229,0,0,229
Listas,2014EP,16-197-004,951,234,0,234,0,0,234
Listas,2014EP,16-197-005,307,64,0,64,0,1,63
Listas,2014EP,16-197-006,176,12,0,12,0,1,11
Listas,2014EP,16-198-001,512,119,0,119,0,0,119
Listas,2014EP,16-199-001,611,134,0,134,0,3,131
Listas,2014EP,16-199-002,645,168,0,168,0,1,167
Listas,2014EP,16-199-003,279,42,0,42,0,1,41
Listas,2014EP,16-200-001,400,84,0,84,0,1,83
Listas,2014EP,16-201-001,799,203,0,203,0,1,202
Listas,2014EP,16-202-001,945,117,0,117,0,0,117
Listas,2014EP,16-203-001,616,80,0,80,0,0,80
Listas,2014EP,16-203-002,559,80,0,80,0,0,80
Listas,2014EP,16-204-001,757,89,0,89,0,2,87
Listas,2014EP,16-204-002,722,169,0,169,0,2,167
Listas,2014EP,16-204-003,1060,246,0,246,0,0,246
Listas,2014EP,16-204-004,1223,218,0,218,0,0,218
Listas,2014EP,16-204-005,730,134,0,134,0,2,132
Listas,2014EP,16-204-006,751,142,0,142,0,0,142
Listas,2014EP,16-204-007,1121,267,0,267,0,1,266
Listas,2014EP,16-204-008,1246,284,0,284,0,0,284
Listas,2014EP,16-204-009,1165,227,0,227,0,1,226
Listas,2014EP,16-204-010,1258,241,0,241,0,4,237
Listas,2014EP,16-205-001,386,82,0,82,0,0,82
Listas,2014EP,16-206-001,479,116,0,116,0,0,116
Listas,2014EP,16-207-001,165,65,0,65,0,4,61
Listas,2014EP,16-208-001,605,128,0,128,0,2,126
Listas,2014EP,16-208-002,776,167,0,167,0,0,167
Listas,2014EP,16-208-003,783,100,0,100,0,3,97
Listas,2014EP,16-209-001,723,215,0,215,0,1,214
Listas,2014EP,16-209-002,630,157,0,157,0,0,157
Listas,2014EP,16-209-003,617,122,0,122,0,0,122
Listas,2014EP,16-210-001,897,188,0,188,0,2,186
Listas,2014EP,16-210-002,826,154,0,154,0,1,153
Listas,2014EP,16-210-003,778,137,0,137,0,1,136
Listas,2014EP,16-211-001,598,156,0,156,0,3,153
Listas,2014EP,16-212-001,512,218,0,218,0,1,217
Listas,2014EP,16-213-001,518,98,0,98,0,0,98
Listas,2014EP,16-213-002,567,130,0,130,0,1,129
Listas,2014EP,16-213-003,492,80,0,80,0,1,79
Listas,2014EP,16-214-001,517,262,1,261,-1,2,259
Listas,2014EP,16-215-001,268,164,0,164,0,0,164
Listas,2014EP,16-216-001,542,97,0,97,0,0,97
Listas,2014EP,16-217-001,1277,286,0,286,0,1,285
Listas,2014EP,16-217-002,1475,281,0,281,0,0,281
Listas,2014EP,16-217-003,1215,169,0,169,0,0,169
Listas,2014EP,16-217-004,1413,225,0,225,0,0,225
Listas,2014EP,16-217-005,1387,147,0,147,0,1,146
Listas,2014EP,16-217-006,1060,174,0,174,0,0,174
Listas,2014EP,16-217-007,1179,175,0,175,0,0,175
Listas,2014EP,16-217-008,1281,160,0,160,0,2,158
Listas,2014EP,16-218-001,796,225,0,225,0,3,222
Listas,2014EP,16-219-001,1012,117,0,117,0,0,117
Listas,2014EP,16-219-002,976,180,0,180,0,0,180
Listas,2014EP,16-219-003,818,183,0,183,0,0,183
Listas,2014EP,16-220-001,630,107,0,107,0,0,107
Listas,2014EP,16-220-002,666,138,0,138,0,0,138
Listas,2014EP,16-221-001,917,311,0,311,0,3,308
Listas,2014EP,16-222-001,457,100,0,100,0,0,100
Listas,2014EP,16-223-001,433,190,0,190,0,1,189
Listas,2014EP,16-224-001,798,202,0,202,0,2,200
Listas,2014EP,16-224-002,1024,287,0,287,0,0,287
Listas,2014EP,16-224-003,1139,358,0,358,0,0,358
Listas,2014EP,16-224-004,976,178,0,178,0,0,178
Listas,2014EP,16-224-005,679,218,0,218,0,2,216
Listas,2014EP,16-224-006,581,160,0,160,0,0,160
Listas,2014EP,16-224-007,830,210,0,210,0,0,210
Listas,2014EP,16-224-008,998,199,0,199,0,1,198
Listas,2014EP,16-224-009,195,58,0,58,0,1,57
Listas,2014EP,16-225-001,318,119,0,119,0,2,117
Listas,2014EP,16-226-001,1019,289,0,289,0,0,289
Listas,2014EP,16-226-002,995,253,0,253,0,0,253
Listas,2014EP,16-226-003,758,223,0,223,0,0,223
Listas,2014EP,16-226-004,849,233,0,233,0,2,231
Listas,2014EP,16-227-001,348,103,0,103,0,0,103
Listas,2014EP,16-228-001,621,204,0,204,0,0,204
Listas,2014EP,16-229-001,810,129,0,129,0,0,129
Listas,2014EP,17-001-001,600,157,0,157,0,0,157
Listas,2014EP,17-002-001,608,141,0,141,0,1,140
Listas,2014EP,17-003-001,373,119,0,119,0,1,118
Listas,2014EP,17-003-002,495,148,0,148,0,0,148
Listas,2014EP,17-004-001,675,151,0,151,0,1,150
Listas,2014EP,17-005-001,692,208,0,208,0,2,206
Listas,2014EP,17-005-002,710,181,0,180,-1,0,180
Listas,2014EP,17-006-001,348,66,0,66,0,0,66
Listas,2014EP,17-007-001,1088,261,0,261,0,1,260
Listas,2014EP,17-007-002,1025,271,0,271,0,2,269
Listas,2014EP,17-007-003,1115,263,0,263,0,2,261
Listas,2014EP,17-007-004,1138,251,0,251,0,1,250
Listas,2014EP,17-007-005,1097,262,0,262,0,1,261
Listas,2014EP,17-008-001,273,45,0,45,0,0,45
Listas,2014EP,17-009-001,382,111,0,111,0,0,111
Listas,2014EP,17-010-001,915,202,0,202,0,1,201
Listas,2014EP,17-010-002,921,178,0,178,0,2,176
Listas,2014EP,17-011-001,801,278,0,278,0,1,277
Listas,2014EP,17-011-002,691,202,0,202,0,0,202
Listas,2014EP,17-011-003,937,274,0,274,0,1,273
Listas,2014EP,17-011-004,601,163,0,163,0,0,163
Listas,2014EP,17-011-005,678,216,0,216,0,0,216
Listas,2014EP,17-011-006,721,240,0,240,0,1,239
Listas,2014EP,17-011-007,590,145,0,145,0,1,144
Listas,2014EP,17-011-008,794,192,0,192,0,1,191
Listas,2014EP,17-011-009,733,193,0,193,0,0,193
Listas,2014EP,17-011-010,561,203,0,202,-1,3,199
Listas,2014EP,17-011-011,713,228,0,228,0,0,228
Listas,2014EP,17-011-012,581,231,0,231,0,3,228
Listas,2014EP,17-011-013,796,232,0,232,0,0,232
Listas,2014EP,17-011-014,789,221,0,221,0,0,221
Listas,2014EP,17-011-015,986,284,0,284,0,0,284
Listas,2014EP,17-011-016,240,51,0,51,0,1,50
Listas,2014EP,17-011-017,143,33,0,33,0,0,33
Listas,2014EP,17-012-001,384,123,0,123,0,0,123
Listas,2014EP,17-013-001,768,175,0,175,0,1,174
Listas,2014EP,17-013-002,729,177,0,177,0,0,177
Listas,2014EP,17-013-003,719,157,0,157,0,0,157
Listas,2014EP,17-014-001,787,184,0,184,0,1,183
Listas,2014EP,17-015-001,276,43,0,43,0,0,43
Listas,2014EP,17-016-001,692,132,0,132,0,0,132
Listas,2014EP,17-017-001,936,143,0,143,0,1,142
Listas,2014EP,17-017-002,153,34,0,34,0,0,34
Listas,2014EP,17-018-001,853,156,0,156,0,2,154
Listas,2014EP,17-018-002,826,168,0,168,0,1,167
Listas,2014EP,17-018-003,865,114,0,114,0,0,114
Listas,2014EP,17-018-004,773,156,0,156,0,2,154
Listas,2014EP,17-019-001,309,82,0,82,0,1,81
Listas,2014EP,17-020-001,773,175,0,175,0,0,175
Listas,2014EP,17-020-002,971,279,0,279,0,0,279
Listas,2014EP,17-020-003,913,189,0,189,0,2,187
Listas,2014EP,17-020-004,941,204,0,204,0,2,202
Listas,2014EP,17-020-005,730,195,0,195,0,1,194
Listas,2014EP,17-020-006,592,164,0,164,0,1,163
Listas,2014EP,17-020-007,729,234,0,234,0,1,233
Listas,2014EP,17-020-008,828,273,0,273,0,0,273
Listas,2014EP,17-020-009,876,259,0,257,-2,0,257
Listas,2014EP,17-020-010,994,327,0,327,0,0,327
Listas,2014EP,17-020-011,769,212,0,212,0,0,212
Listas,2014EP,17-020-012,603,149,0,149,0,0,149
Listas,2014EP,17-020-013,732,207,0,207,0,2,205
Listas,2014EP,17-020-014,648,191,0,191,0,0,191
Listas,2014EP,17-020-015,737,182,0,182,0,1,181
Listas,2014EP,17-020-016,748,211,0,211,0,1,210
Listas,2014EP,17-020-017,714,235,0,235,0,1,234
Listas,2014EP,17-020-018,681,156,0,156,0,2,154
Listas,2014EP,17-020-019,775,189,0,189,0,1,188
Listas,2014EP,17-020-020,481,83,0,83,0,0,83
Listas,2014EP,17-020-021,205,28,0,28,0,0,28
Listas,2014EP,17-020-022,589,110,0,110,0,0,110
Listas,2014EP,17-021-001,562,144,0,144,0,1,143
Listas,2014EP,17-021-002,519,97,0,97,0,2,95
Listas,2014EP,17-021-003,517,85,0,85,0,0,85
Listas,2014EP,17-022-001,735,270,0,270,0,0,270
Listas,2014EP,17-022-002,871,315,0,315,0,1,314
Listas,2014EP,17-022-003,811,196,0,196,0,0,196
Listas,2014EP,17-022-004,746,133,0,133,0,1,132
Listas,2014EP,17-022-005,862,179,0,179,0,1,178
Listas,2014EP,17-022-006,752,171,0,171,0,0,171
Listas,2014EP,17-022-007,792,160,1,159,-1,1,158
Listas,2014EP,17-022-008,846,191,0,191,0,2,189
Listas,2014EP,17-022-009,677,117,0,117,0,1,116
Listas,2014EP,17-023-001,657,161,0,161,0,2,159
Listas,2014EP,17-023-002,798,178,0,178,0,0,178
Listas,2014EP,17-023-003,676,173,0,173,0,2,171
Listas,2014EP,17-024-001,211,47,0,47,0,0,47
Listas,2014EP,17-025-001,513,131,0,131,0,0,131
Listas,2014EP,17-026-001,850,171,0,171,0,0,171
Listas,2014EP,17-026-002,834,124,0,124,0,1,123
Listas,2014EP,17-026-003,922,238,0,238,0,2,236
Listas,2014EP,17-026-004,747,181,0,181,0,1,180
Listas,2014EP,17-027-001,568,104,0,104,0,0,104
Listas,2014EP,17-028-001,531,101,0,101,0,0,101
Listas,2014EP,17-029-001,839,186,0,186,0,0,186
Listas,2014EP,17-030-001,542,73,0,73,0,0,73
Listas,2014EP,17-031-001,1029,185,0,185,0,2,183
Listas,2014EP,17-032-001,158,55,0,55,0,0,55
Listas,2014EP,17-033-001,796,196,0,196,0,1,195
Listas,2014EP,17-033-002,819,248,0,248,0,0,248
Listas,2014EP,17-034-001,551,143,0,143,0,0,143
Listas,2014EP,17-035-001,819,170,0,170,0,4,166
Listas,2014EP,17-036-001,685,100,0,100,0,2,98
Listas,2014EP,17-037-001,765,153,0,153,0,0,153
Listas,2014EP,17-038-001,902,273,0,273,0,0,273
Listas,2014EP,17-038-002,760,182,0,182,0,0,182
Listas,2014EP,17-038-003,765,127,0,127,0,0,127
Listas,2014EP,17-039-001,720,163,0,163,0,0,163
Listas,2014EP,17-039-002,776,190,0,190,0,1,189
Listas,2014EP,17-039-003,680,139,0,139,0,0,139
Listas,2014EP,17-040-001,406,69,0,69,0,0,69
Listas,2014EP,17-041-001,195,47,0,47,0,0,47
Listas,2014EP,17-042-001,999,167,0,167,0,0,167
Listas,2014EP,17-043-001,738,200,0,200,0,0,200
Listas,2014EP,17-043-002,709,214,0,214,0,0,214
Listas,2014EP,17-044-001,126,53,0,53,0,0,53
Listas,2014EP,17-045-001,532,178,0,178,0,2,176
Listas,2014EP,17-045-002,171,40,0,40,0,0,40
Listas,2014EP,17-046-001,960,189,0,189,0,3,186
Listas,2014EP,17-046-002,275,43,0,43,0,0,43
Listas,2014EP,17-047-001,181,57,0,57,0,0,57
Listas,2014EP,17-048-001,589,140,0,140,0,1,139
Listas,2014EP,17-049-001,633,133,0,133,0,2,131
Listas,2014EP,17-050-001,282,71,0,71,0,1,70
Listas,2014EP,17-051-001,266,90,0,90,0,0,90
Listas,2014EP,17-052-001,290,54,0,54,0,1,53
Listas,2014EP,17-053-001,296,60,0,60,0,0,60
Listas,2014EP,17-054-001,988,132,0,132,0,0,132
Listas,2014EP,17-055-001,278,73,0,73,0,1,72
Listas,2014EP,17-056-001,559,85,0,85,0,0,85
Listas,2014EP,17-056-002,553,105,0,105,0,1,104
Listas,2014EP,17-056-003,91,14,0,14,0,0,14
Listas,2014EP,17-057-001,1002,170,0,170,0,0,170
Listas,2014EP,17-058-001,140,32,0,32,0,0,32
Listas,2014EP,17-059-001,485,126,0,126,0,0,126
Listas,2014EP,17-060-001,503,145,0,145,0,0,145
Listas,2014EP,17-060-002,659,220,0,220,0,0,220
Listas,2014EP,17-060-003,463,108,0,108,0,1,107
Listas,2014EP,17-061-001,928,110,0,110,0,0,110
Listas,2014EP,17-062-001,231,60,0,60,0,0,60
Listas,2014EP,17-062-002,338,65,0,65,0,0,65
Listas,2014EP,17-062-003,100,22,0,22,0,0,22
Listas,2014EP,17-063-001,262,96,0,96,0,1,95
Listas,2014EP,17-064-001,513,123,0,123,0,0,123
Listas,2014EP,17-064-002,96,22,0,22,0,0,22
Listas,2014EP,17-065-001,282,73,0,73,0,0,73
Listas,2014EP,17-066-001,322,98,0,98,0,0,98
Listas,2014EP,17-067-001,355,78,0,78,0,0,78
Listas,2014EP,17-068-001,61,21,0,21,0,0,21
Listas,2014EP,17-069-001,684,152,0,152,0,1,151
Listas,2014EP,17-069-002,714,120,0,120,0,1,119
Listas,2014EP,17-069-003,785,139,0,139,0,0,139
Listas,2014EP,17-070-001,65,13,0,13,0,1,12
Listas,2014EP,17-070-002,841,178,0,178,0,1,177
Listas,2014EP,17-071-001,925,216,0,216,0,1,215
Listas,2014EP,17-071-002,1048,294,0,294,0,1,293
Listas,2014EP,17-072-001,366,114,0,114,0,0,114
Listas,2014EP,17-073-001,701,123,0,123,0,0,123
Listas,2014EP,17-074-001,141,45,0,45,0,0,45
Listas,2014EP,17-075-001,471,117,0,117,0,0,117
Listas,2014EP,17-076-001,727,184,0,184,0,0,184
Listas,2014EP,17-076-002,697,149,0,149,0,1,148
Listas,2014EP,17-077-001,685,153,0,153,0,1,152
Listas,2014EP,17-077-002,634,151,0,151,0,0,151
Listas,2014EP,17-078-001,831,209,0,209,0,1,208
Listas,2014EP,17-078-002,622,121,0,121,0,0,121
Listas,2014EP,17-078-003,614,112,0,112,0,0,112
Listas,2014EP,17-079-001,901,341,0,341,0,2,339
Listas,2014EP,17-079-002,1074,308,0,308,0,0,308
Listas,2014EP,17-079-003,957,358,0,358,0,0,358
Listas,2014EP,17-079-004,1099,377,1,376,-1,1,375
Listas,2014EP,17-079-005,1000,339,0,339,0,0,339
Listas,2014EP,17-079-006,1005,273,0,273,0,1,272
Listas,2014EP,17-079-007,1141,375,0,375,0,0,375
Listas,2014EP,17-079-008,1088,385,0,385,0,0,385
Listas,2014EP,17-079-009,1023,272,0,272,0,0,272
Listas,2014EP,17-079-010,1063,234,0,234,0,0,234
Listas,2014EP,17-079-011,1042,285,0,285,0,2,283
Listas,2014EP,17-079-012,1101,349,0,349,0,2,347
Listas,2014EP,17-079-013,1008,313,0,313,0,5,308
Listas,2014EP,17-079-014,950,260,0,260,0,0,260
Listas,2014EP,17-079-015,989,186,0,186,0,0,186
Listas,2014EP,17-079-016,255,50,0,50,0,0,50
Listas,2014EP,17-079-017,297,80,0,80,0,0,80
Listas,2014EP,17-080-001,654,105,0,105,0,1,104
Listas,2014EP,17-080-002,450,76,0,76,0,2,74
Listas,2014EP,17-080-003,86,17,0,17,0,1,16
Listas,2014EP,17-081-001,1097,275,0,275,0,0,275
Listas,2014EP,17-081-002,807,182,0,182,0,0,182
Listas,2014EP,17-082-001,473,122,0,122,0,0,122
Listas,2014EP,17-083-001,818,132,0,132,0,1,131
Listas,2014EP,17-084-001,505,145,0,145,0,0,145
Listas,2014EP,17-084-002,437,117,0,117,0,1,116
Listas,2014EP,17-085-001,537,88,0,88,0,0,88
Listas,2014EP,17-086-001,615,150,0,150,0,0,150
Listas,2014EP,17-086-002,221,62,0,62,0,0,62
Listas,2014EP,17-086-003,73,25,0,25,0,0,25
Listas,2014EP,17-087-001,1148,193,0,193,0,1,192
Listas,2014EP,17-087-002,1191,240,0,240,0,2,238
Listas,2014EP,17-087-003,1193,227,0,227,0,0,227
Listas,2014EP,17-088-001,541,211,0,211,0,4,207
Listas,2014EP,17-088-002,540,194,0,194,0,0,194
Listas,2014EP,17-089-001,210,66,0,66,0,0,66
Listas,2014EP,17-090-001,635,169,0,169,0,0,169
Listas,2014EP,17-090-002,481,92,0,92,0,0,92
Listas,2014EP,17-091-001,762,136,0,136,0,0,136
Listas,2014EP,17-092-001,513,161,0,161,0,2,159
Listas,2014EP,17-093-001,200,63,0,63,0,0,63
Listas,2014EP,17-094-001,617,147,0,147,0,0,147
Listas,2014EP,17-094-002,670,164,0,164,0,1,163
Listas,2014EP,17-094-003,648,104,0,104,0,1,103
Listas,2014EP,17-095-001,1016,291,0,291,0,2,289
Listas,2014EP,17-095-002,753,274,0,274,0,0,274
Listas,2014EP,17-095-003,794,215,0,215,0,0,215
Listas,2014EP,17-095-004,594,212,0,212,0,2,210
Listas,2014EP,17-095-005,387,38,0,38,0,0,38
Listas,2014EP,17-095-006,612,219,0,219,0,0,219
Listas,2014EP,17-095-007,636,198,0,198,0,0,198
Listas,2014EP,17-095-008,695,241,0,241,0,1,240
Listas,2014EP,17-095-009,750,269,0,269,0,0,269
Listas,2014EP,17-095-010,814,265,0,265,0,0,265
Listas,2014EP,17-095-011,1080,385,1,384,-1,1,383
Listas,2014EP,17-095-012,749,286,0,286,0,2,284
Listas,2014EP,17-095-013,560,161,0,161,0,0,161
Listas,2014EP,17-095-014,523,159,0,159,0,1,158
Listas,2014EP,17-095-015,605,192,0,192,0,2,190
Listas,2014EP,17-095-016,528,205,0,205,0,1,204
Listas,2014EP,17-095-017,629,196,1,194,-2,0,194
Listas,2014EP,17-095-018,637,245,0,245,0,0,245
Listas,2014EP,17-095-019,807,351,0,351,0,0,351
Listas,2014EP,17-095-020,793,251,0,251,0,0,251
Listas,2014EP,17-095-021,594,285,0,285,0,3,282
Listas,2014EP,17-095-022,566,222,0,222,0,2,220
Listas,2014EP,17-095-023,636,213,0,213,0,0,213
Listas,2014EP,17-095-024,564,194,0,194,0,0,194
Listas,2014EP,17-095-025,614,245,0,245,0,2,243
Listas,2014EP,17-095-026,689,207,0,207,0,1,206
Listas,2014EP,17-095-027,690,216,0,216,0,0,216
Listas,2014EP,17-095-028,648,188,0,188,0,2,186
Listas,2014EP,17-095-029,693,181,0,181,0,2,179
Listas,2014EP,17-095-030,846,225,0,225,0,2,223
Listas,2014EP,17-095-031,662,227,0,227,0,0,227
Listas,2014EP,17-095-032,766,180,0,180,0,1,179
Listas,2014EP,17-095-033,721,217,0,217,0,1,216
Listas,2014EP,17-095-034,831,249,0,249,0,0,249
Listas,2014EP,17-095-035,727,194,0,194,0,1,193
Listas,2014EP,17-095-036,859,300,0,300,0,0,300
Listas,2014EP,17-095-037,929,257,0,257,0,0,257
Listas,2014EP,17-095-038,940,329,0,329,0,1,328
Listas,2014EP,17-095-039,992,262,0,262,0,1,261
Listas,2014EP,17-096-001,268,49,0,49,0,0,49
Listas,2014EP,17-096-002,927,239,0,239,0,1,238
Listas,2014EP,17-096-003,986,226,0,226,0,0,226
Listas,2014EP,17-096-004,930,248,0,248,0,2,246
Listas,2014EP,17-096-005,1080,239,0,239,0,5,234
Listas,2014EP,17-096-006,874,221,0,221,0,0,221
Listas,2014EP,17-096-007,312,45,0,45,0,0,45
Listas,2014EP,17-096-008,1003,360,0,360,0,2,358
Listas,2014EP,17-096-009,622,126,0,126,0,0,126
Listas,2014EP,17-097-001,719,195,0,195,0,1,194
Listas,2014EP,17-097-002,283,53,0,53,0,1,52
Listas,2014EP,17-097-003,238,26,0,26,0,0,26
Listas,2014EP,17-097-004,647,117,0,117,0,0,117
Listas,2014EP,17-098-001,611,119,0,119,0,0,119
Listas,2014EP,17-098-002,584,138,0,138,0,1,137
Listas,2014EP,17-099-001,1180,264,0,264,0,5,259
Listas,2014EP,17-099-002,800,230,0,230,0,0,230
Listas,2014EP,17-099-003,625,153,0,153,0,0,153
Listas,2014EP,17-099-004,960,232,0,232,0,0,232
Listas,2014EP,17-099-005,690,156,0,156,0,0,156
Listas,2014EP,17-099-006,646,150,0,150,0,0,150
Listas,2014EP,17-099-007,790,179,0,179,0,5,174
Listas,2014EP,17-099-008,618,130,0,130,0,1,129
Listas,2014EP,17-099-009,797,219,0,219,0,1,218
Listas,2014EP,17-099-010,656,145,0,145,0,0,145
Listas,2014EP,17-099-011,643,162,0,162,0,1,161
Listas,2014EP,17-099-012,620,110,0,110,0,0,110
Listas,2014EP,17-099-013,631,140,0,139,-1,2,137
Listas,2014EP,17-100-001,882,201,0,201,0,3,198
Listas,2014EP,17-101-001,286,65,0,65,0,0,65
Listas,2014EP,17-102-001,236,61,0,61,0,1,60
Listas,2014EP,17-103-001,314,103,0,103,0,0,103
Listas,2014EP,17-104-001,709,154,0,153,-1,1,152
Listas,2014EP,17-105-001,1037,287,0,287,0,3,284
Listas,2014EP,17-106-001,136,46,0,46,0,0,46
Listas,2014EP,17-107-001,242,100,0,100,0,0,100
Listas,2014EP,17-108-001,656,170,0,169,-1,1,168
Listas,2014EP,17-108-002,517,148,0,148,0,0,148
Listas,2014EP,17-108-003,516,146,0,146,0,1,145
Listas,2014EP,17-108-004,99,33,0,33,0,0,33
Listas,2014EP,17-109-001,513,136,0,136,0,2,134
Listas,2014EP,18-001-001,526,138,0,138,0,2,136
Listas,2014EP,18-002-001,307,90,0,90,0,0,90
Listas,2014EP,18-003-001,493,166,0,166,0,1,165
Listas,2014EP,18-004-001,205,52,0,52,0,0,52
Listas,2014EP,18-005-001,344,106,0,106,0,0,106
Listas,2014EP,18-006-001,432,151,0,151,0,0,151
Listas,2014EP,18-007-001,973,295,0,295,0,2,293
Listas,2014EP,18-008-001,388,120,0,120,0,0,120
Listas,2014EP,18-009-001,408,74,0,74,0,0,74
Listas,2014EP,18-010-001,698,206,0,206,0,0,206
Listas,2014EP,18-011-001,118,39,0,39,0,0,39
Listas,2014EP,18-012-001,304,135,0,135,0,0,135
Listas,2014EP,18-013-001,262,58,0,58,0,0,58
Listas,2014EP,18-014-001,317,99,0,99,0,0,99
Listas,2014EP,18-015-001,260,63,0,63,0,0,63
Listas,2014EP,18-016-001,527,227,0,227,0,2,225
Listas,2014EP,18-017-001,488,179,0,179,0,1,178
Listas,2014EP,18-018-001,867,214,0,214,0,0,214
Listas,2014EP,18-018-002,925,300,0,300,0,1,299
Listas,2014EP,18-018-003,951,267,0,267,0,2,265
Listas,2014EP,18-019-001,225,90,0,90,0,0,90
Listas,2014EP,18-020-001,1132,315,0,315,0,0,315
Listas,2014EP,18-020-002,1089,400,0,400,0,1,399
Listas,2014EP,18-020-003,1128,345,0,345,0,0,345
Listas,2014EP,18-020-004,1119,353,0,353,0,3,350
Listas,2014EP,18-020-005,1094,344,0,344,0,2,342
Listas,2014EP,18-020-006,1115,290,0,289,-1,0,289
Listas,2014EP,18-020-007,964,182,0,182,0,0,182
Listas,2014EP,18-020-008,1233,303,0,303,0,1,302
Listas,2014EP,18-020-009,291,84,0,84,0,1,83
Listas,2014EP,18-021-001,156,76,0,76,0,1,75
Listas,2014EP,18-022-001,541,132,0,132,0,0,132
Listas,2014EP,18-022-002,706,178,0,178,0,1,177
Listas,2014EP,18-023-001,308,142,0,142,0,0,142
Listas,2014EP,18-024-001,206,102,0,102,0,1,101
Listas,2014EP,18-025-001,291,89,1,88,-1,0,88
Listas,2014EP,18-026-001,251,76,0,76,0,1,75
Listas,2014EP,18-027-001,1016,258,0,258,0,1,257
Listas,2014EP,18-027-002,874,223,0,223,0,3,220
Listas,2014EP,18-027-003,746,244,0,244,0,1,243
Listas,2014EP,18-028-001,530,119,0,119,0,1,118
Listas,2014EP,18-029-001,293,92,0,92,0,0,92
Listas,2014EP,18-030-001,327,96,0,96,0,0,96
Listas,2014EP,18-031-001,716,206,0,206,0,2,204
Listas,2014EP,18-032-001,87,34,0,34,0,0,34
Listas,2014EP,18-033-001,174,81,0,81,0,0,81
Listas,2014EP,18-034-001,129,53,0,53,0,0,53
Listas,2014EP,18-035-001,84,52,0,52,0,0,52
Listas,2014EP,18-036-001,221,66,0,66,0,0,66
Listas,2014EP,18-037-001,304,74,0,74,0,1,73
Listas,2014EP,18-038-001,303,79,0,79,0,0,79
Listas,2014EP,18-039-001,482,133,0,133,0,1,132
Listas,2014EP,18-040-001,1072,360,0,360,0,1,359
Listas,2014EP,18-041-001,378,111,0,111,0,0,111
Listas,2014EP,18-042-001,171,72,0,72,0,0,72
Listas,2014EP,18-043-001,216,92,0,92,0,0,92
Listas,2014EP,18-044-001,483,170,0,170,0,2,168
Listas,2014EP,18-045-001,366,123,0,123,0,2,121
Listas,2014EP,18-046-001,1078,373,0,373,0,0,373
Listas,2014EP,18-046-002,1114,385,0,385,0,1,384
Listas,2014EP,18-047-001,555,132,0,132,0,2,130
Listas,2014EP,18-048-001,935,215,0,215,0,3,212
Listas,2014EP,18-049-001,229,96,0,96,0,0,96
Listas,2014EP,18-050-001,124,47,0,47,0,1,46
Listas,2014EP,18-051-001,888,296,0,296,0,1,295
Listas,2014EP,18-052-001,538,126,0,126,0,0,126
Listas,2014EP,18-053-001,84,35,0,35,0,0,35
Listas,2014EP,18-054-001,227,86,0,86,0,0,86
Listas,2014EP,18-055-001,125,74,0,74,0,1,73
Listas,2014EP,18-056-001,650,225,0,225,0,3,222
Listas,2014EP,18-057-001,140,51,0,51,0,0,51
Listas,2014EP,18-058-001,123,59,0,59,0,0,59
Listas,2014EP,18-059-001,247,73,0,73,0,0,73
Listas,2014EP,18-060-001,56,41,0,41,0,0,41
Listas,2014EP,18-061-001,124,52,0,52,0,0,52
Listas,2014EP,18-062-001,159,90,0,90,0,1,89
Listas,2014EP,18-063-001,661,228,0,228,0,1,227
Listas,2014EP,18-064-001,608,143,0,143,0,0,143
Listas,2014EP,18-065-001,783,218,0,218,0,0,218
Listas,2014EP,18-065-002,677,158,0,158,0,2,156
Listas,2014EP,18-066-001,36,20,0,20,0,0,20
Listas,2014EP,18-067-001,97,58,0,58,0,0,58
Listas,2014EP,18-068-001,417,130,0,130,0,0,130
Listas,2014EP,18-069-001,1097,220,0,220,0,1,219
Listas,2014EP,18-069-002,938,186,0,186,0,0,186
Listas,2014EP,18-070-001,451,111,0,111,0,2,109
Listas,2014EP,18-071-001,724,144,0,144,0,0,144
Listas,2014EP,18-071-002,647,150,0,150,0,1,149
Listas,2014EP,18-071-003,742,152,0,152,0,0,152
Listas,2014EP,18-072-001,174,52,0,52,0,0,52
Listas,2014EP,18-073-001,295,105,0,105,0,1,104
Listas,2014EP,18-074-001,915,201,0,201,0,2,199
Listas,2014EP,18-075-001,365,107,0,107,0,1,106
Listas,2014EP,18-076-001,70,20,0,20,0,0,20
Listas,2014EP,18-077-001,79,35,0,35,0,0,35
Listas,2014EP,18-078-001,746,166,0,166,0,1,165
Listas,2014EP,18-079-001,444,92,0,92,0,2,90
Listas,2014EP,18-080-001,348,92,0,92,0,0,92
Listas,2014EP,18-081-001,494,112,0,112,0,0,112
Listas,2014EP,18-082-001,171,48,0,48,0,1,47
Listas,2014EP,18-083-001,186,86,0,86,0,0,86
Listas,2014EP,18-084-001,224,62,0,62,0,0,62
Listas,2014EP,18-085-001,740,220,0,220,0,0,220
Listas,2014EP,18-086-001,194,85,0,85,0,0,85
Listas,2014EP,18-087-001,72,43,0,43,0,0,43
Listas,2014EP,18-088-001,106,52,0,52,0,0,52
Listas,2014EP,18-089-001,195,92,0,92,0,0,92
Listas,2014EP,18-090-001,190,56,0,56,0,0,56
Listas,2014EP,18-091-001,366,115,0,115,0,0,115
Listas,2014EP,18-092-001,75,31,0,31,0,0,31
Listas,2014EP,18-093-001,470,180,0,180,0,4,176
Listas,2014EP,18-094-001,220,58,0,58,0,0,58
Listas,2014EP,18-095-001,1005,349,0,349,0,0,349
Listas,2014EP,18-095-002,1103,282,0,281,-1,1,280
Listas,2014EP,18-095-003,1205,378,0,378,0,0,378
Listas,2014EP,18-095-004,1277,454,0,453,-1,3,450
Listas,2014EP,18-095-005,1327,421,0,421,0,2,419
Listas,2014EP,18-095-006,1233,437,0,436,-1,1,435
Listas,2014EP,18-095-007,1165,387,0,387,0,5,382
Listas,2014EP,18-095-008,366,96,0,96,0,2,94
Listas,2014EP,18-095-009,754,268,0,268,0,1,267
Listas,2014EP,18-095-010,150,73,0,73,0,0,73
Listas,2014EP,18-096-001,1107,300,1,299,-1,0,299
Listas,2014EP,18-096-002,1196,405,0,405,0,0,405
Listas,2014EP,18-096-003,1130,338,0,338,0,0,338
Listas,2014EP,18-096-004,1118,328,0,328,0,1,327
Listas,2014EP,18-096-005,1194,368,0,368,0,6,362
Listas,2014EP,18-096-006,1265,436,0,436,0,2,434
Listas,2014EP,18-096-007,1139,305,0,305,0,1,304
Listas,2014EP,18-096-008,615,191,0,191,0,0,191
Listas,2014EP,18-096-009,427,189,0,189,0,0,189
Listas,2014EP,18-097-001,214,90,0,90,0,0,90
Listas,2014EP,18-098-001,167,55,0,55,0,1,54
Listas,2014EP,18-099-001,408,153,0,153,0,0,153
Listas,2014EP,18-100-001,102,43,0,43,0,0,43
Listas,2014EP,18-101-001,887,282,0,282,0,0,282
Listas,2014EP,18-102-001,625,202,0,202,0,1,201
Listas,2014EP,18-103-001,185,79,0,79,0,0,79
Listas,2014EP,18-104-001,383,112,0,112,0,0,112
Listas,2014EP,18-105-001,221,75,0,75,0,0,75
Listas,2014EP,18-106-001,547,111,0,111,0,1,110
Listas,2014EP,18-107-001,252,91,0,91,0,2,89
Listas,2014EP,18-108-001,497,168,0,168,0,1,167
Listas,2014EP,18-109-001,137,50,0,50,0,1,49
Listas,2014EP,18-110-001,211,51,0,51,0,0,51
Listas,2014EP,18-111-001,181,98,0,98,0,0,98
Listas,2014EP,18-112-001,279,72,0,72,0,0,72
Listas,2014EP,18-113-001,340,97,0,97,0,0,97
Listas,2014EP,18-114-001,250,65,0,65,0,0,65
Listas,2014EP,18-115-001,122,44,0,44,0,2,42
Listas,2014EP,18-116-001,104,56,0,56,0,0,56
Listas,2014EP,18-117-001,236,74,0,74,0,0,74
Listas,2014EP,18-118-001,825,209,0,209,0,1,208
Listas,2014EP,18-119-001,104,24,0,24,0,0,24
Listas,2014EP,18-120-001,403,145,0,145,0,2,143
Listas,2014EP,18-121-001,1090,290,0,290,0,1,289
Listas,2014EP,18-122-001,997,258,0,258,0,0,258
Listas,2014EP,18-123-001,542,165,0,165,0,1,164
Listas,2014EP,18-124-001,250,69,0,69,0,0,69
Listas,2014EP,18-125-001,242,70,0,70,0,0,70
Listas,2014EP,18-126-001,275,95,0,95,0,1,94
Listas,2014EP,18-127-001,300,113,0,113,0,2,111
Listas,2014EP,18-128-001,110,29,0,29,0,0,29
Listas,2014EP,18-129-001,17,8,0,8,0,0,8
Listas,2014EP,18-130-001,233,58,0,58,0,0,58
Listas,2014EP,18-131-001,448,146,0,146,0,0,146
Listas,2014EP,18-132-001,260,88,0,88,0,1,87
Listas,2014EP,18-133-001,313,84,0,84,0,0,84
Listas,2014EP,18-134-001,65,30,0,30,0,0,30
Listas,2014EP,18-135-001,685,171,0,171,0,0,171
Listas,2014EP,18-136-001,545,129,0,129,0,0,129
Listas,2014EP,18-137-001,90,45,0,45,0,0,45
Listas,2014EP,18-138-001,634,127,0,127,0,0,127
Listas,2014EP,18-139-001,195,80,0,80,0,1,79
Listas,2014EP,18-140-001,1006,358,0,358,0,1,357
Listas,2014EP,18-141-001,367,120,0,120,0,3,117
Listas,2014EP,18-142-001,242,89,0,89,0,0,89
Listas,2014EP,18-143-001,259,109,0,109,0,2,107
Listas,2014EP,18-144-001,665,158,0,158,0,1,157
Listas,2014EP,18-145-001,575,195,0,195,0,1,194
Listas,2014EP,18-146-001,435,194,0,194,0,0,194
Listas,2014EP,18-147-001,182,62,0,62,0,0,62
Listas,2014EP,18-148-001,135,58,0,58,0,0,58
Listas,2014EP,18-149-001,305,127,0,127,0,2,125
Listas,2014EP,18-150-001,117,31,0,31,0,2,29
Listas,2014EP,18-151-001,238,99,0,99,0,1,98
Listas,2014EP,18-152-001,126,50,0,50,0,1,49
Listas,2014EP,18-153-001,731,283,0,283,0,2,281
Listas,2014EP,18-154-001,651,198,0,198,0,1,197
Listas,2014EP,18-155-001,822,183,0,183,0,0,183
Listas,2014EP,18-156-001,723,162,0,162,0,1,161
Listas,2014EP,18-156-002,654,127,0,127,0,0,127
Listas,2014EP,18-157-001,203,89,0,89,0,0,89
Listas,2014EP,18-158-001,230,79,0,79,0,0,79
Listas,2014EP,18-159-001,202,72,0,72,0,0,72
Listas,2014EP,18-160-001,676,212,0,212,0,0,212
Listas,2014EP,18-160-002,887,271,0,271,0,0,271
Listas,2014EP,18-160-003,728,219,0,219,0,0,219
Listas,2014EP,18-161-001,87,43,0,43,0,0,43
Listas,2014EP,18-162-001,355,76,0,76,0,0,76
Listas,2014EP,18-163-001,913,218,0,218,0,0,218
Listas,2014EP,18-164-001,235,97,0,97,0,0,97
Listas,2014EP,18-165-001,399,130,0,130,0,0,130
Listas,2014EP,18-166-001,83,42,0,42,0,0,42
Listas,2014EP,18-167-001,861,245,0,245,0,2,243
Listas,2014EP,18-167-002,563,153,0,153,0,0,153
Listas,2014EP,18-167-003,645,167,0,167,0,1,166
Listas,2014EP,18-167-004,694,161,0,161,0,0,161
Listas,2014EP,18-167-005,43,22,0,22,0,0,22
Listas,2014EP,18-167-006,678,193,0,193,0,1,192
Listas,2014EP,18-167-007,681,207,0,207,0,0,207
Listas,2014EP,18-167-008,859,245,0,245,0,4,241
Listas,2014EP,18-167-009,751,173,0,173,0,0,173
Listas,2014EP,18-167-010,930,302,0,301,-1,0,301
Listas,2014EP,18-167-011,684,167,0,167,0,0,167
Listas,2014EP,18-167-012,906,327,0,327,0,0,327
Listas,2014EP,18-167-013,795,205,1,205,0,0,205
Listas,2014EP,18-167-014,768,204,0,204,0,2,202
Listas,2014EP,18-167-015,909,204,0,204,0,0,204
Listas,2014EP,18-167-016,1141,324,0,324,0,1,323
Listas,2014EP,18-167-017,444,128,0,128,0,0,128
Listas,2014EP,18-167-018,120,36,0,36,0,0,36
Listas,2014EP,18-168-001,1103,310,0,310,0,0,310
Listas,2014EP,18-169-001,466,134,0,134,0,1,133
Listas,2014EP,18-170-001,574,133,0,133,0,0,133
Listas,2014EP,18-171-001,316,88,0,88,0,0,88
Listas,2014EP,18-171-002,121,41,0,41,0,1,40
Listas,2014EP,18-171-003,89,31,0,31,0,0,31
Listas,2014EP,18-172-001,220,72,0,72,0,1,71
Listas,2014EP,18-173-001,671,146,0,146,0,2,144
Listas,2014EP,18-174-001,521,161,0,161,0,0,161
Listas,2014EP,18-175-001,680,165,0,165,0,0,165
Listas,2014EP,18-176-001,44,32,0,32,0,0,32
Listas,2014EP,18-177-001,290,108,0,108,0,1,107
Listas,2014EP,18-178-001,185,69,0,69,0,0,69
Listas,2014EP,18-179-001,187,91,0,91,0,0,91
Listas,2014EP,18-180-001,75,46,0,46,0,0,46
Listas,2014EP,18-181-001,557,127,0,127,0,0,127
Listas,2014EP,18-182-001,261,59,0,59,0,0,59
Listas,2014EP,18-183-001,734,184,0,184,0,0,184
Listas,2014EP,18-183-002,591,150,0,150,0,0,150
Listas,2014EP,18-183-003,695,183,0,183,0,0,183
Listas,2014EP,18-183-004,750,274,0,274,0,0,274
Listas,2014EP,18-183-005,703,207,0,207,0,0,207
Listas,2014EP,18-183-006,654,211,0,211,0,0,211
Listas,2014EP,18-183-007,660,237,0,237,0,0,237
Listas,2014EP,18-183-008,373,99,0,99,0,0,99
Listas,2014EP,18-183-009,695,255,0,255,0,3,252
Listas,2014EP,18-183-010,214,77,0,77,0,2,75
Listas,2014EP,18-183-011,325,94,0,94,0,2,92
Listas,2014EP,18-183-012,288,98,0,98,0,0,98
Listas,2014EP,18-183-013,65,33,0,33,0,0,33
Listas,2014EP,18-184-001,835,305,0,305,0,0,305
Listas,2014EP,18-185-001,291,97,0,97,0,0,97
Listas,2014EP,18-186-001,865,365,0,365,0,0,365
Listas,2014EP,18-186-002,867,341,0,341,0,0,341
Listas,2014EP,18-186-003,955,377,1,376,-1,2,374
Listas,2014EP,18-186-004,917,368,0,368,0,1,367
Listas,2014EP,18-186-005,874,334,0,334,0,4,330
Listas,2014EP,18-186-006,1070,295,0,295,0,0,295
Listas,2014EP,18-186-007,1111,377,0,377,0,0,377
Listas,2014EP,18-186-008,889,276,0,276,0,0,276
Listas,2014EP,18-186-009,711,242,0,242,0,0,242
Listas,2014EP,18-186-010,734,210,0,210,0,0,210
Listas,2014EP,18-186-011,902,225,0,225,0,0,225
Listas,2014EP,18-186-012,959,227,0,227,0,0,227
Listas,2014EP,18-186-013,890,205,0,205,0,0,205
Listas,2014EP,18-186-014,932,194,0,194,0,1,193
Listas,2014EP,18-186-015,955,232,0,232,0,0,232
Listas,2014EP,18-186-016,880,309,0,309,0,1,308
Listas,2014EP,18-186-017,862,308,0,308,0,3,305
Listas,2014EP,18-186-018,966,275,0,275,0,4,271
Listas,2014EP,18-186-019,952,214,0,214,0,0,214
Listas,2014EP,18-186-020,930,253,0,253,0,0,253
Listas,2014EP,18-186-021,939,235,0,235,0,0,235
Listas,2014EP,18-186-022,906,259,0,259,0,0,259
Listas,2014EP,18-186-023,937,298,0,298,0,1,297
Listas,2014EP,18-186-024,852,291,1,292,1,8,284
Listas,2014EP,18-186-025,863,260,0,260,0,1,259
Listas,2014EP,18-186-026,1046,362,0,362,0,1,361
Listas,2014EP,18-186-027,879,358,0,358,0,1,357
Listas,2014EP,18-186-028,698,229,0,229,0,0,229
Listas,2014EP,18-186-029,850,337,0,337,0,2,335
Listas,2014EP,18-186-030,1029,402,0,402,0,0,402
Listas,2014EP,18-186-031,761,200,0,200,0,1,199
Listas,2014EP,18-186-032,774,240,0,240,0,3,237
Listas,2014EP,18-186-033,1023,254,0,254,0,0,254
Listas,2014EP,18-186-034,950,303,0,303,0,0,303
Listas,2014EP,18-186-035,994,298,0,298,0,0,298
Listas,2014EP,18-186-036,1018,316,0,316,0,1,315
Listas,2014EP,18-186-037,723,303,0,303,0,0,303
Listas,2014EP,18-186-038,1109,423,0,423,0,0,423
Listas,2014EP,18-186-039,975,290,0,290,0,3,287
Listas,2014EP,18-186-040,1132,567,0,567,0,0,567
Listas,2014EP,18-186-041,918,262,0,262,0,0,262
Listas,2014EP,18-186-042,903,226,0,226,0,0,226
Listas,2014EP,18-186-043,928,279,0,279,0,0,279
Listas,2014EP,18-186-044,970,301,0,301,0,0,301
Listas,2014EP,18-186-045,943,351,0,351,0,0,351
Listas,2014EP,18-186-046,802,269,0,269,0,1,268
Listas,2014EP,18-186-047,1087,354,0,354,0,6,348
Listas,2014EP,18-186-048,934,338,1,337,-1,2,335
Listas,2014EP,18-186-049,926,263,0,263,0,0,263
Listas,2014EP,18-186-050,721,210,0,210,0,0,210
Listas,2014EP,18-186-051,1126,416,0,416,0,0,416
Listas,2014EP,18-186-052,1314,526,0,526,0,8,518
Listas,2014EP,18-186-053,979,298,0,298,0,0,298
Listas,2014EP,18-186-054,985,326,0,326,0,0,326
Listas,2014EP,18-186-055,1090,390,0,388,-2,1,387
Listas,2014EP,18-186-056,921,284,0,284,0,2,282
Listas,2014EP,18-186-057,740,276,0,276,0,1,275
Listas,2014EP,18-186-058,633,186,0,186,0,0,186
Listas,2014EP,18-186-059,446,115,0,115,0,0,115
Listas,2014EP,18-186-060,740,242,0,242,0,1,241
Listas,2014EP,18-186-061,1025,346,0,346,0,1,345
Listas,2014EP,18-186-062,970,292,0,292,0,1,291
Listas,2014EP,18-186-063,845,290,0,290,0,0,290
Listas,2014EP,18-186-064,1028,296,0,296,0,0,296
Listas,2014EP,18-186-065,622,226,0,226,0,2,224
Listas,2014EP,18-186-066,1120,408,0,408,0,0,408
Listas,2014EP,18-186-067,1048,301,0,301,0,1,300
Listas,2014EP,18-186-068,1073,340,0,340,0,4,336
Listas,2014EP,18-186-069,654,218,0,218,0,0,218
Listas,2014EP,18-186-070,595,198,0,198,0,1,197
Listas,2014EP,18-187-001,303,114,0,114,0,1,113
Listas,2014EP,18-188-001,599,193,0,193,0,2,191
Listas,2014EP,18-189-001,1081,312,0,312,0,2,310
Listas,2014EP,18-189-002,1008,255,0,255,0,0,255
Listas,2014EP,18-190-001,415,94,0,94,0,1,93
Listas,2014EP,18-191-001,282,90,0,90,0,0,90
Listas,2014EP,18-192-001,266,76,0,76,0,2,74
Listas,2014EP,18-193-001,281,77,0,77,0,0,77
Listas,2014EP,18-194-001,812,207,0,207,0,1,206
Listas,2014EP,18-194-002,733,92,0,92,0,0,92
Listas,2014EP,18-195-001,232,92,0,92,0,0,92
Listas,2014EP,18-196-001,408,97,0,97,0,0,97
Listas,2014EP,18-196-002,318,61,0,61,0,0,61
Listas,2014EP,18-197-001,287,99,0,99,0,2,97
Listas,2014EP,18-198-001,318,137,0,137,0,1,136
Listas,2014EP,18-199-001,330,120,0,120,0,3,117
Listas,2014EP,18-200-001,327,117,0,117,0,0,117
Listas,2014EP,18-201-001,290,128,0,128,0,0,128
Listas,2014EP,18-202-001,686,147,0,147,0,1,146
Listas,2014EP,18-203-001,294,102,0,102,0,0,102
Listas,2014EP,18-204-001,472,131,0,131,0,1,130
Listas,2014EP,18-204-002,654,157,0,157,0,0,157
Listas,2014EP,18-205-001,335,84,0,84,0,0,84
Listas,2014EP,18-206-001,690,217,0,217,0,3,214
Listas,2014EP,18-206-002,701,159,0,159,0,1,158
Listas,2014EP,18-206-003,706,173,0,173,0,0,173
Listas,2014EP,18-206-004,734,207,0,207,0,1,206
Listas,2014EP,18-206-005,758,253,0,253,0,0,253
Listas,2014EP,18-206-006,89,37,0,37,0,0,37
Listas,2014EP,18-206-007,55,36,0,36,0,0,36
Listas,2014EP,18-207-001,276,95,0,95,0,1,94
Listas,2014EP,18-208-001,285,115,0,115,0,0,115
Listas,2014EP,18-209-001,564,116,0,116,0,0,116
Listas,2014EP,18-210-001,282,138,0,138,0,3,135
Listas,2014EP,18-211-001,64,36,0,36,0,0,36
Listas,2014EP,18-212-001,769,115,0,115,0,0,115
Listas,2014EP,18-212-002,680,153,0,153,0,0,153
Listas,2014EP,18-212-003,729,169,0,169,0,1,168
Listas,2014EP,18-212-004,621,167,0,167,0,1,166
Listas,2014EP,18-213-001,231,73,0,73,0,1,72
Listas,2014EP,18-214-001,625,167,0,167,0,0,167
Listas,2014EP,18-215-001,90,46,0,46,0,0,46
Listas,2014EP,18-216-001,163,54,0,54,0,0,54
Listas,2014EP,19-001-001,722,156,0,156,0,0,156
Listas,2014EP,19-002-001,313,61,0,61,0,0,61
Listas,2014EP,19-003-001,991,251,0,251,0,0,251
Listas,2014EP,19-003-002,928,274,0,273,-1,0,273
Listas,2014EP,19-003-003,780,214,0,214,0,1,213
Listas,2014EP,19-003-004,1138,365,0,365,0,0,365
Listas,2014EP,19-003-005,835,242,0,242,0,1,241
Listas,2014EP,19-003-006,903,248,0,248,0,3,245
Listas,2014EP,19-003-007,711,192,0,192,0,0,192
Listas,2014EP,19-003-008,944,242,0,242,0,0,242
Listas,2014EP,19-003-009,1038,206,0,206,0,1,205
Listas,2014EP,19-003-010,863,239,0,239,0,0,239
Listas,2014EP,19-003-011,820,266,0,266,0,0,266
Listas,2014EP,19-003-012,1122,259,0,259,0,0,259
Listas,2014EP,19-003-013,711,160,0,160,0,0,160
Listas,2014EP,19-003-014,1036,205,0,205,0,0,205
Listas,2014EP,19-003-015,868,243,0,243,0,0,243
Listas,2014EP,19-003-016,844,236,0,236,0,0,236
Listas,2014EP,19-003-017,614,178,0,178,0,2,176
Listas,2014EP,19-003-018,981,274,0,274,0,2,272
Listas,2014EP,19-003-019,883,229,0,229,0,0,229
Listas,2014EP,19-003-020,768,259,0,259,0,2,257
Listas,2014EP,19-003-021,773,167,0,167,0,0,167
Listas,2014EP,19-003-022,1007,256,0,255,-1,0,255
Listas,2014EP,19-003-023,853,207,0,207,0,0,207
Listas,2014EP,19-003-024,454,76,0,76,0,0,76
Listas,2014EP,19-003-025,841,320,0,320,0,1,319
Listas,2014EP,19-003-026,946,306,0,306,0,2,304
Listas,2014EP,19-003-027,838,159,0,159,0,0,159
Listas,2014EP,19-003-028,624,110,0,110,0,0,110
Listas,2014EP,19-003-029,976,227,0,227,0,0,227
Listas,2014EP,19-004-001,916,431,0,431,0,0,431
Listas,2014EP,19-004-002,639,292,0,292,0,1,291
Listas,2014EP,19-005-001,146,33,0,33,0,0,33
Listas,2014EP,19-006-001,370,179,0,179,0,0,179
Listas,2014EP,19-007-001,566,302,0,302,0,1,301
Listas,2014EP,19-008-001,818,287,0,287,0,2,285
Listas,2014EP,19-008-002,603,221,0,221,0,0,221
Listas,2014EP,19-008-003,641,129,0,129,0,0,129
Listas,2014EP,19-009-001,817,259,0,259,0,2,257
Listas,2014EP,19-010-001,1065,313,0,313,0,0,313
Listas,2014EP,19-011-001,569,221,0,221,0,1,220
Listas,2014EP,19-012-001,189,62,0,62,0,0,62
Listas,2014EP,19-013-001,824,165,0,165,0,2,163
Listas,2014EP,19-014-001,378,120,0,120,0,1,119
Listas,2014EP,19-015-001,328,83,0,83,0,1,82
Listas,2014EP,19-016-001,57,25,0,25,0,0,25
Listas,2014EP,19-017-001,189,58,0,58,0,0,58
Listas,2014EP,19-018-001,714,177,0,177,0,1,176
Listas,2014EP,19-019-001,280,117,0,117,0,0,117
Listas,2014EP,19-020-001,534,123,0,123,0,0,123
Listas,2014EP,19-021-001,666,283,0,283,0,0,283
Listas,2014EP,19-022-001,928,274,0,274,0,0,274
Listas,2014EP,19-022-002,931,365,0,365,0,5,360
Listas,2014EP,19-022-003,926,375,0,375,0,0,375
Listas,2014EP,19-022-004,1253,685,0,685,0,2,683
Listas,2014EP,19-022-005,951,334,0,334,0,0,334
Listas,2014EP,19-022-006,1037,289,0,289,0,1,288
Listas,2014EP,19-022-007,1046,351,0,350,-1,1,349
Listas,2014EP,19-022-008,1010,342,0,342,0,0,342
Listas,2014EP,19-023-001,193,81,0,81,0,0,81
Listas,2014EP,19-024-001,917,269,0,269,0,2,267
Listas,2014EP,19-025-001,1119,253,0,253,0,4,249
Listas,2014EP,19-026-001,1377,472,0,472,0,1,471
Listas,2014EP,19-026-002,1406,302,0,302,0,1,301
Listas,2014EP,19-026-003,1390,386,0,386,0,2,384
Listas,2014EP,19-026-004,1444,360,0,360,0,0,360
Listas,2014EP,19-026-005,1922,874,0,874,0,2,872
Listas,2014EP,19-026-006,1417,459,0,459,0,2,457
Listas,2014EP,19-026-007,1426,514,0,514,0,2,512
Listas,2014EP,19-026-008,1437,543,0,543,0,1,542
Listas,2014EP,19-027-001,896,362,0,362,0,0,362
Listas,2014EP,19-027-002,771,263,0,263,0,2,261
Listas,2014EP,19-027-003,712,234,0,234,0,2,232
Listas,2014EP,19-027-004,768,184,0,184,0,0,184
Listas,2014EP,19-027-005,708,286,0,286,0,0,286
Listas,2014EP,19-028-001,109,39,0,39,0,0,39
Listas,2014EP,19-029-001,801,259,0,259,0,2,257
Listas,2014EP,19-029-002,725,200,0,200,0,1,199
Listas,2014EP,19-029-003,958,508,0,507,-1,1,506
Listas,2014EP,19-029-004,723,253,0,253,0,1,252
Listas,2014EP,19-030-001,149,88,0,88,0,0,88
Listas,2014EP,19-031-001,475,247,0,247,0,1,246
Listas,2014EP,19-032-001,509,109,0,109,0,1,108
Listas,2014EP,19-033-001,385,196,0,196,0,1,195
Listas,2014EP,19-035-001,123,58,0,58,0,0,58
Listas,2014EP,19-036-001,354,79,0,79,0,0,79
Listas,2014EP,19-037-001,556,206,0,206,0,5,201
Listas,2014EP,19-038-001,836,119,0,119,0,0,119
Listas,2014EP,19-038-002,818,121,0,121,0,1,120
Listas,2014EP,19-038-003,865,129,0,129,0,1,128
Listas,2014EP,19-038-004,935,184,0,184,0,1,183
Listas,2014EP,19-038-005,634,127,0,127,0,0,127
Listas,2014EP,19-038-006,616,162,0,162,0,4,158
Listas,2014EP,19-039-001,204,74,0,74,0,1,73
Listas,2014EP,19-040-001,171,60,0,60,0,1,59
Listas,2014EP,19-041-001,87,22,0,22,0,0,22
Listas,2014EP,19-042-001,313,110,0,110,0,1,109
Listas,2014EP,19-043-001,609,150,0,150,0,3,147
Listas,2014EP,19-044-001,673,126,0,126,0,1,125
Listas,2014EP,19-044-002,675,102,0,102,0,1,101
Listas,2014EP,19-044-003,736,104,0,104,0,0,104
Listas,2014EP,19-044-004,287,29,0,29,0,0,29
Listas,2014EP,19-044-005,56,42,0,42,0,0,42
Listas,2014EP,19-045-001,698,136,0,136,0,1,135
Listas,2014EP,19-046-001,240,66,0,66,0,1,65
Listas,2014EP,19-047-001,430,110,0,110,0,1,109
Listas,2014EP,19-048-001,750,178,0,178,0,0,178
Listas,2014EP,19-048-002,755,133,0,133,0,1,132
Listas,2014EP,19-049-001,897,396,0,396,0,1,395
Listas,2014EP,19-049-002,915,348,0,348,0,0,348
Listas,2014EP,19-050-001,835,207,0,207,0,1,206
Listas,2014EP,19-051-001,542,135,0,135,0,1,134
Listas,2014EP,19-052-001,391,76,0,76,0,0,76
Listas,2014EP,19-053-001,298,54,0,54,0,1,53
Listas,2014EP,19-054-001,342,105,0,105,0,1,104
Listas,2014EP,19-055-001,888,183,0,183,0,0,183
Listas,2014EP,19-055-002,977,208,0,208,0,3,205
Listas,2014EP,19-055-003,911,207,0,207,0,2,205
Listas,2014EP,19-055-004,923,213,0,213,0,3,210
Listas,2014EP,19-056-001,424,122,0,122,0,0,122
Listas,2014EP,19-057-001,206,79,0,79,0,0,79
Listas,2014EP,19-058-001,260,109,0,109,0,2,107
Listas,2014EP,19-059-001,677,157,0,157,0,0,157
Listas,2014EP,19-059-002,734,191,0,191,0,0,191
Listas,2014EP,19-060-001,195,72,0,72,0,1,71
Listas,2014EP,19-061-001,402,97,0,97,0,1,96
Listas,2014EP,19-062-001,451,121,0,121,0,0,121
Listas,2014EP,19-063-001,323,108,0,108,0,0,108
Listas,2014EP,19-064-001,1318,444,0,443,-1,2,441
Listas,2014EP,19-065-001,239,99,0,99,0,0,99
Listas,2014EP,19-066-001,347,75,0,75,0,1,74
Listas,2014EP,19-067-001,298,55,0,55,0,0,55
Listas,2014EP,19-068-001,646,126,2,124,-2,0,124
Listas,2014EP,19-069-001,282,65,0,65,0,0,65
Listas,2014EP,19-070-001,575,111,0,111,0,1,110
Listas,2014EP,19-071-001,935,210,0,210,0,1,209
Listas,2014EP,19-071-002,658,111,0,111,0,1,110
Listas,2014EP,19-071-003,831,90,0,90,0,3,87
Listas,2014EP,19-072-001,943,194,0,194,0,0,194
Listas,2014EP,19-073-001,569,185,0,185,0,0,185
Listas,2014EP,19-074-001,142,69,0,69,0,0,69
Listas,2014EP,19-075-001,243,84,0,84,0,0,84
Listas,2014EP,19-076-001,755,192,0,192,0,1,191
Listas,2014EP,19-076-002,711,217,0,217,0,0,217
Listas,2014EP,19-076-003,671,184,0,184,0,1,183
Listas,2014EP,19-076-004,753,138,0,138,0,0,138
Listas,2014EP,19-077-001,76,30,0,30,0,1,29
Listas,2014EP,19-078-001,357,87,0,87,0,0,87
Listas,2014EP,19-079-001,598,159,0,159,0,0,159
Listas,2014EP,19-080-001,65,36,0,36,0,0,36
Listas,2014EP,19-081-001,278,89,0,89,0,0,89
Listas,2014EP,19-082-001,628,174,0,174,0,1,173
Listas,2014EP,19-083-001,271,83,0,83,0,1,82
Listas,2014EP,19-084-001,311,83,0,83,0,0,83
Listas,2014EP,19-085-001,243,67,0,67,0,0,67
Listas,2014EP,19-086-001,684,114,0,114,0,0,114
Listas,2014EP,19-087-001,408,97,0,97,0,1,96
Listas,2014EP,19-088-001,388,110,0,110,0,0,110
Listas,2014EP,19-089-001,548,116,0,116,0,2,114
Listas,2014EP,19-090-001,534,127,0,127,0,0,127
Listas,2014EP,19-091-001,85,37,0,37,0,0,37
Listas,2014EP,19-092-001,406,84,0,84,0,0,84
Listas,2014EP,19-093-001,298,88,0,88,0,1,87
Listas,2014EP,19-094-001,83,46,0,46,0,0,46
Listas,2014EP,19-095-001,111,41,0,41,0,2,39
Listas,2014EP,19-096-001,1036,212,0,212,0,2,210
Listas,2014EP,19-097-001,79,36,0,36,0,1,35
Listas,2014EP,19-098-001,107,28,0,28,0,0,28
Listas,2014EP,19-099-001,600,131,0,131,0,0,131
Listas,2014EP,19-100-001,341,94,0,94,0,2,92
Listas,2014EP,19-101-001,751,211,0,210,-1,0,210
Listas,2014EP,19-102-001,400,103,0,103,0,0,103
Listas,2014EP,19-103-001,614,117,0,117,0,0,117
Listas,2014EP,19-104-001,428,85,0,85,0,1,84
Listas,2014EP,19-105-001,257,74,0,74,0,1,73
Listas,2014EP,19-106-001,806,165,0,165,0,0,165
Listas,2014EP,19-107-001,802,161,0,161,0,0,161
Listas,2014EP,19-108-001,908,232,1,231,-1,0,231
Listas,2014EP,19-108-002,857,191,0,191,0,0,191
Listas,2014EP,19-109-001,394,170,0,170,0,0,170
Listas,2014EP,19-110-001,942,195,0,195,0,2,193
Listas,2014EP,19-111-001,351,103,0,103,0,0,103
Listas,2014EP,19-112-001,449,101,0,101,0,3,98
Listas,2014EP,19-113-001,1077,274,0,274,0,1,273
Listas,2014EP,19-114-001,429,109,0,109,0,1,108
Listas,2014EP,19-115-001,344,64,0,64,0,1,63
Listas,2014EP,19-116-001,429,110,0,110,0,0,110
Listas,2014EP,19-116-002,213,46,0,46,0,0,46
Listas,2014EP,19-117-001,1011,316,0,316,0,2,314
Listas,2014EP,19-118-001,33,13,0,13,0,0,13
Listas,2014EP,19-119-001,222,71,0,71,0,1,70
Listas,2014EP,19-120-001,808,201,0,201,0,0,201
Listas,2014EP,19-121-001,629,121,0,121,0,0,121
Listas,2014EP,19-122-001,239,59,0,59,0,0,59
Listas,2014EP,19-123-001,913,208,0,208,0,4,204
Listas,2014EP,19-124-001,125,60,0,60,0,0,60
Listas,2014EP,19-125-001,546,125,0,125,0,1,124
Listas,2014EP,19-126-001,399,122,0,122,0,1,121
Listas,2014EP,19-127-001,305,67,0,67,0,0,67
Listas,2014EP,19-128-001,999,195,0,195,0,1,194
Listas,2014EP,19-129-001,475,136,0,136,0,0,136
Listas,2014EP,19-130-001,249,90,0,90,0,0,90
Listas,2014EP,19-131-001,463,164,0,163,-1,0,163
Listas,2014EP,19-132-001,856,197,0,197,0,1,196
Listas,2014EP,19-132-002,626,142,0,142,0,0,142
Listas,2014EP,19-133-001,569,169,0,169,0,1,168
Listas,2014EP,19-134-001,833,170,0,170,0,0,170
Listas,2014EP,19-135-001,330,101,0,101,0,0,101
Listas,2014EP,19-136-001,764,144,0,144,0,0,144
Listas,2014EP,19-137-001,1108,328,0,328,0,1,327
Listas,2014EP,19-137-002,1127,341,0,340,-1,1,339
Listas,2014EP,19-138-001,320,95,0,95,0,0,95
Listas,2014EP,19-139-001,85,52,0,52,0,0,52
Listas,2014EP,19-140-001,824,138,0,138,0,0,138
Listas,2014EP,19-141-001,183,87,0,87,0,0,87
Listas,2014EP,19-142-001,740,224,0,224,0,1,223
Listas,2014EP,19-143-001,846,164,0,164,0,0,164
Listas,2014EP,19-143-002,692,155,0,155,0,2,153
Listas,2014EP,19-144-001,886,239,0,239,0,0,239
Listas,2014EP,19-145-001,117,44,0,44,0,0,44
Listas,2014EP,19-146-001,42,28,0,28,0,0,28
Listas,2014EP,19-147-001,175,46,0,46,0,0,46
Listas,2014EP,19-148-001,152,87,0,87,0,1,86
Listas,2014EP,19-149-001,1085,273,0,273,0,0,273
Listas,2014EP,19-149-002,812,163,0,163,0,0,163
Listas,2014EP,19-150-001,1065,236,0,236,0,3,233
Listas,2014EP,19-150-002,653,131,0,131,0,0,131
Listas,2014EP,19-151-001,449,195,0,195,0,0,195
Listas,2014EP,19-152-001,1104,187,0,187,0,0,187
Listas,2014EP,19-152-002,191,71,0,71,0,1,70
Listas,2014EP,19-153-001,975,311,0,311,0,0,311
Listas,2014EP,19-153-002,873,262,0,262,0,0,262
Listas,2014EP,19-153-003,811,211,0,211,0,0,211
Listas,2014EP,19-153-004,790,322,0,322,0,0,322
Listas,2014EP,19-153-005,805,258,0,257,-1,0,257
Listas,2014EP,19-153-006,950,293,0,293,0,3,290
Listas,2014EP,19-153-007,1073,278,0,278,0,0,278
Listas,2014EP,19-153-008,653,239,0,239,0,1,238
Listas,2014EP,19-153-009,720,251,0,251,0,1,250
Listas,2014EP,19-153-010,974,378,0,378,0,0,378
Listas,2014EP,19-153-011,986,364,0,364,0,1,363
Listas,2014EP,19-153-012,650,189,0,189,0,2,187
Listas,2014EP,19-153-013,721,235,0,235,0,1,234
Listas,2014EP,19-153-014,799,187,0,187,0,1,186
Listas,2014EP,19-153-015,1067,299,0,298,-1,0,298
Listas,2014EP,19-153-016,975,232,0,232,0,1,231
Listas,2014EP,19-153-017,670,201,0,201,0,2,199
Listas,2014EP,19-153-018,817,160,0,160,0,0,160
Listas,2014EP,19-153-019,726,182,0,182,0,0,182
Listas,2014EP,19-153-020,375,113,0,113,0,2,111
Listas,2014EP,19-153-021,704,229,0,229,0,0,229
Listas,2014EP,19-153-022,620,181,0,181,0,1,180
Listas,2014EP,19-153-023,1024,306,0,306,0,1,305
Listas,2014EP,19-153-024,864,233,0,233,0,0,233
Listas,2014EP,19-153-025,795,222,0,222,0,0,222
Listas,2014EP,19-153-026,683,210,0,210,0,0,210
Listas,2014EP,19-153-027,732,196,0,196,0,0,196
Listas,2014EP,19-153-028,1057,277,0,277,0,0,277
Listas,2014EP,19-153-029,723,147,0,147,0,0,147
Listas,2014EP,19-153-030,1109,224,0,224,0,0,224
Listas,2014EP,19-153-031,776,225,0,225,0,1,224
Listas,2014EP,19-154-001,221,51,0,51,0,0,51
Listas,2014EP,19-155-001,482,163,0,163,0,1,162
Listas,2014EP,19-156-001,281,42,0,42,0,1,41
Listas,2014EP,19-157-001,964,207,0,207,0,1,206
Listas,2014EP,19-158-001,489,173,0,173,0,0,173
Listas,2014EP,19-159-001,298,70,0,70,0,0,70
Listas,2014EP,19-160-001,647,165,0,165,0,1,164
Listas,2014EP,19-160-002,802,210,0,209,-1,1,208
Listas,2014EP,19-160-003,844,134,0,134,0,0,134
Listas,2014EP,19-160-004,853,221,0,221,0,2,219
Listas,2014EP,19-160-005,819,160,0,160,0,2,158
Listas,2014EP,19-161-001,375,108,0,108,0,0,108
Listas,2014EP,19-162-001,182,59,0,59,0,0,59
Listas,2014EP,19-163-001,307,46,0,46,0,1,45
Listas,2014EP,19-164-001,204,80,0,80,0,0,80
Listas,2014EP,19-165-001,1130,498,0,497,-1,1,496
Listas,2014EP,19-166-001,166,38,0,38,0,0,38
Listas,2014EP,19-167-001,82,40,0,40,0,0,40
Listas,2014EP,19-168-001,228,66,0,66,0,0,66
Listas,2014EP,19-169-001,252,61,0,61,0,1,60
Listas,2014EP,19-170-001,549,119,0,119,0,1,118
Listas,2014EP,19-171-001,926,171,0,171,0,3,168
Listas,2014EP,19-172-001,82,33,0,33,0,3,30
Listas,2014EP,19-173-001,386,128,0,128,0,1,127
Listas,2014EP,19-174-001,842,214,0,214,0,0,214
Listas,2014EP,19-174-002,645,218,0,218,0,2,216
Listas,2014EP,19-174-003,636,143,0,143,0,1,142
Listas,2014EP,19-174-004,799,175,0,175,0,0,175
Listas,2014EP,19-174-005,722,209,0,209,0,0,209
Listas,2014EP,19-174-006,826,220,0,220,0,1,219
Listas,2014EP,19-174-007,759,182,0,182,0,3,179
Listas,2014EP,19-175-001,531,92,0,92,0,0,92
Listas,2014EP,19-176-001,424,108,0,108,0,0,108
Listas,2014EP,19-177-001,361,81,0,81,0,0,81
Listas,2014EP,19-178-001,201,101,0,101,0,2,99
Listas,2014EP,19-179-001,800,139,0,139,0,1,138
Listas,2014EP,19-179-002,723,157,0,157,0,0,157
Listas,2014EP,19-179-003,733,156,0,156,0,0,156
Listas,2014EP,19-180-001,177,49,0,49,0,0,49
Listas,2014EP,19-181-001,90,42,0,42,0,0,42
Listas,2014EP,19-182-001,847,180,0,180,0,1,179
Listas,2014EP,19-182-002,826,201,0,201,0,0,201
Listas,2014EP,19-183-001,861,309,0,309,0,1,308
Listas,2014EP,19-184-001,348,94,0,94,0,0,94
Listas,2014EP,19-185-001,88,45,0,45,0,0,45
Listas,2014EP,19-186-001,738,154,0,154,0,0,154
Listas,2014EP,19-187-001,567,130,0,130,0,3,127
Listas,2014EP,19-188-001,892,302,0,301,-1,0,301
Listas,2014EP,19-188-002,987,205,0,205,0,0,205
Listas,2014EP,19-188-003,1135,336,0,335,-1,1,334
Listas,2014EP,19-188-004,866,221,0,221,0,0,221
Listas,2014EP,19-188-005,919,280,0,280,0,2,278
Listas,2014EP,19-188-006,927,279,0,279,0,4,275
Listas,2014EP,19-188-007,922,276,0,276,0,3,273
Listas,2014EP,19-188-008,962,290,0,290,0,0,290
Listas,2014EP,19-188-009,835,224,0,224,0,1,223
Listas,2014EP,19-188-010,1017,237,0,237,0,0,237
Listas,2014EP,19-188-011,839,188,0,188,0,1,187
Listas,2014EP,19-188-012,964,291,0,291,0,0,291
Listas,2014EP,19-188-013,872,244,0,244,0,0,244
Listas,2014EP,19-188-014,670,202,0,202,0,1,201
Listas,2014EP,19-188-015,736,203,0,203,0,1,202
Listas,2014EP,19-189-001,709,181,0,181,0,0,181
Listas,2014EP,19-190-001,1267,523,0,523,0,3,520
Listas,2014EP,19-191-001,1049,250,0,250,0,0,250
Listas,2014EP,19-192-001,483,120,0,120,0,1,119
Listas,2014EP,19-193-001,1163,227,0,227,0,1,226
Listas,2014EP,19-194-001,278,46,0,46,0,0,46
Listas,2014EP,19-195-001,296,95,0,95,0,0,95
Listas,2014EP,19-196-001,903,144,0,144,0,0,144
Listas,2014EP,19-196-002,871,193,0,193,0,0,193
Listas,2014EP,19-197-001,454,114,0,114,0,0,114
Listas,2014EP,19-198-001,632,140,0,140,0,2,138
Listas,2014EP,19-198-002,629,168,0,168,0,1,167
Listas,2014EP,19-199-001,163,66,0,65,-1,0,65
Listas,2014EP,19-200-001,1164,289,0,289,0,2,287
Listas,2014EP,19-201-001,858,240,0,240,0,2,238
Listas,2014EP,19-201-002,998,206,0,206,0,4,202
Listas,2014EP,19-201-003,911,217,0,217,0,1,216
Listas,2014EP,19-201-004,1029,268,1,266,-2,2,264
Listas,2014EP,19-201-005,1094,288,0,288,0,0,288
Listas,2014EP,19-201-006,1012,215,0,215,0,0,215
Listas,2014EP,19-201-007,672,190,0,190,0,0,190
Listas,2014EP,19-201-008,770,226,0,226,0,2,224
Listas,2014EP,19-201-009,781,175,0,175,0,0,175
Listas,2014EP,19-201-010,857,191,0,191,0,0,191
Listas,2014EP,19-201-011,861,189,0,189,0,0,189
Listas,2014EP,19-201-012,1049,288,0,288,0,3,285
Listas,2014EP,19-201-013,803,201,0,201,0,0,201
Listas,2014EP,19-201-014,904,283,0,283,0,4,279
Listas,2014EP,19-201-015,1104,282,0,282,0,1,281
Listas,2014EP,19-201-016,1047,241,0,241,0,0,241
Listas,2014EP,19-201-017,747,199,0,199,0,0,199
Listas,2014EP,19-201-018,775,195,0,195,0,0,195
Listas,2014EP,19-201-019,768,132,0,131,-1,0,131
Listas,2014EP,19-202-001,214,106,0,106,0,1,105
Listas,2014EP,19-203-001,1159,568,0,568,0,3,565
Listas,2014EP,19-203-002,639,228,0,228,0,0,228
Listas,2014EP,19-203-003,1096,450,0,450,0,2,448
Listas,2014EP,19-203-004,1136,359,0,359,0,0,359
Listas,2014EP,19-203-005,925,427,0,425,-2,1,424
Listas,2014EP,19-203-006,811,338,0,338,0,1,337
Listas,2014EP,19-203-007,916,394,0,394,0,0,394
Listas,2014EP,19-203-008,1109,435,0,435,0,2,433
Listas,2014EP,19-203-009,905,271,0,271,0,2,269
Listas,2014EP,19-203-010,959,282,0,282,0,0,282
Listas,2014EP,19-203-011,1021,403,0,403,0,1,402
Listas,2014EP,19-203-012,908,231,0,231,0,0,231
Listas,2014EP,19-203-013,1023,404,0,404,0,2,402
Listas,2014EP,19-203-014,872,426,0,426,0,0,426
Listas,2014EP,19-203-015,653,249,0,249,0,0,249
Listas,2014EP,19-203-016,794,292,0,292,0,2,290
Listas,2014EP,19-203-017,642,298,0,298,0,0,298
Listas,2014EP,19-203-018,709,266,0,266,0,0,266
Listas,2014EP,19-203-019,782,349,0,349,0,1,348
Listas,2014EP,19-203-020,757,365,0,365,0,2,363
Listas,2014EP,19-203-021,745,273,0,273,0,0,273
Listas,2014EP,19-203-022,689,248,0,248,0,0,248
Listas,2014EP,19-203-023,818,260,0,260,0,0,260
Listas,2014EP,19-203-024,984,318,0,318,0,2,316
Listas,2014EP,19-203-025,1075,364,0,364,0,2,362
Listas,2014EP,19-203-026,940,320,0,320,0,1,319
Listas,2014EP,19-203-027,1071,426,0,426,0,1,425
Listas,2014EP,19-203-028,507,145,0,145,0,0,145
Listas,2014EP,19-203-029,817,370,0,370,0,2,368
Listas,2014EP,19-203-030,689,296,0,296,0,1,295
Listas,2014EP,19-203-031,1101,488,0,488,0,2,486
Listas,2014EP,19-203-032,1035,440,0,440,0,3,437
Listas,2014EP,19-203-033,697,192,0,192,0,1,191
Listas,2014EP,19-203-034,1041,329,0,329,0,4,325
Listas,2014EP,19-203-035,954,243,0,243,0,1,242
Listas,2014EP,19-203-036,966,218,0,218,0,1,217
Listas,2014EP,19-203-037,678,155,0,155,0,1,154
Listas,2014EP,19-203-038,922,218,0,218,0,0,218
Listas,2014EP,19-203-039,730,142,0,142,0,0,142
Listas,2014EP,19-203-040,965,259,0,259,0,0,259
Listas,2014EP,19-203-041,584,152,0,152,0,0,152
Listas,2014EP,19-203-042,707,184,0,184,0,1,183
Listas,2014EP,19-203-043,875,220,0,220,0,1,219
Listas,2014EP,19-203-044,967,268,0,268,0,0,268
Listas,2014EP,19-203-045,838,188,0,187,-1,0,187
Listas,2014EP,19-203-046,657,169,0,169,0,0,169
Listas,2014EP,19-203-047,623,192,0,192,0,1,191
Listas,2014EP,19-203-048,363,94,0,94,0,0,94
Listas,2014EP,19-203-049,727,218,0,218,0,3,215
Listas,2014EP,19-203-050,1031,243,0,243,0,1,242
Listas,2014EP,19-203-051,811,191,0,191,0,0,191
Listas,2014EP,19-203-052,248,84,0,84,0,0,84
Listas,2014EP,19-203-053,1151,323,0,323,0,3,320
Listas,2014EP,19-203-054,794,220,0,220,0,0,220
Listas,2014EP,19-203-055,758,232,0,232,0,0,232
Listas,2014EP,19-203-056,881,212,0,212,0,2,210
Listas,2014EP,19-204-001,202,83,0,83,0,0,83
Listas,2014EP,19-205-001,221,79,0,79,0,0,79
Listas,2014EP,19-206-001,111,37,0,37,0,0,37
Listas,2014EP,19-207-001,161,38,0,38,0,0,38
Listas,2014EP,19-208-001,527,121,0,121,0,1,120
Listas,2014EP,19-209-001,197,60,0,60,0,0,60
Listas,2014EP,19-210-001,78,35,0,35,0,0,35
Listas,2014EP,19-211-001,238,48,0,48,0,0,48
Listas,2014EP,19-212-001,392,87,0,87,0,0,87
Listas,2014EP,19-213-001,1059,172,0,172,0,0,172
Listas,2014EP,19-214-001,36,10,0,10,0,0,10
Listas,2014EP,19-215-001,121,54,0,54,0,2,52
Listas,2014EP,19-216-001,918,380,0,380,0,3,377
Listas,2014EP,19-217-001,845,219,0,219,0,0,219
Listas,2014EP,19-217-002,768,139,0,139,0,1,138
Listas,2014EP,19-217-003,851,214,0,214,0,0,214
Listas,2014EP,19-217-004,776,260,0,260,0,1,259
Listas,2014EP,19-217-005,855,268,0,268,0,1,267
Listas,2014EP,19-217-006,748,281,0,281,0,0,281
Listas,2014EP,19-217-007,986,332,0,332,0,0,332
Listas,2014EP,20-001-001,356,101,0,101,0,0,101
Listas,2014EP,20-002-001,51,25,0,25,0,0,25
Listas,2014EP,20-003-001,575,125,0,125,0,1,124
Listas,2014EP,20-004-001,1127,330,0,330,0,2,328
Listas,2014EP,20-005-001,299,44,0,44,0,0,44
Listas,2014EP,20-006-001,60,36,0,36,0,0,36
Listas,2014EP,20-007-001,406,120,0,120,0,1,119
Listas,2014EP,20-008-001,45,19,0,19,0,0,19
Listas,2014EP,20-009-001,1074,258,0,258,0,1,257
Listas,2014EP,20-010-001,709,194,0,194,0,1,193
Listas,2014EP,20-010-002,668,185,0,185,0,0,185
Listas,2014EP,20-011-001,297,57,0,57,0,0,57
Listas,2014EP,20-012-001,1005,422,1,421,-1,1,420
Listas,2014EP,20-013-001,414,90,0,90,0,0,90
Listas,2014EP,20-014-001,125,48,0,48,0,0,48
Listas,2014EP,20-015-001,306,60,0,60,0,0,60
Listas,2014EP,20-016-001,500,112,0,112,0,1,111
Listas,2014EP,20-017-001,486,136,0,136,0,0,136
Listas,2014EP,20-017-002,108,45,0,45,0,0,45
Listas,2014EP,20-018-001,682,125,0,125,0,2,123
Listas,2014EP,20-018-002,651,137,0,137,0,2,135
Listas,2014EP,20-018-003,494,95,0,95,0,1,94
Listas,2014EP,20-019-001,666,153,0,153,0,0,153
Listas,2014EP,20-020-001,658,96,0,96,0,0,96
Listas,2014EP,20-021-001,89,40,0,40,0,0,40
Listas,2014EP,20-022-001,117,44,0,44,0,0,44
Listas,2014EP,20-023-001,951,238,0,238,0,1,237
Listas,2014EP,20-024-001,276,67,0,67,0,0,67
Listas,2014EP,20-025-001,249,85,0,85,0,0,85
Listas,2014EP,20-026-001,589,110,0,110,0,0,110
Listas,2014EP,20-027-001,238,54,0,54,0,0,54
Listas,2014EP,20-028-001,241,55,0,55,0,0,55
Listas,2014EP,20-029-001,44,33,0,33,0,0,33
Listas,2014EP,20-030-001,44,18,0,18,0,0,18
Listas,2014EP,20-031-001,623,178,0,177,-1,0,177
Listas,2014EP,20-032-001,189,69,0,69,0,0,69
Listas,2014EP,20-033-001,129,34,0,34,0,0,34
Listas,2014EP,20-034-001,434,109,0,109,0,0,109
Listas,2014EP,20-035-001,1130,336,0,336,0,0,336
Listas,2014EP,20-035-002,1006,293,0,293,0,0,293
Listas,2014EP,20-036-001,29,11,0,11,0,0,11
Listas,2014EP,20-037-001,738,249,0,249,0,1,248
Listas,2014EP,20-038-001,304,91,0,91,0,1,90
Listas,2014EP,20-039-001,71,42,0,42,0,0,42
Listas,2014EP,20-040-001,507,80,0,80,0,1,79
Listas,2014EP,20-041-001,352,91,0,91,0,2,89
Listas,2014EP,20-042-001,393,82,0,82,0,0,82
Listas,2014EP,20-043-001,144,43,0,43,0,0,43
Listas,2014EP,20-044-001,129,57,0,57,0,0,57
Listas,2014EP,20-045-001,64,34,0,34,0,0,34
Listas,2014EP,20-046-001,23,11,0,11,0,0,11
Listas,2014EP,20-047-001,261,51,0,51,0,0,51
Listas,2014EP,20-048-001,831,208,0,208,0,0,208
Listas,2014EP,20-049-001,593,123,0,123,0,0,123
Listas,2014EP,20-050-001,362,59,0,59,0,0,59
Listas,2014EP,20-051-001,496,145,0,145,0,1,144
Listas,2014EP,20-052-001,600,147,0,147,0,2,145
Listas,2014EP,20-053-001,13,11,0,11,0,0,11
Listas,2014EP,20-054-001,573,142,0,142,0,2,140
Listas,2014EP,20-055-001,109,35,0,35,0,0,35
Listas,2014EP,20-056-001,941,173,0,173,0,2,171
Listas,2014EP,20-057-001,537,82,0,82,0,0,82
Listas,2014EP,20-058-001,58,23,0,23,0,1,22
Listas,2014EP,20-059-001,817,239,0,239,0,0,239
Listas,2014EP,20-059-002,496,139,0,139,0,0,139
Listas,2014EP,20-060-001,420,63,0,63,0,0,63
Listas,2014EP,20-060-002,495,83,0,83,0,0,83
Listas,2014EP,20-061-001,221,51,0,51,0,0,51
Listas,2014EP,20-062-001,76,13,0,13,0,0,13
Listas,2014EP,20-063-001,33,21,0,21,0,0,21
Listas,2014EP,20-064-001,48,37,0,37,0,0,37
Listas,2014EP,20-065-001,246,83,0,83,0,0,83
Listas,2014EP,20-066-001,719,163,1,162,-1,0,162
Listas,2014EP,20-066-002,203,50,0,50,0,0,50
Listas,2014EP,20-067-001,1015,327,0,327,0,1,326
Listas,2014EP,20-067-002,965,322,0,322,0,0,322
Listas,2014EP,20-067-003,973,319,0,319,0,0,319
Listas,2014EP,20-068-001,73,25,0,25,0,0,25
Listas,2014EP,20-069-001,246,82,0,82,0,0,82
Listas,2014EP,20-070-001,370,91,0,91,0,0,91
Listas,2014EP,20-070-002,441,106,0,106,0,1,105
Listas,2014EP,20-070-003,108,22,0,22,0,0,22
Listas,2014EP,20-071-001,78,28,0,28,0,0,28
Listas,2014EP,20-072-001,1040,691,0,691,0,2,689
Listas,2014EP,20-072-002,747,249,0,249,0,2,247
Listas,2014EP,20-072-003,835,301,0,301,0,2,299
Listas,2014EP,20-072-004,798,250,0,250,0,0,250
Listas,2014EP,20-072-005,968,317,0,317,0,0,317
Listas,2014EP,20-073-001,156,51,0,51,0,0,51
Listas,2014EP,20-074-001,158,52,0,52,0,0,52
Listas,2014EP,20-075-001,266,70,0,70,0,1,69
Listas,2014EP,20-076-001,11,10,0,10,0,0,10
Listas,2014EP,20-077-001,249,78,0,78,0,1,77
Listas,2014EP,20-078-001,183,54,0,54,0,0,54
Listas,2014EP,20-079-001,81,42,0,42,0,1,41
Listas,2014EP,20-080-001,617,143,0,143,0,1,142
Listas,2014EP,20-081-001,130,82,0,82,0,1,81
Listas,2014EP,20-082-001,113,31,0,31,0,0,31
Listas,2014EP,20-083-001,212,73,0,73,0,0,73
Listas,2014EP,20-084-001,537,117,0,117,0,1,116
Listas,2014EP,20-084-002,315,84,0,84,0,1,83
Listas,2014EP,20-085-001,134,41,0,41,0,1,40
Listas,2014EP,20-085-002,269,69,0,69,0,0,69
Listas,2014EP,20-086-001,77,22,0,22,0,0,22
Listas,2014EP,20-087-001,187,26,0,26,0,0,26
Listas,2014EP,20-088-001,234,62,0,62,0,1,61
Listas,2014EP,20-089-001,89,43,0,43,0,0,43
Listas,2014EP,20-090-001,96,41,0,41,0,0,41
Listas,2014EP,20-091-001,200,62,0,62,0,1,61
Listas,2014EP,20-092-001,152,49,0,49,0,1,48
Listas,2014EP,20-093-001,934,318,0,318,0,2,316
Listas,2014EP,20-093-002,898,285,0,285,0,0,285
Listas,2014EP,20-093-003,85,24,0,24,0,0,24
Listas,2014EP,20-093-004,1073,289,0,289,0,1,288
Listas,2014EP,20-093-005,1032,419,0,419,0,1,418
Listas,2014EP,20-093-006,988,338,0,338,0,0,338
Listas,2014EP,20-093-007,1219,396,0,396,0,1,395
Listas,2014EP,20-093-008,957,434,0,434,0,0,434
Listas,2014EP,20-093-009,727,279,0,279,0,1,278
Listas,2014EP,20-093-010,756,257,0,257,0,1,256
Listas,2014EP,20-093-011,1018,384,0,384,0,0,384
Listas,2014EP,20-093-012,1055,372,0,372,0,0,372
Listas,2014EP,20-093-013,897,329,0,329,0,1,328
Listas,2014EP,20-093-014,1045,326,0,326,0,0,326
Listas,2014EP,20-093-015,1138,268,0,268,0,1,267
Listas,2014EP,20-093-016,1061,315,0,315,0,2,313
Listas,2014EP,20-093-017,1060,301,0,301,0,1,300
Listas,2014EP,20-093-018,767,253,0,253,0,1,252
Listas,2014EP,20-094-001,202,40,0,40,0,0,40
Listas,2014EP,20-095-001,377,90,0,90,0,0,90
Listas,2014EP,20-096-001,150,60,0,60,0,0,60
Listas,2014EP,20-097-001,142,32,0,32,0,0,32
Listas,2014EP,20-098-001,160,53,0,53,0,0,53
Listas,2014EP,20-099-001,214,66,0,66,0,0,66
Listas,2014EP,20-100-001,165,29,0,29,0,0,29
Listas,2014EP,20-101-001,151,51,0,51,0,0,51
Listas,2014EP,20-102-001,138,35,0,35,0,0,35
Listas,2014EP,20-103-001,47,25,0,25,0,0,25
Listas,2014EP,20-104-001,38,33,0,33,0,0,33
Listas,2014EP,20-105-001,421,85,0,85,0,0,85
Listas,2014EP,20-106-001,74,24,0,24,0,0,24
Listas,2014EP,20-107-001,394,106,0,106,0,1,105
Listas,2014EP,20-108-001,72,16,0,16,0,0,16
Listas,2014EP,20-109-001,29,21,0,21,0,0,21
Listas,2014EP,20-110-001,32,15,0,15,0,0,15
Listas,2014EP,20-111-001,1015,377,0,377,0,1,376
Listas,2014EP,20-111-002,1100,406,0,406,0,3,403
Listas,2014EP,20-111-003,766,364,0,364,0,0,364
Listas,2014EP,20-111-004,927,270,0,270,0,0,270
Listas,2014EP,20-111-005,669,265,0,265,0,1,264
Listas,2014EP,20-111-006,955,383,2,382,-1,0,382
Listas,2014EP,20-111-007,471,222,0,222,0,5,217
Listas,2014EP,20-111-008,327,151,0,151,0,0,151
Listas,2014EP,20-111-009,277,101,0,101,0,1,100
Listas,2014EP,20-111-010,255,106,0,106,0,0,106
Listas,2014EP,20-111-011,144,70,0,70,0,1,69
Listas,2014EP,20-112-001,701,158,0,158,0,1,157
Listas,2014EP,20-112-002,821,210,0,210,0,0,210
Listas,2014EP,20-112-003,864,170,0,170,0,1,169
Listas,2014EP,20-112-004,613,123,0,123,0,1,122
Listas,2014EP,20-112-005,520,131,0,131,0,0,131
Listas,2014EP,20-113-001,167,46,0,46,0,0,46
Listas,2014EP,20-114-001,46,27,0,27,0,0,27
Listas,2014EP,20-115-001,92,22,0,22,0,0,22
Listas,2014EP,20-115-002,153,45,0,45,0,0,45
Listas,2014EP,20-116-001,348,96,0,96,0,1,95
Listas,2014EP,20-117-001,977,245,0,245,0,1,244
Listas,2014EP,20-118-001,50,24,0,24,0,0,24
Listas,2014EP,20-119-001,230,56,0,56,0,0,56
Listas,2014EP,20-120-001,395,100,0,100,0,0,100
Listas,2014EP,20-121-001,69,29,0,29,0,0,29
Listas,2014EP,20-122-001,48,31,0,31,0,0,31
Listas,2014EP,20-123-001,647,120,0,120,0,1,119
Listas,2014EP,20-124-001,312,116,0,116,0,0,116
Listas,2014EP,20-125-001,216,104,0,104,0,5,99
Listas,2014EP,20-126-001,261,62,0,62,0,0,62
Listas,2014EP,20-127-001,250,60,0,60,0,1,59
Listas,2014EP,20-128-001,630,171,0,171,0,0,171
Listas,2014EP,20-129-001,898,154,0,154,0,1,153
Listas,2014EP,20-129-002,609,143,0,143,0,0,143
Listas,2014EP,20-130-001,207,49,0,49,0,0,49
Listas,2014EP,20-131-001,213,59,0,59,0,0,59
Listas,2014EP,20-131-002,114,26,0,26,0,0,26
Listas,2014EP,20-131-003,81,30,0,30,0,0,30
Listas,2014EP,20-132-001,365,71,0,71,0,3,68
Listas,2014EP,20-133-001,148,55,0,55,0,0,55
Listas,2014EP,20-134-001,949,219,0,219,0,0,219
Listas,2014EP,20-134-002,1048,307,0,307,0,2,305
Listas,2014EP,20-134-003,649,181,0,181,0,0,181
Listas,2014EP,20-134-004,757,176,0,176,0,0,176
Listas,2014EP,20-134-005,707,192,0,192,0,0,192
Listas,2014EP,20-134-006,814,163,0,163,0,1,162
Listas,2014EP,20-134-007,790,262,0,262,0,0,262
Listas,2014EP,20-134-008,940,322,0,322,0,0,322
Listas,2014EP,20-134-009,941,292,0,292,0,0,292
Listas,2014EP,20-134-010,948,292,1,291,-1,0,291
Listas,2014EP,20-134-011,764,223,0,223,0,4,219
Listas,2014EP,20-134-012,799,236,0,236,0,0,236
Listas,2014EP,20-134-013,1014,258,0,258,0,0,258
Listas,2014EP,20-134-014,1301,345,0,345,0,2,343
Listas,2014EP,20-134-015,1320,389,0,389,0,0,389
Listas,2014EP,20-134-016,1281,273,0,273,0,1,272
Listas,2014EP,20-134-017,785,201,0,201,0,0,201
Listas,2014EP,20-134-018,1266,244,0,244,0,0,244
Listas,2014EP,20-134-019,1175,241,0,241,0,0,241
Listas,2014EP,20-134-020,1318,291,0,291,0,0,291
Listas,2014EP,20-134-021,981,190,0,190,0,0,190
Listas,2014EP,20-134-022,1172,219,0,219,0,1,218
Listas,2014EP,20-134-023,1165,195,0,195,0,1,194
Listas,2014EP,20-134-024,1084,215,0,215,0,0,215
Listas,2014EP,20-134-025,1011,239,0,239,0,1,238
Listas,2014EP,20-134-026,679,89,0,89,0,0,89
Listas,2014EP,20-134-027,222,38,0,38,0,0,38
Listas,2014EP,20-134-028,980,324,0,324,0,1,323
Listas,2014EP,20-134-029,782,179,0,179,0,1,178
Listas,2014EP,20-134-030,897,297,0,297,0,0,297
Listas,2014EP,20-134-031,908,275,0,275,0,1,274
Listas,2014EP,20-134-032,1008,309,0,309,0,2,307
Listas,2014EP,20-134-033,863,315,0,315,0,1,314
Listas,2014EP,20-134-034,862,325,0,325,0,0,325
Listas,2014EP,20-134-035,705,142,0,142,0,1,141
Listas,2014EP,20-134-036,788,207,0,207,0,0,207
Listas,2014EP,20-134-037,909,258,0,258,0,0,258
Listas,2014EP,20-134-038,733,178,0,178,0,0,178
Listas,2014EP,20-134-039,926,243,0,243,0,0,243
Listas,2014EP,20-134-040,696,184,0,184,0,2,182
Listas,2014EP,20-134-041,536,120,0,120,0,0,120
Listas,2014EP,20-134-042,1052,265,0,265,0,1,264
Listas,2014EP,20-134-043,968,284,0,284,0,1,283
Listas,2014EP,20-134-044,1041,341,0,340,-1,1,339
Listas,2014EP,20-135-001,752,153,0,153,0,0,153
Listas,2014EP,20-136-001,385,125,0,125,0,1,124
Listas,2014EP,20-137-001,423,112,0,112,0,2,110
Listas,2014EP,20-138-001,371,91,0,91,0,0,91
Listas,2014EP,20-139-001,412,103,0,103,0,0,103
Listas,2014EP,20-140-001,926,236,0,236,0,0,236
Listas,2014EP,20-141-001,380,75,0,75,0,1,74
Listas,2014EP,20-142-001,515,155,0,155,0,0,155
Listas,2014EP,20-143-001,228,83,0,83,0,0,83
Listas,2014EP,20-144-001,114,58,0,58,0,0,58
Listas,2014EP,20-145-001,244,61,0,61,0,0,61
Listas,2014EP,20-146-001,252,58,0,58,0,0,58
Listas,2014EP,20-147-001,266,71,0,71,0,4,67
Listas,2014EP,20-148-001,220,74,0,74,0,0,74
Listas,2014EP,20-149-001,152,52,0,52,0,0,52
Listas,2014EP,20-150-001,666,157,0,157,0,0,157
Listas,2014EP,20-151-001,209,37,0,37,0,0,37
Listas,2014EP,20-152-001,106,36,0,36,0,1,35
Listas,2014EP,20-153-001,98,42,0,42,0,0,42
Listas,2014EP,20-154-001,364,62,0,62,0,1,61
Listas,2014EP,20-155-001,91,19,0,19,0,0,19
Listas,2014EP,20-156-001,165,65,0,65,0,0,65
Listas,2014EP,20-157-001,481,77,0,77,0,0,77
Listas,2014EP,20-158-001,698,182,0,182,0,0,182
Listas,2014EP,20-158-002,710,202,0,202,0,0,202
Listas,2014EP,20-159-001,112,38,0,38,0,0,38
Listas,2014EP,20-160-001,731,107,0,107,0,1,106
Listas,2014EP,20-161-001,162,58,0,58,0,0,58
Listas,2014EP,20-162-001,876,245,0,245,0,2,243
Listas,2014EP,20-162-002,120,35,0,35,0,1,34
Listas,2014EP,20-163-001,137,30,0,30,0,0,30
Listas,2014EP,20-164-001,359,85,0,85,0,0,85
Listas,2014EP,20-165-001,323,71,0,71,0,0,71
Listas,2014EP,20-166-001,328,68,0,68,0,0,68
Listas,2014EP,20-167-001,764,171,0,171,0,1,170
Listas,2014EP,20-168-001,252,97,0,97,0,0,97
Listas,2014EP,20-169-001,717,117,0,117,0,0,117
Listas,2014EP,20-170-001,300,60,0,60,0,0,60
Listas,2014EP,20-171-001,50,21,0,21,0,0,21
Listas,2014EP,20-172-001,230,69,0,69,0,0,69
Listas,2014EP,20-173-001,26,16,0,16,0,0,16
Listas,2014EP,20-174-001,148,43,0,43,0,0,43
Listas,2014EP,20-175-001,463,116,0,116,0,1,115
Listas,2014EP,20-176-001,509,145,0,145,0,0,145
Listas,2014EP,20-177-001,29,18,0,18,0,0,18
Listas,2014EP,20-178-001,264,79,0,79,0,0,79
Listas,2014EP,20-179-001,955,252,0,252,0,3,249
Listas,2014EP,20-180-001,789,239,0,239,0,3,236
Listas,2014EP,20-181-001,335,83,0,83,0,0,83
Listas,2014EP,20-182-001,486,126,0,126,0,1,125
Listas,2014EP,20-183-001,357,108,0,108,0,1,107
Listas,2014EP,20-184-001,638,192,0,192,0,1,191
Listas,2014EP,20-185-001,775,176,0,176,0,3,173
Listas,2014EP,20-185-002,686,127,0,127,0,0,127
Listas,2014EP,20-186-001,527,132,0,132,0,1,131
Listas,2014EP,20-187-001,38,29,0,29,0,0,29
Listas,2014EP,20-188-001,766,167,0,167,0,1,166
Listas,2014EP,20-189-001,597,129,0,129,0,0,129
Listas,2014EP,20-189-002,626,116,0,116,0,0,116
Listas,2014EP,20-190-001,516,160,0,160,0,0,160
Listas,2014EP,20-191-001,492,178,0,178,0,0,178
Listas,2014EP,20-192-001,174,44,0,44,0,0,44
Listas,2014EP,20-193-001,253,72,0,72,0,0,72
Listas,2014EP,20-194-001,352,105,0,105,0,0,105
Listas,2014EP,20-195-001,61,27,0,27,0,0,27
Listas,2014EP,20-196-001,263,74,0,74,0,0,74
Listas,2014EP,20-197-001,71,18,0,18,0,0,18
Listas,2014EP,20-198-001,120,24,0,24,0,0,24
Listas,2014EP,20-199-001,723,109,0,109,0,3,106
Listas,2014EP,20-200-001,655,130,0,130,0,1,129
Listas,2014EP,20-200-002,711,118,0,118,0,0,118
Listas,2014EP,20-201-001,189,72,0,72,0,0,72
Listas,2014EP,20-202-001,25,12,0,12,0,0,12
Listas,2014EP,20-203-001,163,80,0,80,0,0,80
Listas,2014EP,20-204-001,910,254,0,254,0,0,254
Listas,2014EP,20-205-001,82,53,0,53,0,1,52
Listas,2014EP,20-205-002,61,27,0,27,0,0,27
Listas,2014EP,20-206-001,310,85,0,85,0,1,84
Listas,2014EP,20-207-001,482,112,0,112,0,0,112
Listas,2014EP,20-208-001,571,125,0,125,0,2,123
Listas,2014EP,20-209-001,764,156,0,156,0,0,156
Listas,2014EP,20-210-001,452,103,0,103,0,1,102
Listas,2014EP,20-210-002,500,105,0,105,0,0,105
Listas,2014EP,20-211-001,493,50,0,50,0,0,50
Listas,2014EP,20-211-002,858,160,0,160,0,2,158
Listas,2014EP,20-212-001,829,207,0,207,0,0,207
Listas,2014EP,20-213-001,52,22,0,22,0,2,20
Listas,2014EP,20-214-001,481,114,0,114,0,0,114
Listas,2014EP,20-215-001,250,109,0,109,0,1,108
Listas,2014EP,20-215-002,67,35,0,35,0,0,35
Listas,2014EP,20-216-001,114,37,0,37,0,0,37
Listas,2014EP,20-217-001,153,32,0,32,0,0,32
Listas,2014EP,20-218-001,891,219,0,219,0,0,219
Listas,2014EP,20-219-001,103,46,0,46,0,0,46
Listas,2014EP,20-220-001,65,20,0,20,0,0,20
Listas,2014EP,20-221-001,292,67,0,67,0,0,67
Listas,2014EP,20-222-001,971,315,0,315,0,0,315
Listas,2014EP,20-222-002,950,357,0,357,0,0,357
Listas,2014EP,20-223-001,68,21,0,21,0,0,21
Listas,2014EP,20-224-001,188,30,0,30,0,0,30
Listas,2014EP,20-225-001,649,147,0,147,0,0,147
Listas,2014EP,20-225-002,587,146,0,146,0,1,145
Listas,2014EP,20-226-001,567,169,0,169,0,0,169
Listas,2014EP,20-227-001,569,150,0,150,0,0,150
Listas,2014EP,20-228-001,303,74,0,74,0,0,74
Listas,2014EP,20-229-001,799,170,0,170,0,1,169
Listas,2014EP,20-230-001,443,130,0,130,0,0,130
Listas,2014EP,20-231-001,736,200,0,200,0,0,200
Listas,2014EP,20-231-002,1126,301,0,301,0,0,301
Listas,2014EP,20-231-003,1137,333,0,333,0,0,333
Listas,2014EP,20-231-004,862,275,0,275,0,0,275
Listas,2014EP,20-231-005,796,158,0,158,0,0,158
Listas,2014EP,20-231-006,1186,280,0,280,0,0,280
Listas,2014EP,20-231-007,848,241,0,241,0,2,239
Listas,2014EP,20-231-008,736,241,0,241,0,1,240
Listas,2014EP,20-231-009,829,248,0,248,0,0,248
Listas,2014EP,20-231-010,913,269,0,269,0,0,269
Listas,2014EP,20-231-011,825,277,0,277,0,0,277
Listas,2014EP,20-231-012,1118,344,0,344,0,0,344
Listas,2014EP,20-231-013,1031,303,0,303,0,1,302
Listas,2014EP,20-231-014,895,230,0,230,0,0,230
Listas,2014EP,20-231-015,1009,331,0,330,-1,1,329
Listas,2014EP,20-231-016,1320,432,0,432,0,1,431
Listas,2014EP,20-231-017,1046,335,0,335,0,2,333
Listas,2014EP,20-231-018,1056,315,0,315,0,3,312
Listas,2014EP,20-231-019,918,348,0,348,0,3,345
Listas,2014EP,20-231-020,989,323,0,323,0,0,323
Listas,2014EP,20-231-021,1074,373,0,373,0,0,373
Listas,2014EP,20-231-022,944,302,0,302,0,0,302
Listas,2014EP,20-231-023,1171,436,0,436,0,1,435
Listas,2014EP,20-231-024,508,123,0,123,0,0,123
Listas,2014EP,20-231-025,516,165,0,165,0,0,165
Listas,2014EP,20-231-026,1217,382,0,381,-1,1,380
Listas,2014EP,20-231-027,1071,306,0,306,0,0,306
Listas,2014EP,20-231-028,1398,415,0,415,0,1,414
Listas,2014EP,20-231-029,924,281,0,281,0,1,280
Listas,2014EP,20-231-030,643,139,0,139,0,0,139
Listas,2014EP,20-231-031,729,210,0,210,0,0,210
Listas,2014EP,20-231-032,855,262,0,262,0,0,262
Listas,2014EP,20-231-033,920,241,0,241,0,2,239
Listas,2014EP,20-231-034,1046,317,0,317,0,2,315
Listas,2014EP,20-231-035,933,342,0,342,0,0,342
Listas,2014EP,20-231-036,1031,322,0,322,0,0,322
Listas,2014EP,20-231-037,1089,415,0,414,-1,3,411
Listas,2014EP,20-231-038,924,264,0,264,0,0,264
Listas,2014EP,20-231-039,896,240,0,240,0,0,240
Listas,2014EP,20-231-040,1038,402,0,402,0,1,401
Listas,2014EP,20-231-041,1125,395,0,394,-1,2,392
Listas,2014EP,20-231-042,689,241,0,241,0,0,241
Listas,2014EP,20-231-043,1005,252,0,252,0,3,249
Listas,2014EP,20-231-044,1069,279,0,279,0,1,278
Listas,2014EP,20-231-045,893,190,0,190,0,0,190
Listas,2014EP,20-231-046,849,231,0,231,0,0,231
Listas,2014EP,20-231-047,781,272,0,272,0,0,272
Listas,2014EP,20-231-048,1412,431,0,430,-1,4,426
Listas,2014EP,20-231-049,1078,320,0,320,0,1,319
Listas,2014EP,20-231-050,644,176,0,176,0,0,176
Listas,2014EP,20-231-051,672,250,0,250,0,0,250
Listas,2014EP,20-232-001,333,110,0,110,0,0,110
Listas,2014EP,20-233-001,98,28,0,28,0,1,27
Listas,2014EP,20-234-001,319,87,0,87,0,0,87
Listas,2014EP,20-235-001,994,382,0,382,0,1,381
Listas,2014EP,20-235-002,863,232,0,232,0,1,231
Listas,2014EP,20-236-001,696,55,0,55,0,0,55
Listas,2014EP,20-236-002,753,120,0,120,0,0,120
Listas,2014EP,20-236-003,783,89,0,89,0,0,89
Listas,2014EP,20-237-001,23,16,0,16,0,0,16
Listas,2014EP,20-238-001,544,170,0,170,0,1,169
Listas,2014EP,20-238-002,549,120,0,120,0,0,120
Listas,2014EP,20-238-003,531,93,0,93,0,0,93
Listas,2014EP,20-238-004,525,108,0,108,0,0,108
Listas,2014EP,20-238-005,206,56,0,56,0,0,56
Listas,2014EP,20-238-006,81,27,0,27,0,0,27
Listas,2014EP,20-239-001,158,50,0,50,0,0,50
Listas,2014EP,20-240-001,101,35,0,35,0,0,35
Listas,2014EP,20-241-001,452,124,0,124,0,0,124
Listas,2014EP,20-242-001,757,208,0,208,0,0,208
Listas,2014EP,20-243-001,681,170,0,170,0,2,168
Listas,2014EP,20-244-001,716,163,0,163,0,1,162
Listas,2014EP,20-244-002,764,202,0,202,0,0,202
Listas,2014EP,20-244-003,836,267,0,267,0,0,267
Listas,2014EP,20-244-004,1125,323,0,323,0,2,321
Listas,2014EP,20-244-005,452,106,0,106,0,1,105
Listas,2014EP,20-244-006,546,126,0,126,0,2,124
Listas,2014EP,20-244-007,159,45,0,45,0,0,45
Listas,2014EP,20-244-008,258,71,0,71,0,0,71
Listas,2014EP,20-244-009,251,60,0,60,0,0,60
Listas,2014EP,20-244-010,416,103,0,103,0,0,103
Listas,2014EP,20-245-001,338,121,0,121,0,0,121
Listas,2014EP,20-246-001,857,223,0,223,0,0,223
Listas,2014EP,20-247-001,231,47,0,47,0,1,46
Listas,2014EP,20-248-001,430,116,0,116,0,0,116
Listas,2014EP,20-248-002,220,37,0,37,0,0,37
Listas,2014EP,20-249-001,235,77,0,77,0,0,77
Listas,2014EP,20-250-001,58,23,0,23,0,0,23
Listas,2014EP,20-251-001,859,173,0,173,0,0,173
Listas,2014EP,20-252-001,50,25,0,25,0,0,25
Listas,2014EP,20-253-001,537,116,0,116,0,0,116
Listas,2014EP,20-254-001,94,36,0,36,0,0,36
Listas,2014EP,20-255-001,762,160,0,160,0,0,160
Listas,2014EP,20-256-001,324,70,0,70,0,0,70
Listas,2014EP,20-257-001,64,26,0,26,0,1,25
Listas,2014EP,20-258-001,374,100,0,100,0,0,100
Listas,2014EP,99-F  -,7572,6322,0,6253,0,19,6234
